Date,Open,High,Low,Close,Adj Close,Volume,EPS,P/E Ratio,Beta,Dividend Yield,Book Value,Debt-to-Equity,Return on Equity,FFR,CPI,NASDAQ,NYSE,LSE,Euronext (France),SSE,BSE,TSX,SMA_50,SMA_200,EMA_50,EMA_200,Bollinger_SMA20,Bollinger_Upper_Band,Bollinger_Lower_Band,RSI,MACD,MACD_signal,MACD_hist,Average True Range (ATR),SAR,On-Balance Volume (OBV),Stochastic Oscillator_%K,Stochastic Oscillator_%D,VIX_History,Title,Text,URL,Site,Credibility Score,Cleaned_Text,Sentiment_Score,Weighted_Sentiment,Avg_Weighted_Sentiment,Impact,Impact_Direction
02/01/2020,93.75,94.90,93.21,94.90,94.90,80580000,2.13,76.34428766,1.192,0,9.3404,0.9034837908,0.2283735172,1.55,257.971,9092.19043,14002.49023,7604.299805,6041.5,3085.197998,41626.64063,17100,89.05156998,91.37701496,89.53444189,89.26990936,89.61919975,94.41153332,84.82686619,82.80956051,1.306534443,0.7315643019,0.5749701408,1.324213845,88.54392259,7642990000,97.82633581,77.58081782,12.47000027,Amazon workers group says members were threatened with termination after speaking out on climate impact,Some Amazon.com Inc. tech workers who are members of a group called Amazon Employees for Climate Justice say they were contacted by reps from the tech giant's legal and human resources team after calling for the company to take a bigger role in battling climate change.,https://www.marketwatch.com/story/amazon-workers-group-says-members-were-threatened-with-termination-after-speaking-out-on-climate-impact-2020-01-02,marketwatch.com,8,amazoncom inc tech worker member group called amazon employee climate justice say contacted rep tech giant legal human resource team calling company take bigger role battling climate change,0.5423,0.43384,-0.038438571,0.4722785714,Positive Impact
03/01/2020,93.225,94.31,93.23,93.75,93.75,75288000,2.13,76.34428766,1.192,0,9.3404,0.9034837908,0.2283735172,1.55,257.971,9020.769531,13917.0498,7622.399902,6044.160156,3083.785889,41464.60938,17066.09961,89.16080994,91.39643993,89.69969896,89.31447242,89.9048996,94.97281778,84.83698142,73.98928167,1.392249528,0.8637013471,0.5285481812,1.377607073,88.93548722,7567702000,81.94668387,82.4825254,14.02000046,3 Warren Buffett Stocks Worth Buying,These well-known companies have competitive advantages and strong growth prospects.,https://www.fool.com/investing/2020/01/03/3-warren-buffett-stocks-worth-buying.aspx,fool.com,7,wellknown company competitive advantage strong growth prospect,0.8689,0.60823,0.15618625,0.45204375,Positive Impact
06/01/2020,93,95.18,93.00,95.14,95.14,81236000,2.13,76.34428766,1.192,0,9.3404,0.9034837908,0.2283735172,1.55,257.971,9071.469727,13941.7998,7575.299805,6013.589844,3083.407959,40676.62891,17105.5,89.30151993,91.41734493,89.91320085,89.37247764,90.31089935,95.69801618,84.92378252,76.65640779,1.554861083,1.001933294,0.5529277884,1.483678545,89.30355797,7648938000,99.44756613,93.0735286,13.85000038,Amazon Fire TV Introduces Expanded Suite of Features and New Solution Providers for Fire TV Edition Partners,"SEATTLE--(BUSINESS WIRE)--(NASDAQ: AMZN) ÃÂÃÂ Today, Amazon announced the expansion of the Fire TV Edition program, delivering a richer experience and more opportunities for developers, operators, device makers and manufacturers across multiple categories including automotive, smart TVs, soundbars and streaming media players. Fire TV has passed more than 40 million active users, and customers globally have access to tens of thousands of channels, apps, Alexa skills and more. With this expanded Fire TV Edition, it will be even easier for device makers to integrate Fire TV into their products, with new tools and services for each category that will enable companies to bring tailored entertainment experiences and great content to their customers. ÃÂÃÂAt CES 2017, we announced the first Fire TV Edition smart TV. Now, just three years later, Fire TV Edition has grown into a worldwide program which will include more than 150 Fire TV Edition models across more than ten countries by the end of the year,ÃÂÃÂ said Marc Whitten, Vice President, Amazon Fire TV. ÃÂÃÂOur expanded Fire TV Edition program provides companies with the services and tools they need to bring Fire TV to more categories and more screens.ÃÂÃÂ Since 2017, Amazon has expanded its Fire TV Edition program each year to bring new features and services to partners. In 2018, Amazon and Best Buy announced an initiative to bring Fire TV Edition TVs to customers in the United States and Canada, and to date, they have sold millions of Insignia and Toshiba Fire TV Edition smart TVs. ÃÂÃÂOver the past year, Best Buy has sold millions of Fire TV Edition smart TVs on BestBuy.com, in our stores and as a third-party seller on Amazon.com. WeÃÂÃÂve enjoyed working with the Amazon team to bring these high-quality TVs and the incredible Fire TV experience to our customers,ÃÂÃÂ said Luke Motschenbacher, Vice President of Merchandising, Best Buy. Following the success of Fire TV Edition smart TVs with Best Buy, Amazon announced plans to expand internationally, bringing the next generation of Fire TV Edition devices to customers in the United Kingdom, Germany, Austria, Ireland and India. In 2019, more than 50 Fire TV Edition smart TVs and soundbars have launched from global brands like Grundig, JVC, Onida and Anker and retailers like Best Buy, Currys PC World and MediaMarktSaturn (coming 2020). Amazon will continue its international expansion with more brands launching Fire TV Edition smart TVs in the United States, Canada, India, United Kingdom, Ireland, Germany, Austria, Italy, Spain and Mexico in the coming year. Introducing Fire TV Edition for Soundbars This past September, Amazon and Anker Innovations announced the Nebula SoundbarÃÂÃÂFire TV Edition, the first Fire TV Edition soundbar featuring an all-in-one home cinema experience with expansive video streaming and stunning sound. Starting today, the TCL Alto 8+ SoundbarÃÂÃÂFire TV Edition is available on Amazon in the United States and Canada. Customers of amazon.co.uk, amazon.de, amazon.fr, amazon.it and amazon.es can sign up today to be notified when the TCL TS8011 SoundbarÃÂÃÂFire TV Edition is available on Amazon. Both soundbars are designed to support premium acoustic performance, with carefully tuned speaker drivers and support for Dolby Digital Plus producing clear, dynamic and immersive sound. Amazon now works with a growing number of device manufacturers including Anker, Polk Audio and Tonly on soundbar solutions. Later this year, Fire TV Edition soundbars will offer new features including Dolby Atmos support, compatible device control, HDMI switching and far-field voice control, along with partner customizations. Introducing Fire TV Edition for Auto Building on the success of Fire TV Edition smart TVs and soundbars, Amazon is expanding the program to automakers, partnering with BMW and Fiat Chrysler Automobiles (FCA). With hands-free access to Alexa, touch screen interface and offline playback capabilities, parents and kids alike can enjoy the living room TV experience in the car and watch a wide variety of content and the latest shows from the most popular video services worldwide and shows recorded with Fire TV Recast or saved locally on-device. Content can be streamed using a vehicleÃÂÃÂs Wi-Fi or LTE connection, a mobile hotspot or any other WAN-enabled device. ÃÂÃÂAdding Fire TV to future BMW vehicles represents a big step in bringing the best of streamed entertainment to our products. With AmazonÃÂÃÂs approach, and with the help of Garmin, we are able to innovate and create a unique and special experience for BMW cars, providing the consistency of content and customer experience that Fire TV provides in the home. We look forward to working closely with Amazon to bring Fire TV to future vehicles,ÃÂÃÂ said Fathi El-Dwaik, Vice President User Interaction, Business Line My Car and Business Line My Life, BMW Group. Introducing Fire TV Edition for Operators Starting today, Fire TV is enabling television and telecommunication operators to quickly bring Fire TV Edition devices to their customers in a more customized and cost-effective way. After successfully introducing Fire TV partnerships with Tata Sky in India and Verizon in the United States, Fire TV is now expanding the device offerings available to operators, allowing them to choose the best solution that fits their customer and business needs as well as providing merchandising opportunities in the Fire TV Edition customer experience. The Fire TV Edition for Operators is available today in North America, Europe, India and Japan. Introducing Fire TV Edition ÃÂÃÂ Certified Solutions Providers Fire TV is enabling partners across a variety of industries and categories to work with certified solutions providers to rapidly bring the latest Fire TV Edition devices to customers. Amazon currently works with a growing number of TV manufacturers who produce Fire TV Edition smart TVs. Vestel, Arcelik, Compal, TPV and others can now build Fire TV Edition smart TVs for their customers with manufacturing and assembly capabilities around the world. Today, Amazon announced Skyworth as the latest global ODM with turnkey solutions for smart TVs. These turnkey solutions enable Skyworth and other ODMs to work with the worldÃÂÃÂs leading TV brands to bring high-quality, differentiated, cost-effective 4K and FHD smart TVs to customers. Starting in India, brands can choose from a selection of manufacturers with various industrial design and price options to bring an entire lineup of smart TVs to customers. The turnkey ODM solution offered in collaboration with Amazon includes out-of-the-box reference designs, schematics and boards designed with CVTE, a leading LCD TV mainboard provider for feature-rich 4K and FHD smart TVs; self-service tools and software customizations, such as settings SDK for custom picture and audio settings; and customized industrial design and hardware options. ÃÂÃÂWe are excited to build a scalable, worldwide smart TV program with Fire TV Edition,ÃÂÃÂ said Tony Wang, CEO and Chairman of Skyworth TV Business Division. ÃÂÃÂODMs & OEMs can offer customers the choice of a top-rated smart TV software experience along with the speed, value and high-quality hardware that they always expect from Skyworth.ÃÂÃÂ For auto partners, Amazon is working with leading system integrators VOXX Automotive and Garmin to deliver solutions and services that can significantly accelerate the development cycle for automakers. ÃÂÃÂBy working with Amazon to enable Fire TV for in-vehicle entertainment, we have been able to create a reference implementation that automotive OEMs can build into their vehicle programs and bring all of the rich entertainment of Fire TV into automotive grade installations,ÃÂÃÂ said Ed Mas, President, VOXX Automotive, a division of VOXX International Corporation. For operators, Amazon also announced it is working with the National Cable Television Cooperative (NCTC) to enable its members the ability to deliver low cost Fire TV streaming media players directly to their customers. NCTC has over 750 members, including independent cable and telecommunication operators, delivering service to 16 million broadband and 8 million video customers in the aggregate. Device makers and operators interested in learning more about the Fire TV Edition program can visit: https://developer.amazon.com/apps-and-games/fire-tv-edition. About Amazon Amazon is guided by four principles: customer obsession rather than competitor focus, passion for invention, commitment to operational excellence and long-term thinking. Customer reviews, 1-Click shopping, personalized recommendations, Prime, Fulfillment by Amazon, AWS, Kindle Direct Publishing, Kindle, Fire tablets, Fire TV, Amazon Echo and Alexa are some of the products and services pioneered by Amazon. For more information, visit www.amazon.com/about and follow @AmazonNews.",https://www.businesswire.com/news/home/20200106005589/en/Amazon-Fire-TV-Introduces-Expanded-Suite-of-Features-and-New-Solution-Providers-for-Fire-TV-Edition-Partners,businesswire.com,5,seattlebusiness wirenasdaq amzn today amazon announced expansion fire tv edition program delivering richer experience opportunity developer operator device maker manufacturer across multiple category including automotive smart tv soundbars streaming medium player fire tv passed million active user customer globally access ten thousand channel apps alexa skill expanded fire tv edition even easier device maker integrate fire tv product new tool service category enable company bring tailored entertainment experience great content customer ce announced first fire tv edition smart tv three year later fire tv edition grown worldwide program include fire tv edition model across ten country end year said marc whitten vice president amazon fire tv expanded fire tv edition program provides company service tool need bring fire tv category screen since amazon expanded fire tv edition program year bring new feature service partner amazon best buy announced initiative bring fire tv edition tv customer united state canada date sold million insignia toshiba fire tv edition smart tv past year best buy sold million fire tv edition smart tv bestbuycom store thirdparty seller amazoncom weve enjoyed working amazon team bring highquality tv incredible fire tv experience customer said luke motschenbacher vice president merchandising best buy following success fire tv edition smart tv best buy amazon announced plan expand internationally bringing next generation fire tv edition device customer united kingdom germany austria ireland india fire tv edition smart tv soundbars launched global brand like grundig jvc onida anker retailer like best buy curry pc world mediamarktsaturn coming amazon continue international expansion brand launching fire tv edition smart tv united state canada india united kingdom ireland germany austria italy spain mexico coming year introducing fire tv edition soundbars past september amazon anker innovation announced nebula soundbarfire tv edition first fire tv edition soundbar featuring allinone home cinema experience expansive video streaming stunning sound starting today tcl alto soundbarfire tv edition available amazon united state canada customer amazoncouk amazonde amazonfr amazonit amazones sign today notified tcl t soundbarfire tv edition available amazon soundbars designed support premium acoustic performance carefully tuned speaker driver support dolby digital plus producing clear dynamic immersive sound amazon work growing number device manufacturer including anker polk audio tonly soundbar solution later year fire tv edition soundbars offer new feature including dolby atmos support compatible device control hdmi switching farfield voice control along partner customizations introducing fire tv edition auto building success fire tv edition smart tv soundbars amazon expanding program automaker partnering bmw fiat chrysler automobile fca handsfree access alexa touch screen interface offline playback capability parent kid alike enjoy living room tv experience car watch wide variety content latest show popular video service worldwide show recorded fire tv recast saved locally ondevice content streamed using vehicle wifi lte connection mobile hotspot wanenabled device adding fire tv future bmw vehicle represents big step bringing best streamed entertainment product amazon approach help garmin able innovate create unique special experience bmw car providing consistency content customer experience fire tv provides home look forward working closely amazon bring fire tv future vehicle said fathi eldwaik vice president user interaction business line car business line life bmw group introducing fire tv edition operator starting today fire tv enabling television telecommunication operator quickly bring fire tv edition device customer customized costeffective way successfully introducing fire tv partnership tata sky india verizon united state fire tv expanding device offering available operator allowing choose best solution fit customer business need well providing merchandising opportunity fire tv edition customer experience fire tv edition operator available today north america europe india japan introducing fire tv edition certified solution provider fire tv enabling partner across variety industry category work certified solution provider rapidly bring latest fire tv edition device customer amazon currently work growing number tv manufacturer produce fire tv edition smart tv vestel arcelik compal tpv others build fire tv edition smart tv customer manufacturing assembly capability around world today amazon announced skyworth latest global odm turnkey solution smart tv turnkey solution enable skyworth odms work world leading tv brand bring highquality differentiated costeffective k fhd smart tv customer starting india brand choose selection manufacturer various industrial design price option bring entire lineup smart tv customer turnkey odm solution offered collaboration amazon includes outofthebox reference design schematic board designed cvte leading lcd tv mainboard provider featurerich k fhd smart tv selfservice tool software customizations setting sdk custom picture audio setting customized industrial design hardware option excited build scalable worldwide smart tv program fire tv edition said tony wang ceo chairman skyworth tv business division odms oems offer customer choice toprated smart tv software experience along speed value highquality hardware always expect skyworth auto partner amazon working leading system integrator voxx automotive garmin deliver solution service significantly accelerate development cycle automaker working amazon enable fire tv invehicle entertainment able create reference implementation automotive oems build vehicle program bring rich entertainment fire tv automotive grade installation said ed ma president voxx automotive division voxx international corporation operator amazon also announced working national cable television cooperative nctc enable member ability deliver low cost fire tv streaming medium player directly customer nctc member including independent cable telecommunication operator delivering service million broadband million video customer aggregate device maker operator interested learning fire tv edition program visit amazon amazon guided four principle customer obsession rather competitor focus passion invention commitment operational excellence longterm thinking customer review click shopping personalized recommendation prime fulfillment amazon aws kindle direct publishing kindle fire tablet fire tv amazon echo alexa product service pioneered amazon information visit follow amazonnews,0.9992,0.4996,0.1248147619,0.3747852381,Positive Impact
07/01/2020,95.225,95.69,94.60,95.34,95.34,80898000,2.13,76.34428766,1.192,0,9.3404,0.9034837908,0.2283735172,1.55,257.971,9068.580078,13898.4502,7573.899902,6012.350098,3104.802002,40869.46875,17168.09961,89.42759995,91.45286743,90.12613424,89.43188585,90.69904938,96.36893162,85.02916714,76.2741049,1.680419136,1.137630463,0.5427886733,1.517250606,89.77403346,7729836000,94.97244623,92.12223208,13.78999996,Ring customers with cameras breached by hackers sue Amazon in proposed class action lawsuit,"An 8-year-old in Mississippi, a Georgia woman lying in bed, a Michigan family watching TV, and dozens of other Ring users were harassed by hackers via their home security cameras ÃÂÃÂ according to a new lawsuit.",https://www.geekwire.com/2020/ring-customers-cameras-breached-hackers-sue-amazon-proposed-class-action-lawsuit/,geekwire.com,5,yearold mississippi georgia woman lying bed michigan family watching tv dozen ring user harassed hacker via home security camera according new lawsuit,-0.7506,-0.3753,0.09552272727,-0.470822727,Negative Impact
08/01/2020,94.902,95.55,94.32,94.60,94.60,70160000,2.13,76.34428766,1.192,0,9.3404,0.9034837908,0.2283735172,1.55,257.971,9129.240234,13934.44043,7574.899902,6031,3066.893066,40817.73828,17167.80078,89.55824005,91.48229496,90.30152125,89.48329497,91.05519943,96.76720998,85.34318888,69.83439325,1.700250504,1.250154471,0.4500960334,1.523572649,90.3660805,7659676000,84.3238141,92.91460882,13.44999981,No more Amazons: Study trashes corporate tax breaks to lure jobs,A new study questions the policy of state and local governments throwing massive tax subsidies at corporations to lure jobs and bolster the economy ÃÂÃÂ and particularly cites the political backlash over Gov. Andrew Cuomo and Mayor Bill de BlasioÃÂÃÂs doomed deal that tried to get Amazon to open a headquarters in Queens.,https://nypost.com/2020/01/08/no-more-amazons-study-trashes-corporate-tax-breaks-to-lure-jobs/,nypost.com,5,new study question policy state local government throwing massive tax subsidy corporation lure job bolster economy particularly cite political backlash gov andrew cuomo mayor bill de blasios doomed deal tried get amazon open headquarters queen,-0.5423,-0.27115,0.1957827273,-0.466932727,Negative Impact
09/01/2020,95.4945,95.89,94.79,95.05,95.05,63346000,2.13,76.34428766,1.192,0,9.3404,0.9034837908,0.2283735172,1.55,257.971,9203.429688,13997.65039,7598.100098,6042.549805,3094.88208,41452.35156,17235.59961,89.68221008,91.51161743,90.48783406,89.53870993,91.45979919,97.09645348,85.82314491,72.69236232,1.732627933,1.346649163,0.3859787693,1.559321812,90.89892282,7723022000,88.33470432,89.21032155,12.53999996,Amazon confirms Ring fired employees for attempting to access customer video data,Amazon confirmed Thursday that its subsidiary Ring fired employees for attempting to access customer video data beyond the scope of their jobs.,https://www.geekwire.com/2020/amazon-confirms-ring-fired-employees-attempting-access-customer-video-data/,geekwire.com,5,amazon confirmed thursday subsidiary ring fired employee attempting access customer video data beyond scope job,-0.4404,-0.2202,0.1360083333,-0.356208333,Negative Impact
10/01/2020,95.2685,95.35,94.00,94.16,94.16,57074000,2.13,76.34428766,1.192,0,9.3404,0.9034837908,0.2283735172,1.55,257.971,9178.860352,13957.96973,7587.899902,6037.109863,3092.291016,41599.71875,17234.5,89.80266006,91.5409824,90.63176203,89.58467298,91.7958992,97.21994728,86.37185112,66.98818054,1.666893632,1.410698057,0.2561955751,1.587929317,91.49797195,7665948000,74.39607918,82.35153253,12.56000042,Amazon has fired an employee for leaking user email addresses and phone numbers,"Amazon has fired an employee after it shared user email address and phone number with a third-party ÃÂÃÂin violation of our policies,ÃÂÃÂ according to an email seen by TechCrunch.",https://techcrunch.com/2020/01/10/amazon-employee-emal-address/,techcrunch.com,5,amazon fired employee shared user email address phone number thirdparty violation policy according email seen techcrunch,-0.5267,-0.26335,0.2403690909,-0.503719091,Negative Impact
13/01/2020,94.5655,94.90,94.04,94.57,94.57,55616000,2.13,76.34428766,1.192,0,9.3404,0.9034837908,0.2283735172,1.55,257.971,9273.929688,14042.65039,7617.600098,6036.140137,3115.570068,41859.69141,17293.40039,89.91397018,91.57045242,90.78600675,89.6342285,92.1233242,97.37461705,86.87203136,69.41892894,1.628864121,1.45433127,0.174532851,1.576072148,92.02513517,7721564000,80.10656319,80.94578223,12.31999969,"India orders antitrust probe against Amazon, Walmart's Flipkart","India's antitrust body has ordered an investigation into alleged competition law violations by Amazon.com Inc and Walmart's Flipkart, it said in an order on Monday.",https://www.reuters.com/article/us-india-antitrust-ecommerce/india-orders-antitrust-probe-against-amazon-walmarts-flipkart-idUSKBN1ZC1BO,reuters.com,10,india antitrust body ordered investigation alleged competition law violation amazoncom inc walmarts flipkart said order monday,-0.4939,-0.4939,0.08920705882,-0.583107059,Negative Impact
14/01/2020,94.294,94.36,92.93,93.47,93.47,68818000,2.13,76.34428766,1.192,0,9.3404,0.9034837908,0.2283735172,1.55,257.971,9251.330078,14037.12988,7622.399902,6040.890137,3106.820068,41952.62891,17352.90039,90.00675018,91.59262493,90.89133982,89.67241528,92.39457436,97.30894243,87.48020628,63.40111509,1.493315297,1.462128075,0.031187222,1.662715367,92.48903881,7652746000,62.8532197,72.45195403,12.39000034,"Bundesliga nutzt AWS, um Zuschauererfahrung beim FuÃÂÃÂball zu revolutionieren","SEATTLE--(BUSINESS WIRE)--Amazon Web Services, Inc. (AWS), ein Unternehmen von Amazon.com (NASDAQ: AMZN), meldete heute, dass sich die deutsche Bundesliga fÃÂÃÂ¼r AWS als seinen offiziellen Technologieanbieter entschieden habe, um tiefere Einblicke in jede Live-ÃÂÃÂbertragung von Bundesliga-Spielen zu bieten und neue personalisierte Fanerlebnisse zu ermÃÂÃÂ¶glichen. Die Bundesliga wird kÃÂÃÂ¼nstliche Intelligenz (KI), maschinelles Lernen (ML), Analytik, Computing, Datenbanken und Speicherdienste von AWS nutzen, um Echtzeit-Statistiken zu liefern. So sollen zukÃÂÃÂ¼nftige Spiele und Spieleergebnisse prognostiziert und personalisiertes Bildmaterial von Spielen bei Mobil-, Online-, Streaming- und FernsehÃÂÃÂ¼bertragungen bereitgestellt werden. Mit der Technologie von AWS wird die deutsche Bundesliga neue cloudbasierte Dienste entwickeln, die Prozesse automatisieren, die operative Effizienz steigern und die Zuschauererfahrung fÃÂÃÂ¼r die schnell wachsende internationale Fangemeinde der Liga verbessern. Durch die Entwicklung einer neuen Statistikplattform der nÃÂÃÂ¤chsten Generation auf AWS mit Amazon SageMaker ÃÂÃÂ ein vollstÃÂÃÂ¤ndig verwalteter Dienst fÃÂÃÂ¼r den Aufbau, das Schulen und den Einsatz von ML-Modellen ÃÂÃÂ wird die Bundesliga Fans anhand von Live-DatenstrÃÂÃÂ¶men und historischen Daten von ÃÂÃÂ¼ber 10.000 Bundesliga-Spielen Echtzeit-Prognosen zum Zeitpunkt mÃÂÃÂ¶glicher Tore bieten, potenzielle Torchancen identifizieren und aufzeigen, wie Mannschaften aufgestellt sind und das Spielfeld kontrollieren. Die Bundesliga plant auch, ML-Dienste von AWS zu nutzen, wie z. B. Amazon Personalize ÃÂÃÂ ein ML-Dienst, mit dem Echtzeit- und persÃÂÃÂ¶nliche Empfehlungen erstellt werden kÃÂÃÂ¶nnen. Dadurch kann Fans je nach Lieblingsmannschaft, -spielern oder -spielen personalisiertes Filmmaterial von Spielen sowie personalisierte Marketingaktionen und Suchergebnisse geboten werden. Mit weiteren ML-Diensten von AWS, darunter Amazon Rekognition ÃÂÃÂ ein intelligenter Bild- und Videoanalysedienst ÃÂÃÂ wird die Bundesliga ein cloudbasiertes Medienarchiv anlegen, das von seinen ÃÂÃÂ¼ber 150.000 Stunden Aufnahmematerial automatisch spezifische Einzelbilder mit Metadaten markieren wird, wie z. B. Spiel, Trikot, Spieler, Mannschaft und Austragungsort. Die Bundesliga kann dann problemlos historisches Aufnahmematerial nach entscheidenden Spielen fÃÂÃÂ¼r Ausstrahlungen wÃÂÃÂ¤hrend Spielen in 200 LÃÂÃÂ¤ndern durchsuchen. Das Archiv wird der Bundesliga ermÃÂÃÂ¶glichen, sein Bildmaterial der gesamten Geschichte des FuÃÂÃÂballs zu durchsuchen, um Fans eine besseres Zuschauererlebnis zu bieten und den aktuell manuellen Such- und Markierprozess von Spielehighlights zu automatisieren. ÃÂÃÂWir freuen uns sehr gemeinsam mit AWS die nÃÂÃÂ¤chste Generation der Zuschauererfahrung beim FuÃÂÃÂball zu entwickelnÃÂÃÂ, so Christian Seifert, CEO der Bundesliga. ÃÂÃÂInnovationen fordern den Status quo heraus. Die enge Zusammenarbeit mit AWS, eines der innovativsten Technologieunternehmen der Welt, verbessert unsere Innovationsinvestitionen der letzten zwei Jahrzehnte drastisch, sodass wir letztlich unseren Fans ein erstklassiges FuÃÂÃÂballerlebnis bieten kÃÂÃÂ¶nnen.ÃÂÃÂ ÃÂÃÂAls Liga mit den durchschnittlich meisten Toren pro Spiel und den weltweit hÃÂÃÂ¶chsten Besucherzahlen in den Stadien zÃÂÃÂ¤hlt die Bundesliga zu einer der unterhaltsamsten Sportligen der WeltÃÂÃÂ, so Andy Isherwood, VizeprÃÂÃÂ¤sident und Managing Director fÃÂÃÂ¼r EMEA bei Amazon Web Services, Inc. ÃÂÃÂWir freuen uns sehr, mit der Bundesliga zusammenarbeiten zu dÃÂÃÂ¼rfen, um ihr zu zeigen, wie Fans auf der ganzen Welt durch den Einsatz von Cloud-Technologie ein fesselnderer Spieltag geboten werden kann. Wir freuen uns auch, ihnen unser umfassendes Portfolio von ML- und KI-Diensten bereitzustellen, sodass noch bessere Einblicke in das beliebteste Spiel der Welt geliefert werden kÃÂÃÂ¶nnen.ÃÂÃÂ FuÃÂÃÂballfans kÃÂÃÂ¶nnen mit den AWS-basierten Statistiken sÃÂÃÂ¤mtlichen Bundesligaereignissen auf Bundesliga.com und den offiziellen KanÃÂÃÂ¤len auf Facebook, Twitter und Instagram folgen. ÃÂÃÂber Amazon Web Services Seit 13 Jahren ist Amazon Web Services die umfassendste und am weitesten verbreitete Cloud-Plattform der Welt. AWS bietet ÃÂÃÂ¼ber 175 voll ausgestattete Dienste fÃÂÃÂ¼r Computing, Speicher, Datenbanken, Networking, Analytik, Robotertechnik, maschinelles Lernen und kÃÂÃÂ¼nstliche Intelligenz (KI), das Internet der Dinge (Internet of Things, IoT), mobile Technologien, Sicherheit, Hybrid, Virtual und Augmented Reality (VR und AR), Medien und Anwendungsentwicklung, Bereitstellung sowie Management aus 69 VerfÃÂÃÂ¼gbarkeitszonen (Availability Zones, AZs) in 22 geografischen Regionen. PlÃÂÃÂ¤ne fÃÂÃÂ¼r weitere 13 VerfÃÂÃÂ¼gbarkeitszonen und vier weitere AWS-Regionen in Indonesien, Italien, SÃÂÃÂ¼dafrika und Spanien wurden angekÃÂÃÂ¼ndigt. Millionen von Kunden ÃÂÃÂ darunter die am schnellsten wachsenden Start-ups, grÃÂÃÂ¶ÃÂÃÂten Unternehmen und fÃÂÃÂ¼hrenden RegierungsbehÃÂÃÂ¶rden ÃÂÃÂ vertrauen AWS, um ihre Infrastruktur mit Strom zu versorgen, agiler zu werden und Kosten zu senken. Mehr Informationen zu AWS erhalten Sie unter aws.amazon.com. ÃÂÃÂber Amazon Amazon orientiert sich an vier GrundsÃÂÃÂ¤tzen: Orientierung am Kunden statt an der Konkurrenz, Leidenschaft fÃÂÃÂ¼r Neuerungen, Einsatz fÃÂÃÂ¼r betriebliche Optimierung sowie langfristiges Denken. Kundenrezensionen, 1-Klick-EinkÃÂÃÂ¤ufe, persÃÂÃÂ¶nliche Empfehlungen, Prime, Versand durch Amazon, AWS, Kindle Direct Publishing, Kindle, Fire-Tablets, Fire TV, Amazon Echo und Alexa sind nur einige der von Amazon angebotenen Produkte und Dienstleistungen. FÃÂÃÂ¼r weitere Informationen besuchen Sie amazon.com/about und folgen Sie @AmazonNews. ÃÂÃÂber die Bundesliga Die Bundesliga ist die hÃÂÃÂ¶chste professionelle Spielklasse im deutschen FuÃÂÃÂball und die FuÃÂÃÂballliga mit den weltweit durchschnittlich hÃÂÃÂ¶chsten Besucherzahlen in den Stadien. Die Liga wurde 1963 gegrÃÂÃÂ¼ndet und besteht aus 18 Mannschaften, die zusammen mit der 2. Bundesliga nach einem Abstiegs- bzw. Aufstiegssystem organisiert sind. Die Spiele der Bundesliga, die der DFL (Deutsche FuÃÂÃÂball Liga) angehÃÂÃÂ¶rt, werden in ÃÂÃÂ¼ber 200 LÃÂÃÂ¤ndern im Fernsehen ÃÂÃÂ¼bertragen. Die Ausgangssprache, in der der Originaltext verÃÂÃÂ¶ffentlicht wird, ist die offizielle und autorisierte Version. ÃÂÃÂbersetzungen werden zur besseren VerstÃÂÃÂ¤ndigung mitgeliefert. Nur die Sprachversion, die im Original verÃÂÃÂ¶ffentlicht wurde, ist rechtsgÃÂÃÂ¼ltig. Gleichen Sie deshalb ÃÂÃÂbersetzungen mit der originalen Sprachversion der VerÃÂÃÂ¶ffentlichung ab.",https://www.businesswire.com/news/home/20200114005409/de/,businesswire.com,5,seattlebusiness wireamazon web service inc aws ein unternehmen von amazoncom nasdaq amzn meldete heute das sich die deutsche bundesliga fr aws al seinen offiziellen technologieanbieter entschieden habe um tiefere einblicke jede livebertragung von bundesligaspielen zu bieten und neue personalisierte fanerlebnisse zu ermglichen die bundesliga wird knstliche intelligenz ki maschinelles lernen ml analytik computing datenbanken und speicherdienste von aws nutzen um echtzeitstatistiken zu liefern sollen zuknftige spiele und spieleergebnisse prognostiziert und personalisiertes bildmaterial von spielen bei mobil online streaming und fernsehbertragungen bereitgestellt werden mit der technologie von aws wird die deutsche bundesliga neue cloudbasierte dienste entwickeln die prozesse automatisieren die operative effizienz steigern und die zuschauererfahrung fr die schnell wachsende internationale fangemeinde der liga verbessern durch die entwicklung einer neuen statistikplattform der nchsten generation auf aws mit amazon sagemaker ein vollstndig verwalteter dienst fr den aufbau da schulen und den einsatz von mlmodellen wird die bundesliga fan anhand von livedatenstrmen und historischen daten von ber bundesligaspielen echtzeitprognosen zum zeitpunkt mglicher tore bieten potenzielle torchancen identifizieren und aufzeigen wie mannschaften aufgestellt sind und da spielfeld kontrollieren die bundesliga plant auch mldienste von aws zu nutzen wie z b amazon personalize ein mldienst mit dem echtzeit und persnliche empfehlungen erstellt werden knnen dadurch kann fan je nach lieblingsmannschaft spielern oder spielen personalisiertes filmmaterial von spielen sowie personalisierte marketingaktionen und suchergebnisse geboten werden mit weiteren mldiensten von aws darunter amazon rekognition ein intelligenter bild und videoanalysedienst wird die bundesliga ein cloudbasiertes medienarchiv anlegen da von seinen ber stunden aufnahmematerial automatisch spezifische einzelbilder mit metadaten markieren wird wie z b spiel trikot spieler mannschaft und austragungsort die bundesliga kann dann problemlos historisches aufnahmematerial nach entscheidenden spielen fr ausstrahlungen whrend spielen lndern durchsuchen da archiv wird der bundesliga ermglichen sein bildmaterial der gesamten geschichte de fuballs zu durchsuchen um fan eine besseres zuschauererlebnis zu bieten und den aktuell manuellen und markierprozess von spielehighlights zu automatisieren wir freuen un sehr gemeinsam mit aws die nchste generation der zuschauererfahrung beim fuball zu entwickeln christian seifert ceo der bundesliga innovationen fordern den status quo heraus die enge zusammenarbeit mit aws eines der innovativsten technologieunternehmen der welt verbessert unsere innovationsinvestitionen der letzten zwei jahrzehnte drastisch sodass wir letztlich unseren fan ein erstklassiges fuballerlebnis bieten knnen al liga mit den durchschnittlich meisten toren pro spiel und den weltweit hchsten besucherzahlen den stadien zhlt die bundesliga zu einer der unterhaltsamsten sportligen der welt andy isherwood vizeprsident und managing director fr emea bei amazon web service inc wir freuen un sehr mit der bundesliga zusammenarbeiten zu drfen um ihr zu zeigen wie fan auf der ganzen welt durch den einsatz von cloudtechnologie ein fesselnderer spieltag geboten werden kann wir freuen un auch ihnen unser umfassendes portfolio von ml und kidiensten bereitzustellen sodass noch bessere einblicke da beliebteste spiel der welt geliefert werden knnen fuballfans knnen mit den awsbasierten statistiken smtlichen bundesligaereignissen auf bundesligacom und den offiziellen kanlen auf facebook twitter und instagram folgen ber amazon web service seit jahren ist amazon web service die umfassendste und weitesten verbreitete cloudplattform der welt aws bietet ber voll ausgestattete dienste fr computing speicher datenbanken networking analytik robotertechnik maschinelles lernen und knstliche intelligenz ki da internet der dinge internet thing iot mobile technologien sicherheit hybrid virtual und augmented reality vr und ar medien und anwendungsentwicklung bereitstellung sowie management au verfgbarkeitszonen availability zone az geografischen regionen plne fr weitere verfgbarkeitszonen und vier weitere awsregionen indonesien italien sdafrika und spanien wurden angekndigt millionen von kunden darunter die schnellsten wachsenden startup grten unternehmen und fhrenden regierungsbehrden vertrauen aws um ihre infrastruktur mit strom zu versorgen agiler zu werden und kosten zu senken mehr informationen zu aws erhalten sie unter awsamazoncom ber amazon amazon orientiert sich vier grundstzen orientierung kunden statt der konkurrenz leidenschaft fr neuerungen einsatz fr betriebliche optimierung sowie langfristiges denken kundenrezensionen klickeinkufe persnliche empfehlungen prime versand durch amazon aws kindle direct publishing kindle firetablets fire tv amazon echo und alexa sind nur einige der von amazon angebotenen produkte und dienstleistungen fr weitere informationen besuchen sie amazoncomabout und folgen sie amazonnews ber die bundesliga die bundesliga ist die hchste professionelle spielklasse im deutschen fuball und die fuballliga mit den weltweit durchschnittlich hchsten besucherzahlen den stadien die liga wurde gegrndet und besteht au mannschaften die zusammen mit der bundesliga nach einem abstiegs bzw aufstiegssystem organisiert sind die spiele der bundesliga die der dfl deutsche fuball liga angehrt werden ber lndern im fernsehen bertragen die ausgangssprache der der originaltext verffentlicht wird ist die offizielle und autorisierte version bersetzungen werden zur besseren verstndigung mitgeliefert nur die sprachversion die im original verffentlicht wurde ist rechtsgltig gleichen sie deshalb bersetzungen mit der originalen sprachversion der verffentlichung ab,-0.9985,-0.49925,0.1163147826,-0.615564783,Negative Impact
15/01/2020,93.6125,93.94,92.75,93.10,93.10,57932000,2.13,76.34428766,1.192,0,9.3404,0.9034837908,0.2283735172,1.55,257.971,9258.700195,14053.23047,7642.799805,6032.609863,3090.040039,41872.73047,17415.19922,90.07733017,91.60458241,90.97799308,89.70653053,92.62659912,97.1841312,88.06906705,62.60427909,1.340502622,1.437802985,-0.097300363,1.719072069,95.89099884,7594814000,52.83974404,65.26650898,12.42000008,Jeff Bezos: Anyone who denies reality of climate change is 'not being reasonable',"Speaking at Amazon's Smbhav summit in New Delhi, India, Bezos described climate change as a big problem and warned that Earth is ""a finite planet.""",https://www.cnbc.com/2020/01/15/jeff-bezos-anyone-who-denies-climate-change-is-not-being-reasonable.html,cnbc.com,9,speaking amazon smbhav summit new delhi india bezos described climate change big problem warned earth finite planet,-0.4767,-0.42903,0.1667776471,-0.595807647,Negative Impact
16/01/2020,94.1495,94.28,93.30,93.90,93.90,53190000,2.13,76.34428766,1.192,0,9.3404,0.9034837908,0.2283735172,1.55,257.971,9357.129883,14141.78027,7609.799805,6039.029785,3074.081055,41932.55859,17484.80078,90.1506102,91.62057243,91.09246406,89.74822678,92.84479942,97.19170502,88.49789383,52.03607247,1.269000202,1.404042428,-0.135042226,1.513072423,95.82826889,7648004000,53.40582113,56.36626162,12.31999969,Peter Navarro puts Amazon and eBay on notice: The China trade deal cracks down on counterfeits,"""We don't love regulations in this administration, but what we do love is corporations accepting their appropriate responsibility,"" the Trump trade advisor said.",https://www.cnbc.com/2020/01/16/navarro-to-amazon-ebay-china-trade-deal-cracks-down-on-counterfeits.html,cnbc.com,9,dont love regulation administration love corporation accepting appropriate responsibility trump trade advisor said,-0.6293,-0.56637,0.09125571429,-0.657625714,Negative Impact
17/01/2020,94.2945,94.33,92.86,93.24,93.24,79946000,2.13,76.34428766,1.192,0,9.3404,0.9034837908,0.2283735172,1.55,257.971,9388.94043,14183.2002,7674.600098,6100.720215,3075.496094,41945.37109,17559,90.21362015,91.63157742,91.1765243,89.78293099,93.04652443,97.04177401,89.05127484,48.92999661,1.145788654,1.352391673,-0.206603019,1.491643633,95.76679354,7568058000,37.96000157,48.06852225,12.10000038,"Please Stop Big Tech, Small Rivals Tell Lawmakers","Until Friday, few executives had complained in public about how Google, Apple, Amazon and Facebook hurt their businesses.",https://www.nytimes.com/2020/01/17/technology/antitrust-hearing-boulder-colorado.html,nytimes.com,5,friday executive complained public google apple amazon facebook hurt business,-0.6597,-0.32985,0.3158338889,-0.645683889,Negative Impact
21/01/2020,93.25,94.71,93.00,94.60,94.60,74156000,2.13,76.34428766,1.192,0,9.3404,0.9034837908,0.2283735172,1.55,257.971,9370.80957,14109.98047,7610.700195,6045.990234,3052.139893,41323.80859,17572.30078,90.30985016,91.6498624,91.31077819,89.83086201,93.29582443,97.00094545,89.59070341,59.32987657,1.145006959,1.31091473,-0.165907771,1.45910808,95.7065477,7642214000,69.83288229,53.73290166,12.85000038,"Bezos Pumps in Another $1 Billion in India, But Amazon Gets the Cold Shoulder","The Indian government isn't impressed with the e-commerce giant, and that could be bad news for expansion efforts in the country.",https://www.fool.com/investing/2020/01/21/bezos-pumps-1-billion-india-but-amazon-criticized.aspx,fool.com,7,indian government isnt impressed ecommerce giant could bad news expansion effort country,-0.7231,-0.50617,0.09653076923,-0.602700769,Negative Impact
22/01/2020,94.8045,95.13,94.17,94.37,94.37,64326000,2.13,76.34428766,1.192,0,9.3404,0.9034837908,0.2283735172,1.55,257.971,9383.769531,14110.24023,7571.899902,6010.97998,3060.754883,41115.37891,17599.90039,90.40911011,91.66240742,91.43086536,89.87605742,93.54822464,96.77072284,90.32572644,58.07451137,1.113237955,1.271379375,-0.15814142,1.452429635,95.64750677,7577888000,51.60213764,53.13167383,12.90999985,"Amazon Stock Slowing Its Role, Will Under-Perform This Year",Competitive pressures have caused AMZN stock to fall flat over the past 20 months. Those pressures are only going to get bigger in 2020.,https://investorplace.com/2020/01/amazon-stock-slowing-its-role-will-under-perform-this-year/,investorplace.com,6,competitive pressure caused amzn stock fall flat past month pressure going get bigger,-0.4019,-0.24114,0.2460442857,-0.487184286,Negative Impact
23/01/2020,94.2555,94.50,93.64,94.23,94.23,49692000,2.13,76.34428766,1.192,0,9.3404,0.9034837908,0.2283735172,1.55,257.971,9402.480469,14102.04004,7507.700195,5971.790039,2976.528076,41386.39844,17621.80078,90.50781006,91.67108742,91.54059599,89.91937025,93.77717438,96.43464831,91.11970044,46.60944279,1.064173674,1.229938235,-0.165764561,1.334751129,95.58964666,7528196000,47.01087551,56.14863182,12.97999954,Amazon Asks Court To Pause Microsoft Work On $10 Billion Pentagon Cloud Deal,"Amazon.com asked a court to temporarily block Microsoft from working on a $10 billion Pentagon cloud contract until a lawsuit challenging its validity is resolved. The company's cloud unit, Amazon Web Services,.",https://www.investors.com/news/amazon-law-microsoft-trade-deal/,investors.com,5,amazoncom asked court temporarily block microsoft working billion pentagon cloud contract lawsuit challenging validity resolved company cloud unit amazon web service,-0.2023,-0.10115,0.2187936364,-0.319943636,Negative Impact
24/01/2020,94.5685,94.75,92.37,93.08,93.08,75324000,2.13,76.34428766,1.192,0,9.3404,0.9034837908,0.2283735172,1.55,257.971,9314.910156,13978.46973,7586,6024.259766,2976.528076,41613.19141,17565.30078,90.59780014,91.67753742,91.60104323,89.95083921,93.95824928,95.71977647,92.1967221,46.63301182,0.9221074416,1.168372076,-0.246264635,1.38489369,95.53294375,7452872000,20.1761765,39.59639655,14.56000042,Driver Abuse Complaints Continue To Follow Amazon,"A Tennessee truck driver alleged he was coerced into violating federal hours-of-service (HOS) laws while hauling freight for Amazon.com, Inc. through his employer, leading to injuries he sustained after crashing his truck.",https://www.benzinga.com/news/20/01/15177298/driver-abuse-complaints-continue-to-follow-amazon,benzinga.com,5,tennessee truck driver alleged coerced violating federal hoursofservice ho law hauling freight amazoncom inc employer leading injury sustained crashing truck,-0.8316,-0.4158,0.168957,-0.584757,Negative Impact
27/01/2020,91,92.05,90.77,91.42,91.42,70570000,2.13,76.34428766,1.192,0,9.3404,0.9034837908,0.2283735172,1.55,257.971,9139.30957,13769.59961,7412.100098,5863.02002,2976.528076,41155.12109,17442.5,90.64814011,91.67278992,91.59382584,89.96542787,93.8571743,95.94587228,91.76847632,31.67113284,0.6674730565,1.068192272,-0.400719216,1.394215175,95.40650607,7382302000,12.68543045,26.62416082,18.22999954,"Amazon Employees Publicly Condemn Company's Communications, Climate Policies",More than 350 employees at Amazon.com Inc. (NASDAQ: AMZN) issued public statements about the company violating its communications policy on Sunday in a show of solidarity with their colleagues who were threatened with termination for doing the very same thing.,https://www.benzinga.com/news/20/01/15186684/amazon-employees-publicly-condemn-companys-communications-climate-policies,benzinga.com,5,employee amazoncom inc nasdaq amzn issued public statement company violating communication policy sunday show solidarity colleague threatened termination thing,-0.6486,-0.3243,0.1375622727,-0.461862273,Negative Impact
28/01/2020,92.025,92.91,91.50,92.66,92.66,56160000,2.13,76.34428766,1.192,0,9.3404,0.9034837908,0.2283735172,1.55,257.971,9269.679688,13877.61035,7480.700195,5925.819824,2976.528076,40966.85938,17500.90039,90.74828003,91.67508492,91.63573457,89.99226439,93.81579933,95.96697162,91.66462704,38.04788073,0.5597226697,0.9664983518,-0.406775682,1.42250061,95.1281356,7438462000,36.99258353,23.28473016,16.28000069,Amazon and Google sued by reps of legendary songwriters over pirated music on their platforms,"Amazon and Google failed to police their music marketplaces and allowed pirated recordings to proliferate, according to a series of lawsuits filed last week by organizations representing top songwriters.",https://www.geekwire.com/2020/amazon-google-sued-reps-legendary-songwriters-pirated-music-platforms/,geekwire.com,5,amazon google failed police music marketplace allowed pirated recording proliferate according series lawsuit filed last week organization representing top songwriter,-0.4019,-0.20095,0.1611414286,-0.362091429,Negative Impact
29/01/2020,93.2,93.74,92.75,92.90,92.90,41760000,2.13,76.34428766,1.192,0,9.3404,0.9034837908,0.2283735172,1.55,257.971,9275.160156,13843.80957,7483.600098,5954.890137,2976.528076,41198.66016,17511.80078,90.85167999,91.67881992,91.68531367,90.0211971,93.84357452,95.92807135,91.75907769,42.06790449,0.4878703575,0.870772753,-0.382902395,1.411572048,94.86646736,7480222000,41.62769333,30.43523577,16.38999939,The Streaming Wars Move To Madison Avenue,Madison Avenue has had a long and colorful history with product category wars.,https://www.forbes.com/sites/bradadgate/2020/01/29/the-streaming-wars-move-to-madison-avenue/,forbes.com,8,madison avenue long colorful history product category war,-0.5994,-0.47952,0.120312,-0.599832,Negative Impact
30/01/2020,92.9,93.64,92.53,93.53,93.53,126548000,2.13,76.34428766,1.192,0,9.3404,0.9034837908,0.2283735172,1.55,257.971,9298.929688,13861.91992,7382,5871.77002,2976.528076,40913.82031,17490.59961,90.98286987,91.68527241,91.75781104,90.05615033,93.90067444,95.87753587,91.92381301,43.02576814,0.476591139,0.7919364302,-0.315345291,1.39875085,94.62049922,7606770000,60.41478569,46.34502085,15.48999977,Can Amazon Become Your Internet Service Provider?,Comcast and other big cable companies may have something new to worry about.,https://www.fool.com/investing/2020/01/30/can-amazon-disrupt-comcast-and-big-internet.aspx,fool.com,7,comcast big cable company may something new worry,-0.4404,-0.30828,0.2517686364,-0.560048636,Negative Impact
31/01/2020,102.5735,102.79,100.11,100.44,100.44,311346000,2.13,76.34428766,1.192,0,9.3404,0.9034837908,0.2283735172,1.55,257.971,9150.94043,13614.09961,7286,5806.339844,2976.528076,40723.48828,17318.5,91.23905975,91.72169239,92.09813206,90.15943239,94.17744942,97.69407512,90.66082371,68.58054709,1.012909835,0.8361311111,0.1767787239,1.963394165,90.76699829,7918116000,80.44758166,60.83002023,18.84000015,"Amazon (AMZN) Q4 Earnings Crush Estimates, Revenues Up Y/Y","Amazon's (AMZN) fourth-quarter results benefit from Prime momentum, strong holiday sales, robust AWS portfolio and strengthening Alexa features.",https://www.zacks.com/stock/news/742649/amazon-amzn-q4-earnings-crush-estimates-revenues-up-y-y,zacks.com,8,amazon amzn fourthquarter result benefit prime momentum strong holiday sale robust aws portfolio strengthening alexa feature,0.936,0.7488,0.2064227273,0.5423772727,Positive Impact
03/02/2020,100.53,102.43,100.01,100.21,100.21,117834000,2.13,76.34428766,1.192,0,9.3404,0.9034837908,0.2283735172,1.58,258.678,9273.400391,13677.91992,7326.299805,5832.509766,2746.605957,39872.30859,17379.80078,91.49046967,91.7565374,92.41624449,90.25943803,94.50052452,98.9220442,90.07900484,66.88803606,1.403531089,0.9496111067,0.4539199824,2.074287415,91.00737839,7800282000,78.56724357,73.14320364,17.96999931,Goldman Sachs in talks with Amazon to offer small business loans: FT,"Goldman Sachs Group is in advanced talks with Amazon.com Inc to offer small business loans in the United States on the e-commerce giant's lending platform, the Financial Times reported on Monday.",https://www.reuters.com/article/us-goldman-sachs-amazon-com/goldman-sachs-in-talks-with-amazon-to-offer-small-business-loans-ft-idUSKBN1ZX20T,reuters.com,10,goldman sachs group advanced talk amazoncom inc offer small business loan united state ecommerce giant lending platform financial time reported monday,0.5859,0.5859,0.187848125,0.398051875,Positive Impact
04/02/2020,101.494,102.99,100.77,102.48,102.48,105786000,2.13,76.34428766,1.192,0,9.3404,0.9034837908,0.2283735172,1.58,258.678,9467.969727,13862.83984,7439.799805,5935.049805,2783.288086,40789.37891,17512.69922,91.79460968,91.80353237,92.81103873,90.38107046,94.86749954,100.5518661,89.18313296,75.18092283,1.874940432,1.134676972,0.7402634605,2.155894143,91.24295088,7906068000,95.85617065,84.95699863,16.04999924,"Breaking Up Facebook, Google, Apple And Amazon? DonÃÂÃÂt Hold Your Breath","The big tech firms likely should be subject to more oversight, but global economic, financial and political forces make it very unlikely that they'll ever be broken up.",https://www.forbes.com/sites/greatspeculations/2020/02/04/breaking-up-facebook-google-apple-and-amazon-dont-hold-your-breath/,forbes.com,8,big tech firm likely subject oversight global economic financial political force make unlikely theyll ever broken,-0.4767,-0.38136,0.1798388235,-0.561198824,Negative Impact
05/02/2020,103.551,103.55,101.60,101.99,101.99,87524000,2.13,76.34428766,1.192,0,9.3404,0.9034837908,0.2283735172,1.58,258.678,9508.679688,14024.86035,7482.5,5985.399902,2818.087891,41142.66016,17651.59961,92.09976974,91.84167236,93.17113524,90.49661702,95.20002441,101.7184103,88.68163856,74.68425632,2.183823246,1.344506227,0.8393170191,2.210358756,91.71283276,7818544000,87.81678478,87.41339967,15.14999962,Amazon Could Be Vulnerable To Competition And This Is How,New data indicate that a substantial number of good customers of Amazon are not happy. Here's what will make them go elsewhere.,https://www.forbes.com/sites/richardkestenbaum/2020/02/05/amazon-could-be-vulnerable-to-competition-and-this-is-how/,forbes.com,8,new data indicate substantial number good customer amazon happy here make go elsewhere,0.8555,0.6844,0.2072838462,0.4771161538,Positive Impact
06/02/2020,102.051,102.82,101.24,102.51,102.51,63660000,2.13,76.34428766,1.192,0,9.3404,0.9034837908,0.2283735172,1.58,258.678,9572.150391,14034.9502,7504.799805,6038.180176,2866.51001,41306.03125,17757.5,92.40427963,91.87328735,93.53742396,90.61616807,95.59567413,102.8763547,88.31499359,74.28740436,2.442260333,1.564057048,0.8782032847,2.238680158,92.42312295,7882204000,91.86870571,91.84722038,14.96000004,Does AmazonÃÂÃÂs Stock Have More Room To Grow?,"Yes, as per Trefis Price estimate AmazonÃÂÃÂs stock has a fair value of $2,218, which is roughly 10% higher than the current market price. Amazon is one of the worldÃÂÃÂs largest online retailers and dabbles in a broad range of businesses, including its core e-commerce operations, cloud services.",https://www.forbes.com/sites/greatspeculations/2020/02/06/does-amazons-stock-have-more-room-to-grow/,forbes.com,8,yes per trefis price estimate amazon stock fair value roughly higher current market price amazon one world largest online retailer dabbles broad range business including core ecommerce operation cloud service,0.8316,0.66528,0.2761971429,0.3890828571,Positive Impact
07/02/2020,102.0995,104.93,101.91,103.96,103.96,101906000,2.13,76.34428766,1.192,0,9.3404,0.9034837908,0.2283735172,1.58,258.678,9520.509766,13931.92969,7466.700195,6029.75,2875.959961,41141.85156,17655.5,92.70971954,91.91766983,93.94630917,90.74898229,96.04124908,104.2176273,87.86487087,78.95391638,2.732776402,1.797800919,0.9349754835,2.349537441,93.09079572,7984110000,93.20243287,90.96264112,15.47000027,Lifeblood of Amazon merchants threatened as coronavirus infects Chinese workers,Amazon.com Inc sellers are bracing for product shortages as Chinese workers - worried about the fast-spreading coronavirus - may be unable or unwilling to return to idled factories.,https://www.reuters.com/article/us-china-health-amazon-com/lifeblood-of-amazon-merchants-threatened-as-coronavirus-infects-chinese-workers-idUSKBN20114P,reuters.com,10,amazoncom inc seller bracing product shortage chinese worker worried fastspreading coronavirus may unable unwilling return idled factory,-0.4939,-0.4939,0.1665209091,-0.660420909,Negative Impact
10/02/2020,104.2505,106.78,104.25,106.70,106.70,101124000,2.13,76.34428766,1.192,0,9.3404,0.9034837908,0.2283735172,1.58,258.678,9628.389648,13984.48047,7446.899902,6015.669922,2890.488037,40979.62109,17740.59961,93.04668961,91.97558483,94.44627756,90.90765414,96.66812439,106.0675595,87.26868931,80.40065504,3.147143899,2.067669515,1.079474384,2.428287506,94.03765193,8085234000,99.47233159,94.84782339,15.03999996,Amazon challenges India antitrust probe in court: filing,"Amazon.com Inc has begun legal action in India to quash an antitrust investigation against the company, saying it could cause ""irreparable"" loss and damage to its reputation, according to its court filing seen by Reuters.",https://www.reuters.com/article/us-amazon-com-india/amazon-challenges-india-antitrust-probe-in-court-filing-idUSKBN2041EQ,reuters.com,10,amazoncom inc begun legal action india quash antitrust investigation company saying could cause irreparable loss damage reputation according court filing seen reuters,-0.6124,-0.6124,0.238714063,-0.851114063,Negative Impact
11/02/2020,107.545,109.30,106.80,107.54,107.54,114920000,2.13,76.34428766,1.192,0,9.3404,0.9034837908,0.2283735172,1.58,258.678,9638.94043,14054.08008,7499.399902,6054.759766,2901.669922,41216.14063,17777.09961,93.37897964,92.02562733,94.95975691,91.07315013,97.31687431,107.8301902,86.80355843,82.09742015,3.503293246,2.354794261,1.148498985,2.545715877,95.31188662,8200154000,90.51563922,94.39680123,15.18000031,3 Stocks Built to Outlast the Coronavirus Outbreak,"The crisis is only getting worse, and escapism at home is a theme worth exploring.by investors.",https://www.fool.com/investing/2020/02/11/3-stocks-built-to-outlast-the-coronavirus-outbreak.aspx,fool.com,7,crisis getting worse escapism home theme worth exploringby investor,-0.743,-0.5201,0.2089711765,-0.729071176,Negative Impact
12/02/2020,108.16,109.01,107.76,108.00,108.00,66686000,2.13,76.34428766,1.192,0,9.3404,0.9034837908,0.2283735172,1.58,258.678,9725.959961,14136.98047,7534.399902,6104.72998,2926.898926,41565.89844,17832.90039,93.73817963,92.08101982,95.47113899,91.24157649,98.04327431,109.4109068,86.67564177,83.06047801,3.779099149,2.639655239,1.139443911,2.589394161,96.9901603,8266840000,92.99802786,94.32866622,13.73999977,AWS chief says it's 'folklore' that Amazon will destroy competition in any new market it enters,"Andy Jassy, the CEO of Amazon Web Services, pointed to Amazon's failed smartphone launch in 2014, and said that despite Amazon's success in online payments, ""PayPal seems to be doing quite well.""",https://www.cnbc.com/2020/02/12/aws-ceo-andy-jassy-its-folklore-that-amazon-wins-in-new-industries.html,cnbc.com,9,andy jassy ceo amazon web service pointed amazon failed smartphone launch said despite amazon success online payment paypal seems quite well,-0.2035,-0.18315,0.23251,-0.41566,Negative Impact
13/02/2020,107.2495,108.51,107.10,107.49,107.49,60636000,2.13,76.34428766,1.192,0,9.3404,0.9034837908,0.2283735172,1.58,258.678,9711.969727,14099.04004,7452,6093.140137,2906.073975,41459.78906,17821.19922,94.10644958,92.13685734,95.94260412,91.40328717,98.7628994,110.6246738,86.90112497,85.69589597,3.91171516,2.894067223,1.017647937,2.520573207,98.46704114,8206204000,90.26469535,91.25945414,14.14999962,Judge temporarily blocks multibillion-dollar JEDI contract win for Microsoft following Amazon lawsuit,Amazon.com Inc. has won a temporary restraining order from a federal court Thursday to block Microsoft Corp.,https://www.marketwatch.com/story/judge-temporarily-blocks-multibillion-dollar-jedi-contract-win-for-microsoft-following-amazon-lawsuit-2020-02-13,marketwatch.com,8,amazoncom inc temporary restraining order federal court thursday block microsoft corp,-0.4404,-0.35232,0.106965,-0.459285,Negative Impact
14/02/2020,107.784,107.95,106.29,106.74,106.74,52124000,2.13,76.34428766,1.192,0,9.3404,0.9034837908,0.2283735172,1.58,258.678,9731.179688,14097.33984,7409.100098,6069.350098,2917.008057,41257.73828,17848.40039,94.47135956,92.19269485,96.36616866,91.5559261,99.40522423,111.5455828,87.26486568,89.76469475,3.911209583,3.097495695,0.8137138882,2.473608834,99.76669627,8154080000,85.64885967,89.63719429,13.68000031,"Amazon, Flipkart challenge new Indian tax on online sellers","Amazon and Walmart's Flipkart are among online retailers demanding that India scale back a proposed tax on third-party sellers on their platforms, saying the burden of compliance will hurt the fledgling industry, according to a document seen by Reuters.",https://www.reuters.com/article/us-india-budget-tax-ecommerce/amazon-flipkart-challenge-new-indian-tax-on-online-sellers-idUSKBN2082BZ,reuters.com,10,amazon walmarts flipkart among online retailer demanding india scale back proposed tax thirdparty seller platform saying burden compliance hurt fledgling industry according document seen reuters,-0.7579,-0.7579,0.09464,-0.85254,Negative Impact
18/02/2020,106.251,108.30,106.21,107.78,107.78,58912000,2.13,76.34428766,1.192,0,9.3404,0.9034837908,0.2283735172,1.58,258.678,9732.740234,14039.00977,7382,6056.819824,2984.971924,40894.37891,17858.30078,94.86633957,92.25640736,96.81390717,91.71739451,100.1325993,112.4584314,87.80676714,89.65437624,3.949204323,3.267837421,0.6813669022,2.517144339,100.9103928,8212992000,90.97035789,88.9613043,14.82999992,"Amazon Care, the company's virtual medical clinic, is now live for Seattle employees","The company has been working on Amazon Care for several years as a pilot project. The app provides virtual medical consultations, as well as a way to schedule a follow-up visit from a health professional to a patient's home or office.",https://www.cnbc.com/2020/02/18/amazon-care-virtual-medical-clinics-live-for-seattle-employees.html,cnbc.com,9,company working amazon care several year pilot project app provides virtual medical consultation well way schedule followup visit health professional patient home office,0.7184,0.64656,0.37125,0.27531,Positive Impact
19/02/2020,108.39,109.26,108.06,108.51,108.51,51224000,2.13,76.34428766,1.192,0,9.3404,0.9034837908,0.2283735172,1.58,258.678,9817.179688,14087.12988,7457,6111.240234,2975.4021,41323,17925.40039,95.29607956,92.30834736,97.27261675,91.88449507,100.8281494,113.406839,88.24945978,89.91359774,3.992001365,3.412670209,0.5793311553,2.545465197,101.9168457,8264216000,95.30924373,90.64282043,14.38000011,Money Managers Surprisingly Sold These 5 Stocks in the Fourth Quarter,"Institutional investors dumped the FAANG stocks in Q4, but will likely regret their decisions.",https://www.fool.com/investing/2020/02/19/money-managers-surprisingly-sold-these-5-stocks-in.aspx,fool.com,7,institutional investor dumped faang stock q likely regret decision,-0.6705,-0.46935,0.1029642857,-0.572314286,Negative Impact
20/02/2020,108.6535,108.84,106.37,107.66,107.65,62626000,2.13,76.34428766,1.192,0,9.3404,0.9034837908,0.2283735172,1.58,258.678,9750.969727,14061.48047,7436.600098,6062.299805,3030.154053,41170.12109,17944.09961,95.6975795,92.35898487,97.67976899,92.04141551,101.4922493,114.0383971,88.94610151,85.69876197,3.911753793,3.512486926,0.3992668672,2.642179762,102.8025243,8201590000,82.31016496,89.52992219,15.56000042,"Why Amazon Stock Is Headed to $2,500","By some metrics the market has gotten ahead of itself, but it would be a mistake for investors to turn their back on Amazon stock now.",https://investorplace.com/2020/02/why-amazon-stock-is-headed-to-2500/,investorplace.com,6,metric market gotten ahead would mistake investor turn back amazon stock,-0.1779,-0.10674,0.083215,-0.189955,Negative Impact
21/02/2020,107.1075,107.23,104.40,104.80,104.80,92926000,2.13,76.34428766,1.192,0,9.3404,0.9034837908,0.2283735172,1.58,258.678,9576.589844,13975.78027,7403.899902,6029.720215,3039.668945,41170.12109,17843.5,96.04403946,92.40272736,97.95893491,92.16835167,102.0207245,114.1625911,89.87885786,63.86462279,3.57643453,3.525276447,0.05115808314,2.213821956,103.5819215,8108664000,51.5455167,76.38830846,17.07999992,The Talent War: Walmart And Amazon Compete For A Better Workplace,"With unemployment at record lows, the retail industry is facing a talent shortage. And the persistent perception that retail is a ÃÂÃÂlousy jobÃÂÃÂ is pitting Walmart against Amazon once again, this time in the race for talent.",https://www.forbes.com/sites/gregpetro/2020/02/21/the-talent-war-walmart-and-amazon-compete-for-a-better-workplace/,forbes.com,8,unemployment record low retail industry facing talent shortage persistent perception retail lousy job pitting walmart amazon time race talent,-0.4939,-0.39512,0.158824,-0.553944,Negative Impact
24/02/2020,100.159,101.97,99.40,100.46,100.46,130940000,2.13,76.34428766,1.192,0,9.3404,0.9034837908,0.2283735172,1.58,258.678,9221.280273,13534.12012,7156.799805,5791.870117,3031.23291,40363.23047,17562.69922,96.31411942,92.42560738,98.05719238,92.25090042,102.3898495,113.815254,90.9644449,50.64136827,2.927230754,3.405667309,-0.478436554,2.427214486,109.2975006,7977724000,10.76878138,48.20815435,25.03000069,How Amazon's One-Day Shipping Is Raising The Bar To Compete In E-Commerce,"Even as investors are skittish about Amazon.com, Inc. (NASDAQ: AMZN) among broader market coronavirus fears, Morgan Stanley says the company's overnight delivery is changing customer tendencies and increasing expectations across the industry for how quickly stuff should get to your door.",https://www.benzinga.com/analyst-ratings/analyst-color/20/02/15394218/how-amazons-one-day-shipping-is-raising-the-bar-to-compete-in-e-commerce,benzinga.com,5,even investor skittish amazoncom inc nasdaq amzn among broader market coronavirus fear morgan stanley say company overnight delivery changing customer tendency increasing expectation across industry quickly stuff get door,-0.4939,-0.24695,0.108154,-0.355104,Negative Impact
25/02/2020,101.321,101.73,97.92,98.64,98.64,124382000,2.13,76.34428766,1.192,0,9.3404,0.9034837908,0.2283735172,1.58,258.678,8965.610352,13143.73047,7017.899902,5679.680176,3013.050049,40281.19922,17177.40039,96.5381395,92.44382488,98.07992998,92.31444371,102.7508495,113.1242812,92.37741787,40.08353802,2.239453136,3.172424474,-0.932971338,2.500714983,109.0995206,7853342000,6.293703949,22.86933401,27.85000038,Amazon Is Preparing for Coronavirus Troubles. Should Investors?,"Amazon is stocking up on inventory to prevent supply issues if the coronavirus worsens, but will it be enough?",https://www.fool.com/investing/2020/02/25/amazon-worrying-about-coronavirus-should-investors.aspx,fool.com,7,amazon stocking inventory prevent supply issue coronavirus worsens enough,-0.3182,-0.22274,0.141735,-0.364475,Negative Impact
26/02/2020,98.514,100.73,98.02,98.98,98.98,104492000,2.13,76.34428766,1.192,0,9.3404,0.9034837908,0.2283735172,1.58,258.678,8980.780273,13046.62012,7042.5,5684.549805,2987.928955,39888.96094,17041.90039,96.75739944,92.46622738,98.11520723,92.38076267,103.0666996,112.4877447,93.64565454,42.17020917,1.702397033,2.878418986,-1.176021953,2.555000305,108.6523797,7957834000,9.304284437,8.788923255,27.55999947,ReFrame and IMDbPro Award a Record 26 ReFrame Stamp Recipients from the Top 100 Grossing Films of 2019,"LOS ANGELES--(BUSINESS WIRE)--ReFrameTM (ReFrameProject.org), a coalition of industry professionals and partner companies founded by Sundance Institute and Women In Film, whose mission is to increase the number of women of all backgrounds working in film, TV and media ÃÂÃÂ and IMDbPro (imdbpro.com) ÃÂÃÂ the essential resource for entertainment industry professionals ÃÂÃÂ announced today the third class of ReFrame Stamp Feature Film recipients based on an extensive analysis of IMDbPro data on the top 100 domestic-grossing films of 2019. The full list of recipients can be found here. The ReFrame Stamp recognizes gender-balanced narrative and animated features from 2019 that include Booksmart, Captain Marvel, Harriet, Hustlers, and Little Women. The 2019 top 100 results show an uptick from 20 to 26 ReFrame Stamp recipients from 2018, which reflects gains for women in the important roles of director, department heads, and women of color leads and co-leads. In 2019 there were 12 women directors (12 percent) in the top 100 films at the box office as compared to 4 (4 percent) in 2018 ÃÂÃÂ with 4 of those directors being a woman of color. Additionally, the numbers reveal a 17% decrease in women writers with 23 in 2018 to 19 in 2019. There was an increase from zero to 3 women of color writers in 2019 (one woc writer wrote two scripts and is counted once). Additionally of note: 16 of the films that received the stamp were from directors who are men, demonstrating meaningfully that any film can be awarded the stamp if they apply gender-balanced criteria. Alison Emilio, ReFrame Director, added: ÃÂÃÂWe launched the ReFrame Stamp with IMDbPro three years ago as a change lever to promote more inclusive hiring practices at all levels of production. The call to action is simple. Use the ReFrame criteria, improve hiring outcomes, get the stamp.ÃÂÃÂ Director Olivia Wilde, ReFrame Stamp recipient for Booksmart, said: ÃÂÃÂI see the ReFrame Stamp as an important lever for change to help women and people of color break through the boundaries and level the playing field. Stamp criteria helped me focus on who would be best for the job ÃÂÃÂ and I was able to hire an incredibly diverse and balanced crew to curate the environment I always wanted to see on a set.ÃÂÃÂ Director Nisha Ganatra added: ÃÂÃÂWe are so proud to have earned the ReFrame Stamp on Late Night. ItÃÂÃÂs important to all of us to achieve gender parity both in front of and behind the camera and the Stamp shows that a movie has done just that!ÃÂÃÂ The ReFrame Stamp is being adopted and showcased in end credits (for feature films such as Booksmart, Destroyer, Five Feet Apart, Last Christmas, and Late Night, as well as for television and streaming series including GreyÃÂÃÂs Anatomy, The HandmaidÃÂÃÂs Tale, How to Get Away with Murder, Scandal, and Fear the Walking Dead), marketing and publicity materials, social channels, film websites, and ReFrameProject.org. The Stamp also appears on IMDb at IMDb.com/ReFrame and in the ÃÂÃÂAwardsÃÂÃÂ section of IMDb and IMDbPro Title Pages for ReFrame Stamp recipients. The ReFrame Stamp serves as a mark of distinction for film and television and streaming series that have demonstrated success in gender-balanced hiring based on criteria developed by ReFrame in consultation with ReFrame Ambassadors, producers and other industry experts. Stamps are awarded to narrative features and television and streaming series that hire female-identifying people in four out of eight critical areas of their production, including: writer, director, producer, lead, co-lead, speaking parts, department heads and crew. Additional points are awarded to content that has women of color in key positions. The criteria are iterative and will change over time as the industry evolves. For more information or to apply for the ReFrame Stamp, please visit ReFrameProject.org/stamp. 2019 ReFrame Stamp ÃÂÃÂ Top 100-Grossing Narrative & Animated Feature Recipients A DogÃÂÃÂs Way Home / USA 2019 (Director: Charles Martin Smith, Screenwriters: Cathryn Michon, W. Bruce Cameron, Producers: Gavin Polone, Distributor: Sony Pictures Releasing) Abominable / USA 2019 (Director: Jill Culton, Screenwriters: Jill Culton, Producers: Suzanne Buirgy, Peilin Chou, Dave Polsky, Distributor: Universal Pictures) Alita: Battle Angel / USA 2019 (Director: Robert Rodriguez, Screenwriters: Laeta Kalogridis, Producers: James Cameron, Jon Landau, Distributor: 20th Century Fox) Black and Blue / USA 2019 (Director: Deon Taylor, Screenwriters: Peter A. Dowling, Producers: Roxanne Avent, Sean Sorensen, Distributor: Sony Pictures Releasing) Booksmart / USA (Director: Olivia Wilde, Screenwriters: Emily Halpern, Sarah Haskins, Katie Silberman, Producers: Chelsea Barnard, David Distenfeld, Jessica Elbaum, Megan Ellison, Distributor: United Artists Releasing) Breakthrough / USA 2019 (Director: Roxann Dawson, Screenwriters: Grant Nieporte, Producers: DeVon Franklin, Distributor: 20th Century Fox) Captain Marvel / USA 2019 (Director: Anna Boden, Screenwriters: Anna Boden, Geneva Robertson-Dworet, Producers: Kevin Feige, Distributor: Walt Disney Studios Motion Pictures) Cats / USA 2019 (Director: Tom Hooper, Screenwriters: Lee Hall, Tom Hooper, Producers: Tim Bevan, Eric Fellner, Debra Hayward, Tom Hooper, Distributor: Universal Pictures) Dora and the Lost City of Gold / USA 2019 (Director: James Bobin, Screenwriters: Matthew Robinson, Nicholas Stoller, Producers: Kristin Burr, Distributor: Paramount Pictures) Escape Room / USA 2019 (Director: Adam Robitel, Screenwriters: Maria Melnik, Producers: Ori Marmur, Neal H. Moritz, Distributor: Sony Pictures Releasing) Five Feet Apart / USA 2019 (Director: Justin Baldoni, Screenwriters: Mikki Daughtry, Tobias Iaconis, Producers: Cathy Schulman, Distributor: CBS Films / Lionsgate) Frozen 2 / USA 2019 (Director: Jennifer Lee, Chris Buck, Screenwriters: Jennifer Lee, Producers: Peter Del Vecho, Distributor: Walt Disney Studios Motion Pictures) Harriet / USA 2019 (Director: Kasi Lemmons, Screenwriters: Kasi Lemmons, Gregory Allen Howard, Producers: Gregory Allen Howard, Debra Martin Chase, Daniela Lundberg, Distributor: Focus Features) Hustlers / USA 2019 (Director: Lorene Scafaria, Screenwriters: Lorene Scafaria, Producers: Jessica Elbaum, Elaine Goldsmith-Thomas, Jennifer Lopez, Distributor: STX Entertainment) IsnÃÂÃÂt It Romantic / USA 2019 (Director: Todd Strauss-Schulson, Screenwriters: Erin Cardillo, Dana Fox, Katie Silberman, Producers: Gina Matthews, Distributor: Warner Brothers Pictures) Last Christmas / USA 2019 (Director: Paul Feig, Screenwriters: Emma Thompson, Bryony Kimmings, Producers: Paul Feig, Jessie Henderson, David Livingstone, Emma Thompson, Distributor: Universal Pictures) Little / USA 2019 (Director: Tina Gordon, Screenwriters: Tina Gordon, Producers: Kenya Barris, James Lopez, Will Packer, Distributor: Universal Pictures) Little Women / USA 2019 (Director: Greta Gerwig, Screenwriters: Greta Gerwig, Producers: Denise Di Novi, Amy Pascal, Robin Swicord, Distribution: Sony Pictures Releasing) Long Shot / USA 2019 (Director: Jonathan Levine, Screenwriters: Liz Hannah, Producers: Beth Kono, Charlize Theron, Distributor: Lionsgate) Ma / USA 2019 (Director: Tate Taylor, Screenwriters: Scotty Landes, Producers: Jason Blum, John Norris, Tate Taylor, Distributor: Universal Pictures) Queen & Slim / USA 2019 (Director: Melina Matsoukas, Screenwriters: Lena Waithe, Producers: James Frey, Lena Waithe, Melina Matsoukas, Michelle Knudsen, Andrew Coles, Brad Weston, Pamela Abdy, Distributor: Universal Pictures) The Curse of La Llorona / USA 2019 (Director: Michael Chaves, Screenwriters: Mikki Daughtry, Producers: Gary Dauberman, Emile Gladstone, James Wan, Distributor: Warner Brothers Pictures) The Hustle / USA 2019 (Director: Chris Addison, Screenwriters: Jac Schaeffer, Producers: Rebel Wilson, Distributor: United Artists Releasing) UglyDolls / USA 2019 (Director: Kelly Asbury, Screenwriters: Alison Peck, Producers: Jane Hartwell, Distributor: STX Entertainment) Us / USA 2019 (Director: Jordan Peele, Screenwriters: Jordan Peele, Producers: Jason Blum, Distributor: Universal Pictures) What Men Want / USA 2019 (Director: Adam Shankman, Screenwriters: Tina Gordon, Peter Huyck, Alex Gregory, Producers: James Lopez, Will Packer, Distributor: Paramount Pictures) About ReFrame Founded and led by Women In Film and Sundance Institute, ReFrame is an initiative that employs a unique strategy, a peer-to-peer approach, in which ReFrame Ambassadors engage with senior industry decision-makers at over 50 Partner Companies to implement ReFrame programs. The initiativeÃÂÃÂs goals are to provide research, support, and a practical framework that can be used by Partner companies to mitigate bias during the creative decision-making and hiring process, celebrate successes, and measure progress toward a more gender-representative industry on all levels. For more information download the ReFrame Culture Change Handbook or visit ReFrameProject.org. ReFrame is made possible by support from The David and Lura Lovell Foundation; The Harnisch Foundation; Hulu; IMDbPro; Mercer; the Women at Sundance Leadership Council: Ruth Ann Harnisch, Katy Drake Bettner, Barbara Bridges, Abigail Disney, Suzanne Lerner, Cristina Ljungberg, Ann Lovell, Pat Mitchell, Susan Bay Nimoy, Patty Quillin, Brenda Robinson, Kimberly Steward, Lynda Weinman, Jenifer Westphal, and Jacki Zehner; Delta Air Lines; Pritzker Pucker Family Foundation; and an anonymous donor. About Sundance Institute Founded in 1981 by Robert Redford, Sundance Institute is a nonprofit organization that provides and preserves the space for artists in film, theatre, and media to create and thrive. The Institute's signature Labs, granting, and mentorship programs, dedicated to developing new work, take place throughout the year in the U.S. and internationally. Sundance Co//ab, a digital community platform, brings artists together to learn from each other and Sundance Advisors and connect in a creative space, developing and sharing works in progress. The Sundance Film Festival and other public programs connect audiences and artists to ignite new ideas, discover original voices, and build a community dedicated to independent storytelling. Sundance Institute has supported such projects as The Farewell, Late Night, The Souvenir, The Infiltrators, Sorry to Bother You, Eighth Grade, Won't You Be My Neighbor?, Hereditary, RBG, Call Me By Your Name, Get Out, The Big Sick, Top of the Lake, Winter's Bone, Dear White People, Little Miss Sunshine, Beasts of the Southern Wild, Fruitvale Station, State of the Union, Indecent, Spring Awakening, A GentlemanÃÂÃÂs Guide to Love and Murder and Fun Home. Join Sundance Institute on Facebook, Instagram, Twitter and YouTube. About Women In Film, Los Angeles Women In Film advocates for and advances the careers of women working in the screen industriesÃÂÃÂÃÂÃÂto achieve parity and transform culture. Founded in 1973, Women In Film supports all women working in film, TV, and digital media from emerging to advanced career. Our distinguished programs include: mentoring, speaker & screening series, production training program, writing labs, film finishing funds, legal aid and an annual financing intensive. Women In Film advocates for gender parity through research, education and media campaigns. Women In Film honors the achievements of women in Hollywood through the legacy series, annual Emmy and Oscar parties and our signature event, the Crystal + Lucy Awards. Membership is open to all media professionals and more information can be found on our website: wif.org. Follow Women In Film on Facebook, Instagram, Twitter, and YouTube. About IMDbPro IMDbPro (http://www.imdbpro.com) is the essential resource for entertainment industry professionals. This membership-based service includes comprehensive information and tools that are designed to help entertainment industry professionals achieve success throughout all stages of their career. IMDbPro offers members the following: detailed contact and representation information; tools to manage and showcase their IMDb profile, including the ability to select their primary images and the credits they are best ÃÂÃÂknown forÃÂÃÂ; exclusive STARmeter rankings that are determined by page views on IMDb; the IMDbPro app for iPhone and Android; IMDbPro Track, which empowers members using the iPhone app to receive personalized entertainment industry news and notifications on the people and film & TV projects they want to follow; and a convenient tool that generates custom digital assets to promote their work on social media and other platforms. Additional IMDbPro services include Box Office Mojo (http://www.boxofficemojo.com), the leading online source of box-office data. IMDbPro is a division of IMDb (www.imdb.com), the #1 movie website in the world with a combined web and mobile audience of more than 250 million unique monthly visitors. Follow IMDbPro on Facebook (https://www.facebook.com/imdbpro/), Instagram (https://www.instagram.com/imdbpro/) and Twitter (https://twitter.com/imdbpro). About IMDb IMDb is the world's most popular and authoritative source for information on movies, TV shows, and celebrities. Products and services to help fans decide what to watch and where to watch it include: the IMDb website for desktop and mobile devices; apps for iOS and Android; and IMDb X-Ray on Fire TV devices. IMDb also offers a free streaming channel, IMDb TV, and produces IMDb original video series. For entertainment industry professionals, IMDb provides IMDbPro and Box Office Mojo. IMDb is an Amazon company. For more information, visit www.imdb.com/press and follow @IMDb.",https://www.businesswire.com/news/home/20200226005224/en/ReFrame-and-IMDbPro-Award-a-Record-26-ReFrame-Stamp-Recipients-from-the-Top-100-Grossing-Films-of-2019,businesswire.com,5,los angelesbusiness wirereframetm reframeprojectorg coalition industry professional partner company founded sundance institute woman film whose mission increase number woman background working film tv medium imdbpro imdbprocom essential resource entertainment industry professional announced today third class reframe stamp feature film recipient based extensive analysis imdbpro data top domesticgrossing film full list recipient found reframe stamp recognizes genderbalanced narrative animated feature include booksmart captain marvel harriet hustler little woman top result show uptick reframe stamp recipient reflects gain woman important role director department head woman color lead coleads woman director percent top film box office compared percent director woman color additionally number reveal decrease woman writer increase zero woman color writer one woc writer wrote two script counted additionally note film received stamp director men demonstrating meaningfully film awarded stamp apply genderbalanced criterion alison emilio reframe director added launched reframe stamp imdbpro three year ago change lever promote inclusive hiring practice level production call action simple use reframe criterion improve hiring outcome get stamp director olivia wilde reframe stamp recipient booksmart said see reframe stamp important lever change help woman people color break boundary level playing field stamp criterion helped focus would best job able hire incredibly diverse balanced crew curate environment always wanted see set director nisha ganatra added proud earned reframe stamp late night important u achieve gender parity front behind camera stamp show movie done reframe stamp adopted showcased end credit feature film booksmart destroyer five foot apart last christmas late night well television streaming series including grey anatomy handmaid tale get away murder scandal fear walking dead marketing publicity material social channel film website reframeprojectorg stamp also appears imdb imdbcomreframe award section imdb imdbpro title page reframe stamp recipient reframe stamp serf mark distinction film television streaming series demonstrated success genderbalanced hiring based criterion developed reframe consultation reframe ambassador producer industry expert stamp awarded narrative feature television streaming series hire femaleidentifying people four eight critical area production including writer director producer lead colead speaking part department head crew additional point awarded content woman color key position criterion iterative change time industry evolves information apply reframe stamp please visit reframeprojectorgstamp reframe stamp top grossing narrative animated feature recipient dog way home usa director charles martin smith screenwriter cathryn michon w bruce cameron producer gavin polone distributor sony picture releasing abominable usa director jill culton screenwriter jill culton producer suzanne buirgy peilin chou dave polsky distributor universal picture alita battle angel usa director robert rodriguez screenwriter laeta kalogridis producer james cameron jon landau distributor th century fox black blue usa director deon taylor screenwriter peter dowling producer roxanne avent sean sorensen distributor sony picture releasing booksmart usa director olivia wilde screenwriter emily halpern sarah haskins katie silberman producer chelsea barnard david distenfeld jessica elbaum megan ellison distributor united artist releasing breakthrough usa director roxann dawson screenwriter grant nieporte producer devon franklin distributor th century fox captain marvel usa director anna boden screenwriter anna boden geneva robertsondworet producer kevin feige distributor walt disney studio motion picture cat usa director tom hooper screenwriter lee hall tom hooper producer tim bevan eric fellner debra hayward tom hooper distributor universal picture dora lost city gold usa director james bobin screenwriter matthew robinson nicholas stoller producer kristin burr distributor paramount picture escape room usa director adam robitel screenwriter maria melnik producer ori marmur neal h moritz distributor sony picture releasing five foot apart usa director justin baldoni screenwriter mikki daughtry tobias iaconis producer cathy schulman distributor cbs film lionsgate frozen usa director jennifer lee chris buck screenwriter jennifer lee producer peter del vecho distributor walt disney studio motion picture harriet usa director kasi lemmon screenwriter kasi lemmon gregory allen howard producer gregory allen howard debra martin chase daniela lundberg distributor focus feature hustler usa director lorene scafaria screenwriter lorene scafaria producer jessica elbaum elaine goldsmiththomas jennifer lopez distributor stx entertainment isnt romantic usa director todd straussschulson screenwriter erin cardillo dana fox katie silberman producer gina matthew distributor warner brother picture last christmas usa director paul feig screenwriter emma thompson bryony kimmings producer paul feig jessie henderson david livingstone emma thompson distributor universal picture little usa director tina gordon screenwriter tina gordon producer kenya barris james lopez packer distributor universal picture little woman usa director greta gerwig screenwriter greta gerwig producer denise di novi amy pascal robin swicord distribution sony picture releasing long shot usa director jonathan levine screenwriter liz hannah producer beth kono charlize theron distributor lionsgate usa director tate taylor screenwriter scotty landes producer jason blum john norris tate taylor distributor universal picture queen slim usa director melina matsoukas screenwriter lena waithe producer james frey lena waithe melina matsoukas michelle knudsen andrew cole brad weston pamela abdy distributor universal picture curse la llorona usa director michael chaves screenwriter mikki daughtry producer gary dauberman emile gladstone james wan distributor warner brother picture hustle usa director chris addison screenwriter jac schaeffer producer rebel wilson distributor united artist releasing uglydolls usa director kelly asbury screenwriter alison peck producer jane hartwell distributor stx entertainment u usa director jordan peele screenwriter jordan peele producer jason blum distributor universal picture men want usa director adam shankman screenwriter tina gordon peter huyck alex gregory producer james lopez packer distributor paramount picture reframe founded led woman film sundance institute reframe initiative employ unique strategy peertopeer approach reframe ambassador engage senior industry decisionmakers partner company implement reframe program initiative goal provide research support practical framework used partner company mitigate bias creative decisionmaking hiring process celebrate success measure progress toward genderrepresentative industry level information download reframe culture change handbook visit reframeprojectorg reframe made possible support david lura lovell foundation harnisch foundation hulu imdbpro mercer woman sundance leadership council ruth ann harnisch katy drake bettner barbara bridge abigail disney suzanne lerner cristina ljungberg ann lovell pat mitchell susan bay nimoy patty quillin brenda robinson kimberly steward lynda weinman jenifer westphal jacki zehner delta air line pritzker pucker family foundation anonymous donor sundance institute founded robert redford sundance institute nonprofit organization provides preserve space artist film theatre medium create thrive institute signature lab granting mentorship program dedicated developing new work take place throughout year u internationally sundance coab digital community platform brings artist together learn sundance advisor connect creative space developing sharing work progress sundance film festival public program connect audience artist ignite new idea discover original voice build community dedicated independent storytelling sundance institute supported project farewell late night souvenir infiltrator sorry bother eighth grade wont neighbor hereditary rbg call name get big sick top lake winter bone dear white people little miss sunshine beast southern wild fruitvale station state union indecent spring awakening gentleman guide love murder fun home join sundance institute facebook instagram twitter youtube woman film los angeles woman film advocate advance career woman working screen industriesto achieve parity transform culture founded woman film support woman working film tv digital medium emerging advanced career distinguished program include mentoring speaker screening series production training program writing lab film finishing fund legal aid annual financing intensive woman film advocate gender parity research education medium campaign woman film honor achievement woman hollywood legacy series annual emmy oscar party signature event crystal lucy award membership open medium professional information found website wiforg follow woman film facebook instagram twitter youtube imdbpro imdbpro essential resource entertainment industry professional membershipbased service includes comprehensive information tool designed help entertainment industry professional achieve success throughout stage career imdbpro offer member following detailed contact representation information tool manage showcase imdb profile including ability select primary image credit best known exclusive starmeter ranking determined page view imdb imdbpro app iphone android imdbpro track empowers member using iphone app receive personalized entertainment industry news notification people film tv project want follow convenient tool generates custom digital asset promote work social medium platform additional imdbpro service include box office mojo leading online source boxoffice data imdbpro division imdb movie website world combined web mobile audience million unique monthly visitor follow imdbpro facebook instagram twitter imdb imdb world popular authoritative source information movie tv show celebrity product service help fan decide watch watch include imdb website desktop mobile device apps io android imdb xray fire tv device imdb also offer free streaming channel imdb tv produce imdb original video series entertainment industry professional imdb provides imdbpro box office mojo imdb amazon company information visit follow imdb,0.9993,0.49965,0.1366253333,0.3630246667,Positive Impact
27/02/2020,96.719,98.75,94.14,94.22,94.21,162880000,2.13,76.34428766,1.192,0,9.3404,0.9034837908,0.2283735172,1.58,258.678,8566.480469,12547.25,6796.399902,5495.600098,2991.330078,39745.66016,16717.40039,96.88075943,92.48163235,97.96225778,92.39901375,103.1324493,112.2687951,93.99610355,32.34299157,0.8821516951,2.479165528,-1.597013833,2.788321359,108.2231244,7794954000,0.5079049374,5.368631108,39.15999985,"Amazon Go Grocery: This Is The Future Of Shopping, Whether We Like It OrNot","Amazon has unveiled its Amazon Go Grocery in Seattle, expanding the initial concept of a store without tills to a practically complete supermarket with sections of various types, including fresh products. Just another step in a process that, whether some like it or not, is called progress.",https://www.forbes.com/sites/enriquedans/2020/02/27/amazon-go-grocery-this-is-the-future-of-shopping-whether-we-like-it-ornot/,forbes.com,8,amazon unveiled amazon go grocery seattle expanding initial concept store without till practically complete supermarket section various type including fresh product another step process whether like called progress,0.8402,0.67216,0.1479455556,0.5242144444,Positive Impact
28/02/2020,90.7315,94.49,90.56,94.19,94.19,189620000,2.13,76.34428766,1.192,0,9.3404,0.9034837908,0.2283735172,1.58,258.678,8567.370117,12380.96973,6580.600098,5309.899902,2880.303955,38297.28906,16263.09961,96.99529938,92.49253986,97.81422806,92.41680964,103.1651245,112.1605191,94.16972992,27.84966136,0.2272628853,2.028784999,-1.801522114,2.853321075,107.3780169,7605334000,19.37461835,9.728935907,40.11000061,Amazon pulls the plug on coronavirus price gougers,"Amazon said it has pulled down ÃÂÃÂtens of thousandsÃÂÃÂ listings for face masks whose sellers have been price gouging amid the coronavirus panic. Some merchants have been looking to take advantage of the crisis amid growing anxiety about the global epidemic, which has infected more than 80,000 people around the world and killed nearly 3,000,.",https://nypost.com/2020/02/28/amazon-pulls-the-plug-on-coronavirus-price-gougers/,nypost.com,5,amazon said pulled ten thousand listing face mask whose seller price gouging amid coronavirus panic merchant looking take advantage crisis amid growing anxiety global epidemic infected people around world killed nearly,-0.9246,-0.4623,0.04652928571,-0.508829286,Negative Impact
02/03/2020,95.3245,97.73,93.50,97.70,97.70,135234000,2.13,76.34428766,1.192,0,9.3404,0.9034837908,0.2283735172,0.65,258.115,8952.169922,12827.99023,6654.899902,5333.52002,2970.930908,38144.01953,16553.30078,97.15858948,92.51323986,97.80965058,92.46935384,103.0281998,112.2782709,93.77812861,30.30813444,-0.008416358,1.621344728,-1.629761086,2.953999656,106.0322958,7740568000,38.10362234,19.32871521,33.41999817,Amazon Fights Back Against Fake Coronavirus Products,"Consumers are looking for answers, which makes them susceptible to fraud.",https://www.fool.com/investing/2020/03/02/amazon-fights-back-against-fake-coronavirus-produc.aspx,fool.com,7,consumer looking answer make susceptible fraud,-0.5859,-0.41013,0.0890625,-0.4991925,Negative Impact
03/03/2020,98.7685,99.82,94.40,95.45,95.45,150690000,2.13,76.34428766,1.192,0,9.3404,0.9034837908,0.2283735172,0.65,258.115,8684.089844,12542.74023,6718.200195,5393.169922,2992.896973,38623.69922,16423.59961,97.2835495,92.51359486,97.71709569,92.49900705,102.7901749,112.5751196,93.00523014,25.0716519,-0.372297148,1.222616353,-1.594913501,3.154713767,104.7942324,7589878000,26.16787081,27.88203717,36.81999969,Amazon confirms first coronavirus case among U.S. employees,Online retailer Amazon.com Inc said on Tuesday an employee in the United States tested positive for the coronavirus.,https://www.reuters.com/article/us-health-coronavirus-amazon-com/amazon-confirms-first-coronavirus-case-among-u-s-employees-idUSKBN20R0DR,reuters.com,10,online retailer amazoncom inc said tuesday employee united state tested positive coronavirus,0.7506,0.7506,0.1694295,0.5811705,Positive Impact
04/03/2020,97.3285,98.90,96.10,98.79,98.79,95458000,2.13,76.34428766,1.192,0,9.3404,0.9034837908,0.2283735172,0.65,258.115,9018.089844,13009.95996,6815.600098,5464.890137,3011.666016,38409.48047,16779.5,97.46709946,92.54030235,97.75922905,92.56161888,102.6055748,112.5528385,92.65831105,33.03049143,-0.386548322,0.9007834178,-1.287331739,3.295999799,103.6552141,7685336000,44.04094255,36.10414523,31.98999977,"Coronavirus Scare Spikes Online Orders, Amazon Sparks Delivery War",The coronavirus outbreak is likely to highlight the importance of online shopping. Amazon (AMZN) strengthens same-day delivery initiative to gain competitive edge against traditional retailers.,https://www.zacks.com/stock/news/797006/coronavirus-scare-spikes-online-orders-amazon-sparks-delivery-war,zacks.com,8,coronavirus outbreak likely highlight importance online shopping amazon amzn strengthens sameday delivery initiative gain competitive edge traditional retailer,0.9136,0.73088,0.152675,0.578205,Positive Impact
05/03/2020,96.65,98.04,95.50,96.20,96.20,94964000,2.13,76.34428766,1.192,0,9.3404,0.9034837908,0.2283735172,0.65,258.115,8738.589844,12593.03027,6705.399902,5361.100098,3071.677002,38470.60938,16554,97.60462952,92.55656734,97.69814163,92.5978366,102.3159748,112.6673128,91.96463681,30.67497015,-0.599918056,0.600643123,-1.200561179,3.430106572,102.6073172,7590372000,30.1895792,33.46613085,39.61999893,"Amazon, Facebook ask Seattle employees to work from home over coronavirus fears",Amazon.com Inc and Facebook Inc on Thursday joined Microsoft Corp in recommending employees in the Seattle area to work from home after several people in the region were infected with the coronavirus.,https://www.reuters.com/article/us-health-coronavirus-facebook/amazon-facebook-ask-seattle-employees-to-work-from-home-over-coronavirus-fears-idUSKBN20S0MZ,reuters.com,10,amazoncom inc facebook inc thursday joined microsoft corp recommending employee seattle area work home several people region infected coronavirus,-0.4939,-0.4939,0.1103645455,-0.604264545,Negative Impact
06/03/2020,93.75,95.54,93.48,95.05,95.05,105472000,2.13,76.34428766,1.192,0,9.3404,0.9034837908,0.2283735172,0.65,258.115,8575.620117,12352.03027,6462.600098,5139.109863,3034.510986,37576.62109,16175,97.71271942,92.56745983,97.59446928,92.62228098,101.9431248,112.7901368,91.09611273,30.26372978,-0.851750232,0.3101644519,-1.161914684,3.506463732,101.6432521,7484900000,24.05537836,32.7619667,41.93999863,Amazon removes hundreds of thousands of 'high-priced offers' amid coronavirus price gouging,"Amazon says it has removed 530,000 offers from the marketplace for coronavirus-based price gouging and suspended more than 2,500 seller accounts in its U.S. marketplace for violating its price-gouging policies",https://www.cnbc.com/2020/03/06/amazon-removes-530000-products-amid-coronavirus-price-gouging.html,cnbc.com,9,amazon say removed offer marketplace coronavirusbased price gouging suspended seller account u marketplace violating pricegouging policy,-0.7096,-0.63864,-0.159846667,-0.478793333,Negative Impact
09/03/2020,88.693,93.14,88.06,90.03,90.03,156264000,2.13,76.34428766,1.192,0,9.3404,0.9034837908,0.2283735172,0.65,258.115,7950.680176,11298.42969,5965.799805,4707.910156,2943.291016,35634.94922,14514.2002,97.72411942,92.55269234,97.29784313,92.59649214,101.24645,113.2726799,89.22022021,23.57948281,-1.440122574,-0.039892953,-1.400229621,3.855892181,100.7563122,7328636000,9.277759236,21.17423893,54.45999908,"Amazon recommends New York, New Jersey employees work from home due to virus","Amazon.com Inc has extended its work-from-home advisory to include employees in New York and New Jersey, the company said Monday, as the world's largest online retailer and other corporations aim to lower the risk of coronavirus transmission among their ranks.",https://www.reuters.com/article/us-health-coronavirus-amazon-com/amazon-recommends-new-york-new-jersey-employees-work-from-home-due-to-virus-idUSKBN20W2QD,reuters.com,10,amazoncom inc extended workfromhome advisory include employee new york new jersey company said monday world largest online retailer corporation aim lower risk coronavirus transmission among rank,-0.5106,-0.5106,0.023714,-0.534314,Negative Impact
10/03/2020,93.544,94.71,90.91,94.59,94.59,142666000,2.13,76.34428766,1.192,0,9.3404,0.9034837908,0.2283735172,0.65,258.115,8344.25,11793.26953,5960.200195,4636.609863,2996.761963,35634.94922,14958.09961,97.74716949,92.57177734,97.19169255,92.61633802,100.6412251,112.7309798,88.55147026,31.40528868,-1.520885744,-0.336091511,-1.184794233,4.085285187,99.48713089,7471302000,31.41518189,21.58277316,47.29999924,What To Stock Up On For Coronavirus,What To Stock Up On For Coronavirus,https://seekingalpha.com/article/4330853-what-to-stock-up-on-for-coronavirus,seekingalpha.com,6,stock coronavirus,0,0,0.18173625,-0.18173625,Negative Impact
11/03/2020,92.8925,93.57,90.08,91.04,91.04,112496000,2.13,76.34428766,1.192,0,9.3404,0.9034837908,0.2283735172,0.65,258.115,7952.049805,11177.29004,5876.5,4610.25,2968.51709,35697.39844,14270.09961,97.69822952,92.57117233,96.95056732,92.60068291,99.81637497,112.1724567,87.46029325,29.29813819,-1.849861372,-0.638845483,-1.211015888,4.231642587,98.34486769,7358806000,15.54297372,18.74530495,53.90000153,Coronavirus Impact On Imports Bigger Than Expected,"The full effects remain unknown, but new National Retail Federation data shows that China's woes will cause supply chain disruptions.",https://www.fool.com/investing/2020/03/11/coronavirus-impact-on-imports-bigger-than-expected.aspx,fool.com,7,full effect remain unknown new national retail federation data show china woe cause supply chain disruption,-0.6486,-0.45402,0.1444370968,-0.598457097,Negative Impact
12/03/2020,86.099,88.25,83.75,83.83,83.83,226924000,2.13,76.34428766,1.192,0,9.3404,0.9034837908,0.2283735172,0.65,258.115,7201.799805,10060.75977,5237.5,4044.26001,2923.486084,32778.14063,12508.5,97.52794952,92.53121731,96.43605479,92.51341739,98.60789986,112.2542905,84.96150917,26.42879197,-2.661881015,-1.04345259,-1.618428425,4.520071302,97.31683081,7131882000,0.441931144,15.80002892,75.47000122,The five biggest tech companies lost more than $400 billion in value on Thursday,"Apple, Facebook, Alphabet, Amazon and Microsoft lost a combined $416.63 billion on Thursday as fears about the coronavirus and its effects on the economy continued to scare investors.",https://www.cnbc.com/2020/03/12/techs-big-5-lost-a-combined-416point63-billion-in-value-on-thursday.html,cnbc.com,9,apple facebook alphabet amazon microsoft lost combined billion thursday fear coronavirus effect economy continued scare investor,-0.7906,-0.71154,0.1398143478,-0.851354348,Negative Impact
13/03/2020,87.75,89.32,84.03,89.25,89.25,176194000,2.13,76.34428766,1.192,0,9.3404,0.9034837908,0.2283735172,0.65,258.115,7874.879883,10851.74023,5366.100098,4118.359863,2887.427002,34103.48047,13716.2998,97.46510956,92.52266979,96.15424872,92.48094557,97.69572487,111.2800738,84.11137599,37.69354795,-2.835418948,-1.401845861,-1.433573087,4.526142665,95.68881111,7308076000,30.58953823,15.52481436,57.83000183,Whole Foods suggests workers share paid time off amid coronavirus outbreak,Whole Foods outraged its employees this week by suggesting healthy employees generously donate their unused vacation time to fellow workers who get sick during the deadly coronavirus pandemic.,https://nypost.com/2020/03/13/whole-foods-suggests-workers-share-paid-time-off-amid-coronavirus-outbreak/,nypost.com,5,whole food outraged employee week suggesting healthy employee generously donate unused vacation time fellow worker get sick deadly coronavirus pandemic,-0.3182,-0.1591,0.2568953846,-0.415995385,Negative Impact
16/03/2020,82.0755,87.97,81.30,84.46,84.46,178346000,2.13,76.34428766,1.192,0,9.3404,0.9034837908,0.2283735172,0.65,258.115,6904.589844,9567.530273,5151.100098,3881.459961,2789.253906,31390.07031,12360.40039,97.25624954,92.49087727,95.69555256,92.40111026,96.58142471,110.6869981,82.47585136,35.3905402,-3.321377209,-1.785752131,-1.535625079,4.82182094,94.25615378,7129730000,16.2412431,15.75757082,82.69000244,Why FAANG Stocks Tumbled Today,"With the market down big on pandemic fears, the largest tech stocks headed lower.",https://www.fool.com/investing/2020/03/16/why-faang-stocks-tumbled-today.aspx,fool.com,7,market big pandemic fear largest tech stock headed lower,-0.6597,-0.46179,0.1232593103,-0.58504931,Negative Impact
17/03/2020,88.7735,92.89,84.46,90.39,90.39,218342000,2.13,76.34428766,1.192,0,9.3404,0.9034837908,0.2283735172,0.65,258.115,7334.779785,10063.36035,5294.899902,3991.780029,2779.641113,30579.08984,12685.2002,97.18911957,92.49906975,95.48757004,92.3811191,95.71184959,109.0321426,82.39155661,42.06631449,-3.190855748,-2.066772854,-1.124082894,5.230428423,81.30149841,7348072000,49.09802958,31.9762703,75.91000366,"Exclusive: Amazon to receive only vital supplies at U.S., UK warehouses amid coronavirus outbreak","Amazon.com Inc will only receive vital supplies at its U.S. and UK warehouses until April 5, its latest move to free up inventory space for medical and household goods in high demand as a result of the coronavirus outbreak.",https://www.reuters.com/article/us-health-coronavirus-amazon-com-exclusi/exclusive-amazon-to-receive-only-vital-supplies-at-u-s-uk-warehouses-amid-coronavirus-outbreak-idUSKBN2142IM,reuters.com,10,amazoncom inc receive vital supply u uk warehouse april latest move free inventory space medical household good high demand result coronavirus outbreak,0.7845,0.7845,0.2606225926,0.5238774074,Positive Impact
18/03/2020,87.5,92.08,87.25,91.50,91.50,192904000,2.13,76.34428766,1.192,0,9.3404,0.9034837908,0.2283735172,0.65,258.115,6989.839844,9384.599609,5080.600098,3754.840088,2728.756104,28869.50977,11721.40039,97.11623962,92.53339725,95.33119475,92.37235174,94.86129951,106.845905,82.87669403,47.30996741,-2.963844714,-2.246187226,-0.717657488,5.229821341,81.30149841,7540976000,55.08237604,40.14054957,76.44999695,What Makes Amazon (AMZN) a New Buy Stock,"Amazon (AMZN) might move higher on growing optimism about its earnings prospects, which is reflected by its upgrade to a Zacks Rank #2 (Buy).",https://www.zacks.com/stock/news/821137/what-makes-amazon-amzn-a-new-buy-stock,zacks.com,8,amazon amzn might move higher growing optimism earnings prospect reflected upgrade zacks rank buy,0.7964,0.63712,0.05046526316,0.5866547368,Positive Impact
19/03/2020,93,97.25,91.63,94.05,94.05,207998000,2.13,76.34428766,1.192,0,9.3404,0.9034837908,0.2283735172,0.65,258.115,7150.580078,9461.30957,5151.600098,3855.5,2702.129883,28288.23047,12170.5,97.0903096,92.57123978,95.28081461,92.38900995,94.18087463,104.542461,83.81928823,49.86693957,-2.549071365,-2.306764054,-0.242307311,5.359714508,81.53324844,7748974000,68.83609596,57.67216719,72,France says pressure on Amazon workers 'unacceptable' amid lockdown,"Amazon workers in France are coming under unacceptable pressure, Finance Minister Bruno Le Maire said on Thursday, after staff complained they faced not getting paid if they stopped showing up due to fears of coronavirus contamination.",https://www.reuters.com/article/us-health-coronavirus-amazon-france/france-says-pressure-on-amazon-workers-unacceptable-amid-lockdown-idUSKBN2161A3,reuters.com,10,amazon worker france coming unacceptable pressure finance minister bruno le maire said thursday staff complained faced getting paid stopped showing due fear coronavirus contamination,-0.8834,-0.8834,0.07908148148,-0.962481481,Negative Impact
20/03/2020,96.3155,97.85,91.04,92.30,92.30,196358000,2.13,76.34428766,1.192,0,9.3404,0.9034837908,0.2283735172,0.65,258.115,6879.52002,9133.160156,5190.799805,4048.800049,2745.61792,29915.96094,11851.7998,97.04442947,92.59813725,95.16409626,92.38816902,93.55617447,102.6516165,84.46073241,44.73493688,-2.334020558,-2.312215355,-0.021805203,5.544571468,82.16191851,7552616000,59.42748428,61.11531876,66.04000092,Amazon AWS launches $20 million initiative to help fight the coronavirus,The company hopes to accelerate diagnostic solutions for coronavirus COVID-19 and other infectious diseases.,https://www.cnbc.com/2020/03/20/coronavirus-amazon-aws-commits-20-million-to-covid-19-research.html,cnbc.com,9,company hope accelerate diagnostic solution coronavirus covid infectious disease,0.6369,0.57321,0.02442571429,0.5487842857,Positive Impact
23/03/2020,91.3875,95.97,90.60,95.14,95.14,156170000,2.13,76.34428766,1.192,0,9.3404,0.9034837908,0.2283735172,0.65,258.115,6860.669922,8777.379883,4993.899902,3914.310059,2660.169922,25981.24023,11228.5,97.04620956,92.63525475,95.16321022,92.41556537,93.29002457,101.8287925,84.75125668,49.70272705,-1.912621095,-2.232296503,0.3196754082,5.541572026,83.1032033,7708786000,78.6430748,68.96888501,61.59000015,Amazon Shifts Employees To PillPack And PBM RxAdvance,"Premera Blue Cross, which provides medical benefits to many Amazon employees, had no comment on AmazonÃÂÃÂs decision to change prescription benefits.",https://www.forbes.com/sites/brucejapsen/2020/03/23/in-pharmacy-move-amazon-shifts-employees-to-pillpack-and-pbm-rxadvance/,forbes.com,8,premera blue cross provides medical benefit many amazon employee comment amazon decision change prescription benefit,0.8126,0.65008,0.1052626923,0.5448173077,Positive Impact
24/03/2020,97.575,97.75,95.02,97.01,97.00,142942000,2.13,76.34428766,1.192,0,9.3404,0.9034837908,0.2283735172,0.65,258.115,7417.859863,9658.320313,5446,4242.700195,2722.437988,26674.0293,12571.09961,97.10314957,92.66927223,95.23543717,92.46123136,93.20842438,101.5612095,84.85563929,48.22505642,-1.412013707,-2.068239943,0.6562262369,5.490322113,83.98801101,7851728000,93.83904168,77.30320026,61.66999817,Coronavirus Lockdown Could Boost Streaming Video Demand by 60%: 3 Stocks to Buy,"With more and more people sheltering in place, viewers are killing time by binge-watching.",https://www.fool.com/investing/2020/03/24/coronavirus-lockdown-could-boost-streaming-video-d.aspx,fool.com,7,people sheltering place viewer killing time bingewatching,-0.6597,-0.46179,0.05688884615,-0.518678846,Negative Impact
25/03/2020,96.0345,97.51,94.29,94.29,94.29,129582000,2.13,76.34428766,1.192,0,9.3404,0.9034837908,0.2283735172,0.65,258.115,7384.299805,9961.379883,5688.200195,4432.299805,2781.591064,28535.7793,13139.2002,97.09768951,92.67557472,95.19843962,92.47944796,92.97404938,100.8970078,85.051091,48.10747645,-1.220130065,-1.898617968,0.678487903,5.485500881,84.81973026,7722146000,78.49957009,83.66056219,63.95000076,"Do more to stop coronavirus price gouging, U.S. states tell Amazon, Walmart, Facebook",A group of 32 U.S. states have a message for the nation's leading online platforms: You are not doing enough to stop price gouging amid the coronavirus crisis.,https://www.reuters.com/article/us-health-coronavirus-retailers-states/do-more-to-stop-coronavirus-price-gouging-u-s-states-tell-amazon-walmart-facebook-idUSKBN21C2NF,reuters.com,10,group u state message nation leading online platform enough stop price gouging amid coronavirus crisis,-0.743,-0.743,0.07842035714,-0.821420357,Negative Impact
26/03/2020,95.1,97.82,94.46,97.77,97.77,124426000,2.13,76.34428766,1.192,0,9.3404,0.9034837908,0.2283735172,0.65,258.115,7797.540039,10536.28027,5815.700195,4543.580078,2764.910889,29946.76953,13371.2002,97.18373947,92.69852222,95.29946152,92.53213503,93.15202446,101.3475802,84.95646873,52.57653892,-0.77808314,-1.674511002,0.896427862,5.543072292,85.60154635,7846572000,99.54376235,90.62745804,61,Factbox: Coronavirus cases reported at 13 of Amazon's U.S. warehouses,"Amazon.com Inc is at the front line of responding to outbreaks of the novel coronavirus in the United States, delivering essential goods while about half the population faces government stay-at-home orders.",https://www.reuters.com/article/us-health-coronavirus-amazon-com-warehou/factbox-coronavirus-cases-reported-at-13-of-amazons-u-s-warehouses-idUSKBN21E07V,reuters.com,10,amazoncom inc front line responding outbreak novel coronavirus united state delivering essential good half population face government stayathome order,0.7906,0.7906,0.1502430769,0.6403569231,Positive Impact
27/03/2020,96.543,96.99,95.00,95.01,95.00,107758000,2.13,76.34428766,1.192,0,9.3404,0.9034837908,0.2283735172,0.65,258.115,7502.379883,10187.20996,5510.299805,4351.490234,2772.202881,29815.58984,12687.7002,97.22181946,92.70971722,95.2879139,92.55674062,93.19289932,101.4182999,84.96749876,54.9223653,-0.643811869,-1.468371176,0.8245593067,5.242250715,86.33645348,7738814000,82.80810218,86.95047821,65.54000092,"Amazon, Shop Rite parent snap up Fairway assets in bankruptcy auction","Amazon.com Inc. and Shop Rite parent Village Super Market Inc. have bought Fairway assets in a bankruptcy auction, The Wall Street Journal reports.",https://www.marketwatch.com/story/guid/e3588d98-61d1-4914-9333-fd84f8c239b5,marketwatch.com,8,amazoncom inc shop rite parent village super market inc bought fairway asset bankruptcy auction wall street journal report,0.7506,0.60048,0.10438,0.4961,Positive Impact
30/03/2020,96.1415,98.68,95.62,98.20,98.20,122522000,2.13,76.34428766,1.192,0,9.3404,0.9034837908,0.2283735172,0.65,258.115,7774.149902,10434.74023,5563.700195,4378.509766,2747.214111,28440.32031,13038.5,97.30782944,92.73312973,95.4020154,92.6128676,93.21789932,101.5037639,84.93203474,53.66800963,-0.276603938,-1.230017728,0.9534137903,5.170358385,87.02726618,7861336000,97.21518398,93.18901617,57.08000183,Amazon fires warehouse worker who led Staten Island strike for more coronavirus protection,Amazon said it fired Chris Smalls for 'violating social distancing guidelines and putting the safety of others at risk.',https://www.cnbc.com/2020/03/30/amazon-fires-staten-island-coronavirus-strike-leader-chris-smalls.html,cnbc.com,9,amazon said fired chris small violating social distancing guideline putting safety others risk,-0.6908,-0.62172,0.05185555556,-0.673575556,Negative Impact
31/03/2020,98.2175,99.65,97.20,97.49,97.49,102472000,2.13,76.34428766,1.192,0,9.3404,0.9034837908,0.2283735172,0.65,258.115,7700.100098,10301.87012,5672,4396.120117,2750.295898,29468.49023,13378.7998,97.39282944,92.75314224,95.48374029,92.66135648,93.31972427,101.7694909,84.86995763,56.95412632,-0.042511235,-0.992516429,0.9500051946,5.022822244,87.95960515,7758864000,88.20131005,89.40819874,53.54000092,Factbox: Coronavirus cases reported at 19 of Amazon's U.S. warehouses,"Amazon.com Inc is at the front line of responding to outbreaks of the novel coronavirus in the United States, delivering essential goods while more than half the population faces government stay-at-home orders.",https://www.reuters.com/article/us-health-coronavirus-amazon-com-warehou/factbox-coronavirus-cases-reported-at-19-of-amazons-u-s-warehouses-idUSKBN21I0FA,reuters.com,10,amazoncom inc front line responding outbreak novel coronavirus united state delivering essential good half population face government stayathome order,0.7906,0.7906,-0.083726923,0.8743269231,Positive Impact
01/04/2020,96.6485,97.25,94.65,95.39,95.39,82438000,2.13,76.34428766,1.192,0,9.3404,0.9034837908,0.2283735172,0.05,256.389,7360.580078,9844.849609,5454.600098,4207.240234,2734.521973,28265.31055,12876.40039,97.40852951,92.75855976,95.47986821,92.68845743,93.14939957,101.2655046,85.03329451,64.01785804,-0.026221786,-0.799257501,0.7730357143,4.704465049,89.12874473,7676426000,76.75141969,87.38930457,57.06000137,Are the FAANG Stocks on Sale During the Coronavirus Crisis?,"With the sudden bear market in US stocks, could your favorite large cap growth stocks suddenly be true value stocks?",https://www.zacks.com/stock/news/849080/are-the-faang-stocks-on-sale-during-the-coronavirus-crisis,zacks.com,8,sudden bear market u stock could favorite large cap growth stock suddenly true value stock,0.8689,0.69512,0.07418833333,0.6209316667,Positive Impact
02/04/2020,95.082,96.38,94.50,95.94,95.94,86720000,2.13,76.34428766,1.192,0,9.3404,0.9034837908,0.2283735172,0.05,256.389,7487.310059,10062.37012,5480.200195,4220.959961,2780.637939,28265.31055,13097.7998,97.43989944,92.76292477,95.49797133,92.72082599,93.13639946,101.2327291,85.04006979,59.20413203,0.03123224227,-0.633159552,0.6643917944,4.446715219,90.18097036,7763146000,79.78417583,81.57896852,50.90999985,Amazon responds after leaked memo reveals companyÃÂÃÂs PR strategy against warehouse worker,"AmazonÃÂÃÂs logistics chief penned a blog post Thursday, hours after a leaked memo revealed an unflattering glimpse into the companyÃÂÃÂs PR strategy toward a fired warehouse worker who organized a walkout in New York this week.",https://www.geekwire.com/2020/amazon-responds-leaked-memo-reveals-companys-pr-strategy-warehouse-worker/,geekwire.com,5,amazon logistics chief penned blog post thursday hour leaked memo revealed unflattering glimpse company pr strategy toward fired warehouse worker organized walkout new york week,-0.7579,-0.37895,0.1364937931,-0.515443793,Negative Impact
03/04/2020,95.5575,96.32,94.46,95.33,95.33,72198000,2.13,76.34428766,1.192,0,9.3404,0.9034837908,0.2283735172,0.05,256.389,7373.080078,9880.629883,5415.5,4154.580078,2763.987061,27590.94922,12938.2998,97.46190948,92.76237476,95.49136454,92.74678293,93.15014954,101.2611159,85.03918313,66.89773032,0.02706968558,-0.501113705,0.5281833902,4.011750902,91.12797342,7690948000,71.54847696,76.02802416,46.79999924,Canada signs agreement with Amazon Canada to manage distribution of medical equipment,"Canada has signed an agreement with Amazon Canada to manage the distribution of medical equipment like masks, gloves and ventilators purchased by the Canadian government to help in its fight against the cornonavirus outbreak, Prime Minister Justin Trudeau said on Friday.",https://www.reuters.com/article/us-health-cornavirus-canada-amazon/canada-signs-agreement-with-amazon-canada-to-manage-distribution-of-medical-equipment-idUSKBN21L2MO,reuters.com,10,canada signed agreement amazon canada manage distribution medical equipment like mask glove ventilator purchased canadian government help fight cornonavirus outbreak prime minister justin trudeau said friday,0.7579,0.7579,0.162545,0.595355,Positive Impact
06/04/2020,96.8,99.93,96.50,99.88,99.88,115464000,2.13,76.34428766,1.192,0,9.3404,0.9034837908,0.2283735172,0.05,256.389,7913.240234,10515.24023,5582.399902,4346.140137,2763.987061,27590.94922,13592.7002,97.5978595,92.78222477,95.66344834,92.81775525,93.64259949,102.1426772,85.14252179,65.40904132,0.3864631432,-0.323598335,0.7100614782,3.737822396,91.98027618,7806412000,99.63315596,83.65526958,45.24000168,Amazon is tracking warehouse workers and says it could fire them for violating social distancing rules,"Amazon will warn workers, or in some cases, fire them, if they violate social distancing rules.",https://www.cnbc.com/2020/04/06/amazon-says-workers-could-be-fired-for-violating-social-distancing-rules.html,cnbc.com,9,amazon warn worker case fire violate social distancing rule,-0.6486,-0.58374,-0.024857,-0.558883,Negative Impact
07/04/2020,100.8555,101.79,99.88,100.58,100.58,102280000,2.13,76.34428766,1.192,0,9.3404,0.9034837908,0.2283735172,0.05,256.389,7887.259766,10537.04004,5704.5,4438.27002,2820.762939,30067.21094,13614.09961,97.78111954,92.80729977,95.85625436,92.89499154,93.94204941,102.9872977,84.89680116,64.94502608,0.7195154564,-0.114975577,0.8344910332,3.528786795,92.93376333,7908692000,89.2186592,86.80009737,46.70000076,Will Amazon (AMZN) Postpone Prime Day Due to Coronavirus?,"Amazon (AMZN) is reportedly delaying its mid-year shopping holiday, Amazon Prime Day 2020, until at least August.",https://www.zacks.com/stock/news/858673/will-amazon-amzn-postpone-prime-day-due-to-coronavirus,zacks.com,8,amazon amzn reportedly delaying midyear shopping holiday amazon prime day least august,0.6249,0.49992,0.079682,0.420238,Positive Impact
08/04/2020,101.05,102.20,100.56,102.15,102.15,79546000,2.13,76.34428766,1.192,0,9.3404,0.9034837908,0.2283735172,0.05,256.389,8090.899902,10902.58984,5677.700195,4442.75,2815.368896,29893.96094,13925.7002,97.9708696,92.83957478,96.10306797,92.98708119,94.49739952,104.1375148,84.8572842,63.78075799,1.097496413,0.1275188212,0.9699775918,3.235393524,94.1730769,7988238000,99.56900492,96.14027336,43.34999847,U.S. senators question Amazon CEO about firing of warehouse protest leader,"Five Democratic lawmakers on Wednesday wrote Amazon.com Inc to raise concern about its firing of a worker who protested warehouse operations during the coronavirus pandemic, according to a copy of the letter seen by Reuters.",https://www.reuters.com/article/us-health-coronavirus-amazon-com-senator/u-s-senators-question-amazon-ceo-about-firing-of-warehouse-protest-leader-idUSKCN21Q2WP,reuters.com,10,five democratic lawmaker wednesday wrote amazoncom inc raise concern firing worker protested warehouse operation coronavirus pandemic according copy letter seen reuters,-0.4404,-0.4404,0.1185419048,-0.558941905,Negative Impact
09/04/2020,102.215,102.65,100.88,102.14,102.14,92930000,2.13,76.34428766,1.192,0,9.3404,0.9034837908,0.2283735172,0.05,256.389,8153.580078,11136.61035,5842.700195,4506.850098,2825.904053,31159.61914,14166.59961,98.15562958,92.88069729,96.33973199,93.07813511,95.41277466,104.2297907,86.5957586,67.76828743,1.38017091,0.3780492389,1.002121671,2.874929156,95.45738411,7895308000,95.75102981,94.84623131,41.66999817,Jeff Bezos makes surprise visit to Amazon warehouse and Whole Foods store amid worker safety concerns,The visit comes as Amazon and Whole Foods employees have called for Bezos to better protect workers.,https://www.cnbc.com/2020/04/09/bezos-visits-amazon-warehouse-whole-foods-amid-worker-safety-concern.html,cnbc.com,9,visit come amazon whole food employee called bezos better protect worker,0.7351,0.66159,0.1967808333,0.4648091667,Positive Impact
13/04/2020,102,109.00,101.90,108.44,108.44,134334000,2.13,76.34428766,1.192,0,9.3404,0.9034837908,0.2283735172,0.05,256.389,8192.419922,10949.53027,5842.700195,4506.850098,2783.048096,30690.01953,14075.90039,98.45381958,92.94845726,96.81438943,93.23102428,96.37244949,106.4528038,86.2920952,71.35837804,2.088913636,0.7202221184,1.368691518,2.998500279,96.75205525,8029642000,96.21709366,97.1790428,41.16999817,"One streaming stock winner, and one loser, during the virus lockdown",The streaming wars are heating up as consumers hunker down. Two market watchers pick out the winners and losers.,https://www.cnbc.com/2020/04/13/netflix-disney-or-amazon-winners-and-losers-of-streaming-wars.html,cnbc.com,9,streaming war heating consumer hunker two market watcher pick winner loser,-0.5423,-0.48807,0.1667027778,-0.654772778,Negative Impact
14/04/2020,110.0235,114.60,109.31,114.17,114.17,161744000,2.13,76.34428766,1.192,0,9.3404,0.9034837908,0.2283735172,0.05,256.389,8515.740234,11172.2002,5791.299805,4523.910156,2827.282959,30690.01953,14258.40039,98.72841965,93.04321728,97.49484476,93.4393325,97.85787468,109.2196659,86.4960835,74.51641882,3.076887134,1.191555122,1.885332013,3.243035998,99.2016442,8191386000,97.86323582,96.6104531,37.75999832,Amazon fires three reported critics of warehouse conditions in pandemic,"Amazon.com Inc said on Tuesday it had fired three reported critics of the company's pandemic response for workplace violations, dismissals that drew sharp words from U.S. Senator Bernie Sanders and a labor coalition.",https://www.reuters.com/article/us-health-coronavirus-amazon-com-warehou/amazon-fires-three-reported-critics-of-warehouse-conditions-in-pandemic-idUSKCN21W0UI,reuters.com,10,amazoncom inc said tuesday fired three reported critic company pandemic response workplace violation dismissal drew sharp word u senator bernie sander labor coalition,-0.836,-0.836,0.04271439024,-0.87871439,Negative Impact
15/04/2020,112.884,116.67,112.25,115.38,115.38,137332000,2.13,76.34428766,1.192,0,9.3404,0.9034837908,0.2283735172,0.05,256.389,8393.179688,10843.91992,5597.700195,4353.720215,2811.174072,30379.81055,13958.59961,99.03189972,93.14672977,98.19638037,93.65768743,99.1074749,112.3531277,85.86182212,81.47683776,3.913038782,1.735851854,2.177186928,3.328357697,101.9000015,8328718000,94.21683055,96.09905335,40.84000015,Pentagon probe unable to rule out White House influence on JEDI contract,"The Pentagon's inspector general on Wednesday said it could not determine whether the White House influenced the award of a $10 billion contract to Microsoft Corp over Amazon after several officials said their conversations were privileged ""presidential communications.""",https://www.reuters.com/article/us-amazon-com-pentagon-microsoft/pentagon-probe-unable-to-rule-out-white-house-influence-on-jedi-contract-idUSKCN21X27T,reuters.com,10,pentagon inspector general wednesday said could determine whether white house influenced award billion contract microsoft corp amazon several official said conversation privileged presidential communication,0.7964,0.7964,0.06505676471,0.7313432353,Positive Impact
16/04/2020,117.3,123.05,116.75,120.41,120.41,240764000,2.13,76.34428766,1.192,0,9.3404,0.9034837908,0.2283735172,0.05,256.389,8532.360352,10818.03027,5628.399902,4350.160156,2819.935059,30602.60938,13899.2998,99.39041977,93.26822979,99.0674831,93.92387462,100.5529499,116.3642677,84.74163216,82.29234899,4.924444697,2.373570422,2.550874275,3.623607635,104.8537018,8569482000,90.76505259,94.28170632,40.11000061,"Amazon CEO Jeff Bezos has made the same salary for decades, a little more than double the median U.S. employeeÃÂÃÂs pay","Jeff Bezos is the richest person in the world and runs the third-largest company by market capitalization in America, so thereÃÂÃÂs a good chance he doesnÃÂÃÂt much care that his ÃÂÃÂlowÃÂÃÂ base salary, which is just a little more than double that of Amazon.com Inc.",https://www.marketwatch.com/story/amazon-ceo-jeff-bezos-has-made-the-same-salary-for-decades-a-little-more-than-double-the-median-us-employees-pay-2020-04-16,marketwatch.com,8,jeff bezos richest person world run thirdlargest company market capitalization america there good chance doesnt much care low base salary little double amazoncom inc,0.7569,0.60552,0.088326,0.517194,Positive Impact
17/04/2020,118.6165,120.00,115.80,118.75,118.75,158600000,2.13,76.34428766,1.192,0,9.3404,0.9034837908,0.2283735172,0.05,256.389,8650.139648,11208.29004,5787,4499.009766,2838.495117,31588.7207,14359.90039,99.72554977,93.37840229,99.83934651,94.17090074,101.7881248,119.2344336,84.34181614,84.98394066,5.528355935,3.004527525,2.52382841,3.754322052,108.492962,8410882000,84.96108389,89.98098901,38.15000153,Trump Plans Steady Economic Reboot: 5 Coronavirus-Proof Bets,"Here we discuss five stocks poised to gain maximum benefits from the staggered reopening of U.S. economy, per the latest guidelines.",https://www.zacks.com/stock/news/875994/trump-plans-steady-economic-reboot-5-coronavirus-proof-bets,zacks.com,8,discus five stock poised gain maximum benefit staggered reopening u economy per latest guideline,0.8126,0.65008,0.2509944444,0.3990855556,Positive Impact
20/04/2020,119.4975,122.25,119.30,119.68,119.68,115414000,2.13,76.34428766,1.192,0,9.3404,0.9034837908,0.2283735172,0.05,256.389,8560.730469,11003.87988,5812.799805,4528.299805,2852.552979,31648,14388.2998,100.0689297,93.49205479,100.6174308,94.42472756,103.1569248,121.7296864,84.58416321,83.91159777,6.012732176,3.606168455,2.406563721,3.741643088,111.4043702,8526296000,88.21541985,87.98051878,43.83000183,"Got $1,000? Buying These Stocks Now Would Be a Smart Idea",Buying these long-term winners now should benefit your future retirement handsomely.,https://www.fool.com/investing/2020/04/20/got-1000-buying-these-stocks-now-would-be-a-smart.aspx,fool.com,7,buying longterm winner benefit future retirement handsomely,0.8658,0.60606,0.2091807692,0.3968792308,Positive Impact
21/04/2020,120.8305,121.42,113.98,116.41,116.41,149534000,2.13,76.34428766,1.192,0,9.3404,0.9034837908,0.2283735172,0.05,256.389,8263.230469,10706.44043,5641,4357.459961,2827.012939,30636.71094,13940.09961,100.3177698,93.58835728,101.2365903,94.64344668,104.2201496,123.2889034,85.15139583,77.6301229,6.062494552,4.097433675,1.965060878,4.097499847,113.7334968,8376762000,76.76312553,83.31320976,45.40999985,Hundreds Of Amazon Employees Plan To Protest Coronavirus Safety By Calling Out Of Work,"As frustrations amid some Amazon employees continue, the company says employee participation in protests ÃÂÃÂgrossly exaggerated.ÃÂÃÂ",https://www.forbes.com/sites/rachelsandler/2020/04/21/hundreds-of-amazon-employees-plan-to-protest-coronavirus-safety-by-calling-out-of-work/,forbes.com,8,frustration amid amazon employee continue company say employee participation protest grossly exaggerated,-0.6908,-0.55264,0.1457781818,-0.698418182,Negative Impact
22/04/2020,118.45,119.70,117.55,118.17,118.17,84244000,2.13,76.34428766,1.192,0,9.3404,0.9034837908,0.2283735172,0.05,256.389,8495.379883,10908.55957,5770.600098,4411.799805,2843.97998,31379.55078,14288.2002,100.5473497,93.69114979,101.9008221,94.8775865,105.2786247,125.0000562,85.55719328,83.60738073,6.173470937,4.512641127,1.66082981,4.130214146,113.9830017,8461006000,82.94831705,82.64228748,41.97999954,Hagens Berman: Amazon Accused of Illegal Price-Gouging in Class-Action Lawsuit,"SAN FRANCISCO--(BUSINESS WIRE)--California consumers hit Amazon.com with a class-action lawsuit accusing the retail giant of violating state consumer-protection laws by price-gouging during the COVID-19 public health crisis, according to attorneys at Hagens Berman. If you purchased any consumer food items or goods, emergency supplies or medical products from Amazon during the COVID-19 crisis, find out more about the lawsuit and your rights. According to the lawsuit filed Apr. 21, 2020 in the U.S. District Court for the Northern District of California, the worldÃÂÃÂs largest retailer, Amazon.com, has engaged in ÃÂÃÂunconscionableÃÂÃÂ and unlawful price increases during the COVID-19 pandemic, inflating prices for essential goods by upwards of 672 percent. Under California law, any price increase exceeding 10 percent during a state or local emergency is presumptively illegal. ÃÂÃÂCalifornia law rightly prohibits profiteering from a public health crisis,ÃÂÃÂ the suit begins. ÃÂÃÂExploiting consumers in their most vulnerable hour is not only contrary to basic human decencyÃÂÃÂit is a criminal offense in California and presumptively unlawful under CaliforniaÃÂÃÂs Unfair Competition LawÃÂÃÂAmazonÃÂÃÂs position as a vital seller in times of contagion does not place it above the law.ÃÂÃÂ ÃÂÃÂMany Americans were already barely making ends meet before the outbreak of COVID-19, and the crisis gave many their first encounter with resource scarcity and widespread financial distress,ÃÂÃÂ said Steve Berman, managing partner of Hagens Berman and attorney for consumers in the class action. ÃÂÃÂAmazon has chosen to take advantage of this global crisis facing all of us by profiteering on vulnerable consumers.ÃÂÃÂ The lawsuit states that consumers have turned to online shopping to fulfill their essential needs, particularly as warnings mounted from the Centers for Disease Control and other officials to practice social distancing, stay home and shelter in place, all to curb the spread of the highly contagious coronavirus. ÃÂÃÂAmazonÃÂÃÂs sales have never been higher, and since the COVID-19 pandemic began, its sales in some categories (e.g., home items) are up more than 1000 percent,ÃÂÃÂ according to the lawsuit. Amazon Price-Gouging on Essential Items According to the filed lawsuit, as the COVID-19 crisis has escalated, so too have AmazonÃÂÃÂs prices for the goods consumers require to remain healthy, protected and nourished. Attorneys say that after COVID-19 was declared a public health emergency by California officials, certain Amazon prices increased as follows: Face Masks: Increases exceeding 500 percent, from less than $20 to $120; Pain Reliever: Increases of 233 percent, from $18.75 to $62.40; Cold Remedies: Increases up to 634 percent, from $4.65 to $35.99; Black Beans: Increases up to 672 percent, from $3.17 to $24.50; Flour: Increases up to 400 percent, from $22.00 to $110.00; Disinfectants: Increase of 100 percent, from $14.99 to $29.99. The lawsuit against Amazon seeks repayment to consumers for AmazonÃÂÃÂs price-gouging, as well as injunctive relief from the court barring AmazonÃÂÃÂs overpricing. Find out more about the class-action lawsuit against Amazon for price-gouging during the COVID-19 outbreak. About Hagens Berman Hagens Berman Sobol Shapiro LLP is a consumer-rights class-action law firm with nine offices across the country. The firmÃÂÃÂs tenacious drive for plaintiffsÃÂÃÂ rights has earned it numerous national accolades, awards and titles of ÃÂÃÂMost Feared PlaintiffÃÂÃÂs Firm,ÃÂÃÂ and MVPs and Trailblazers of class-action law. More about the law firm and its successes can be found at www.hbsslaw.com. Follow the firm for updates and news at @ClassActionLaw.",https://www.businesswire.com/news/home/20200422005627/en/Hagens-Berman-Amazon-Accused-of-Illegal-Price-Gouging-in-Class-Action-Lawsuit,businesswire.com,5,san franciscobusiness wirecalifornia consumer hit amazoncom classaction lawsuit accusing retail giant violating state consumerprotection law pricegouging covid public health crisis according attorney hagens berman purchased consumer food item good emergency supply medical product amazon covid crisis find lawsuit right according lawsuit filed apr u district court northern district california world largest retailer amazoncom engaged unconscionable unlawful price increase covid pandemic inflating price essential good upwards percent california law price increase exceeding percent state local emergency presumptively illegal california law rightly prohibits profiteering public health crisis suit begin exploiting consumer vulnerable hour contrary basic human decencyit criminal offense california presumptively unlawful california unfair competition law amazon position vital seller time contagion place law many american already barely making end meet outbreak covid crisis gave many first encounter resource scarcity widespread financial distress said steve berman managing partner hagens berman attorney consumer class action amazon chosen take advantage global crisis facing u profiteering vulnerable consumer lawsuit state consumer turned online shopping fulfill essential need particularly warning mounted center disease control official practice social distancing stay home shelter place curb spread highly contagious coronavirus amazon sale never higher since covid pandemic began sale category eg home item percent according lawsuit amazon pricegouging essential item according filed lawsuit covid crisis escalated amazon price good consumer require remain healthy protected nourished attorney say covid declared public health emergency california official certain amazon price increased follows face mask increase exceeding percent less pain reliever increase percent cold remedy increase percent black bean increase percent flour increase percent disinfectant increase percent lawsuit amazon seek repayment consumer amazon pricegouging well injunctive relief court barring amazon overpricing find classaction lawsuit amazon pricegouging covid outbreak hagens berman hagens berman sobol shapiro llp consumerrights classaction law firm nine office across country firm tenacious drive plaintiff right earned numerous national accolade award title feared plaintiff firm mvp trailblazer classaction law law firm success found follow firm update news classactionlaw,-0.9627,-0.48135,0.1420507143,-0.623400714,Negative Impact
23/04/2020,119.999,121.21,119.10,119.97,119.97,101332000,2.13,76.34428766,1.192,0,9.3404,0.9034837908,0.2283735172,0.05,256.389,8494.75,10916.67969,5826.600098,4451,2838.499023,31863.08008,14251.09961,100.7959998,93.7939373,102.6095154,95.12728717,106.5626499,126.6134817,86.51181812,84.1864223,6.333495833,4.876812068,1.456683765,4.213071006,113.9830017,8562338000,89.23669249,82.98271169,41.38000107,"Not Every Retailer Is Seeing An E-Commerce Boost From Coronavirus, With Amazon Among The Few Winners","In a survey, 64.5% of digital retailers reported that e-commerce activity was down during this crisis. So while we are seeing a surge in online shopping, it is most often captured by Amazon along with a few others.",https://www.forbes.com/sites/walterloeb/2020/04/22/the-traditional-brick-and-mortar-stores-have-stuggled-to-stay-alive/,forbes.com,8,survey digital retailer reported ecommerce activity crisis seeing surge online shopping often captured amazon along others,-0.5267,-0.42136,0.1746844,-0.5960444,Negative Impact
24/04/2020,120.85,121.02,119.10,120.51,120.51,76498000,2.13,76.34428766,1.192,0,9.3404,0.9034837908,0.2283735172,0.05,256.389,8634.519531,11017.90039,5752.200195,4393.319824,2808.529053,31327.2207,14420.40039,101.0462198,93.89213982,103.3115345,95.37986145,107.6994751,128.2249293,87.17402089,85.89818831,6.429651972,5.187380049,1.242271923,4.217535291,115.796402,8638836000,90.43654706,87.54051887,35.93000031,French court upholds ruling limiting Amazon deliveries during COVID-19 crisis,A French court on Friday rejected U.S. online retailer Amazon's appeal against a ruling that restricts what it can deliver during the coronavirus crisis.,https://www.reuters.com/article/us-health-coronavirus-amazon-france/french-court-upholds-ruling-limiting-amazon-deliveries-during-covid-19-crisis-idUSKCN2261YQ,reuters.com,10,french court friday rejected u online retailer amazon appeal ruling restricts deliver coronavirus crisis,-0.8402,-0.8402,0.1050854545,-0.945285455,Negative Impact
27/04/2020,122.16,122.24,118.15,118.80,118.80,112912000,2.13,76.34428766,1.192,0,9.3404,0.9034837908,0.2283735172,0.05,256.389,8730.160156,11264.83984,5846.799805,4505.259766,2815.495117,31743.08008,14642.09961,101.2723499,93.98587234,103.9189254,95.61289768,108.8892254,129.0721239,88.70632683,79.34821919,6.29522568,5.408949175,0.8862765045,4.18164226,117.2471222,8525924000,81.65652883,87.10992279,33.29000092,Trillion-Dollar Tech Earnings on Deck: Here's What to Expect,"In the busiest week of corporate earnings, market pundits are keeping an eye on how tech's trillion-dollar companies have weathered the devastating impact of coronavirus.",https://www.zacks.com/stock/news/891337/trillion-dollar-tech-earnings-on-deck-heres-what-to-expect,zacks.com,8,busiest week corporate earnings market pundit keeping eye tech trilliondollar company weathered devastating impact coronavirus,-0.6486,-0.51888,0.1687064286,-0.687586429,Negative Impact
28/04/2020,118.605,118.68,115.30,115.70,115.70,105388000,2.13,76.34428766,1.192,0,9.3404,0.9034837908,0.2283735172,0.05,256.389,8607.730469,11319.7002,5958.5,4569.790039,2810.023926,32114.51953,14798.2998,101.4515599,94.06164234,104.3810853,95.81280917,109.7645504,129.508778,90.02032281,71.83656042,5.871191059,5.501397552,0.369793507,4.295463562,123.0500031,8420536000,67.34022198,79.81109929,33.56999969,New York AG raises concerns about Amazon's pandemic safety practices: source,"Amazon.com Inc may have violated safety measures and labor practices amid the coronavirus pandemic as it fired a warehouse protest leader last month, New York Attorney General Letitia James's office wrote in a letter to the company last week.",https://www.reuters.com/article/us-health-coronavirus-amazon-com-warehou/new-york-ag-raises-concerns-about-amazons-pandemic-safety-practices-source-idUSKCN22A0ZB,reuters.com,10,amazoncom inc may violated safety measure labor practice amid coronavirus pandemic fired warehouse protest leader last month new york attorney general letitia james office wrote letter company last week,-0.7351,-0.7351,0.1025909524,-0.837690952,Negative Impact
29/04/2020,116.5005,119.59,115.50,118.64,118.64,91832000,2.13,76.34428766,1.192,0,9.3404,0.9034837908,0.2283735172,0.05,256.389,8914.709961,11618.23047,6115.299805,4671.109863,2822.441895,32720.16016,15228.09961,101.6685999,94.14957233,104.9400819,96.0399006,110.8220253,130.0562045,91.5878461,72.90193466,5.705913548,5.542300751,0.1636127969,4.470606668,122.8950031,8512368000,80.08523913,76.36066331,31.22999954,Boosted Demand Amid Coronavirus Lockdowns Likely Helped AmazonÃÂÃÂs Quarter,"Amazon (AMZN) has weathered some fierce economic stormsÃÂÃÂthe dot-com selloff two decades ago, the financial crisis of 2008-0 and the European debt debacle. Now, signs are pointing to the online retail and cloud computing behemoth holding up well during the economic downturn sparked by the coronavirus",https://www.forbes.com/sites/jjkinahan/2020/04/29/boosted-demand-amid-coronavirus-lockdowns-likely-helped-amazons-quarter/,forbes.com,8,amazon amzn weathered fierce economic stormsthe dotcom selloff two decade ago financial crisis european debt debacle sign pointing online retail cloud computing behemoth holding well economic downturn sparked coronavirus,-0.5859,-0.46872,0.1743738095,-0.64309381,Negative Impact
30/04/2020,120.992,123.75,119.80,123.70,123.70,190692000,2.13,76.34428766,1.192,0,9.3404,0.9034837908,0.2283735172,0.05,256.389,8889.549805,11372.33984,5901.200195,4572.180176,2860.082031,33717.62109,14780.7002,101.9723798,94.26559731,105.6757648,96.31512544,112.237775,130.8458285,93.62972156,76.26693444,5.915403575,5.616921316,0.2984822593,4.709714072,115.3000031,8703060000,99.77115307,82.39887139,34.15000153,"Amazon, Walmart, Target mega-strike: HereÃÂÃÂs what to know about the sprawling protest","Workers across the pandemicÃÂÃÂs front lines plan to strike together this Friday, on International WorkersÃÂÃÂ Day.
Workers across the pandemicÃÂÃÂs front lines plan to strike together this Friday, May 1, on International WorkersÃÂÃÂ Day, to protest what they say are unsafe conditions and a lack of protection from their employers.",https://www.fastcompany.com/90499409/amazon-walmart-target-mega-strike-heres-what-to-know-about-the-sprawling-protest,fastcompany.com,5,worker across pandemic front line plan strike together friday international worker day worker across pandemic front line plan strike together friday may international worker day protest say unsafe condition lack protection employer,-0.6486,-0.3243,0.1852507692,-0.509550769,Negative Impact
01/05/2020,116.84,118.12,112.91,114.30,114.30,195452000,2.13,76.34428766,1.192,0,9.3404,0.9034837908,0.2283735172,0.05,256.394,8604.950195,11058.57031,5763.100098,4572.180176,2860.082031,33717.62109,14620.2998,102.1053198,94.33909981,106.0140486,96.49409934,113.1558002,130.1174929,96.1941076,56.63680468,5.262424326,5.546021918,-0.283597592,4.973321097,123.75,8507608000,34.56838003,71.47492408,37.18999863,"May's Rough Start: Apple, Amazon, Energy Company Earnings Drag Market In Early Going","This morning, investors continue to be in a selling mood as quarterly reports from Apple and Amazon disappointed while worries about tariffs on China have reared their head again.",https://www.forbes.com/sites/jjkinahan/2020/05/01/mays-rough-start-apple-amazon-energy-company-earnings-drag-market-in-early-going/,forbes.com,8,morning investor continue selling mood quarterly report apple amazon disappointed worry tariff china reared head,-0.6486,-0.51888,0.078174,-0.597054,Negative Impact
04/05/2020,112.819,116.35,112.82,115.80,115.80,97318000,2.13,76.34428766,1.192,0,9.3404,0.9034837908,0.2283735172,0.05,256.394,8710.709961,11056.28027,5753.799805,4378.22998,2860.082031,31715.34961,14745,102.3253398,94.42362232,106.3977918,96.68619287,114.1793003,128.9393559,99.41924475,52.04640243,4.810318743,5.398881283,-0.58856254,4.785713741,123.75,8604926000,30.86521315,55.06824875,35.97000122,France rejects Amazon's request for unemployment schemes at six sites,"The French government has rejected Amazon 's request to tap a state partial unemployment scheme for employees at its six warehouses in the country, a spokeswoman for the labour ministry said on Monday.",https://www.reuters.com/article/us-health-coronavirus-amazon-france/france-rejects-amazons-request-for-unemployment-schemes-at-six-sites-idUSKBN22G1IA,reuters.com,10,french government rejected amazon request tap state partial unemployment scheme employee six warehouse country spokeswoman labour ministry said monday,-0.6705,-0.6705,-0.060502,-0.609998,Negative Impact
05/05/2020,117,117.55,115.36,115.89,115.89,64850000,2.13,76.34428766,1.192,0,9.3404,0.9034837908,0.2283735172,0.05,256.394,8809.120117,11135.40039,5849.399902,4483.129883,2860.082031,31453.50977,14811.59961,102.6338498,94.51194233,106.7700353,96.87727552,114.9798252,128.1224183,101.8372321,50.65232692,4.408505884,5.200806203,-0.792300319,4.626785278,123.31276,8669776000,28.0944032,31.17599879,33.61000061,"Amazon: Still Delivering Strong Growth, Still Cheaply Valued","Amazon: Still Delivering Strong Growth, Still Cheaply Valued",https://seekingalpha.com/article/4342949-amazon-still-delivering-strong-growth-still-cheaply-valued,seekingalpha.com,6,amazon still delivering strong growth still cheaply valued,0.8591,0.51546,0.12188375,0.39357625,Positive Impact
06/05/2020,116.472,117.87,116.00,117.56,117.56,62356000,2.13,76.34428766,1.192,0,9.3404,0.9034837908,0.2283735172,0.05,256.394,8854.389648,10999.99023,5853.799805,4433.379883,2878.139893,31685.75,14830.7002,103.0123698,94.60334984,107.1932889,97.08310366,115.8289753,127.1180348,104.5399158,45.98309761,4.176914877,4.996027938,-0.819113061,4.220820836,122.8930096,8732132000,43.39953711,34.11971782,34.11999893,"As coronavirus kills another Amazon worker, the company's response is adding to employees' fears",The death comes as Amazon faces continued criticism over its treatment of warehouse workers during the pandemic.,https://www.cnbc.com/2020/05/06/amazon-worker-in-illinois-dies-of-coronavirus.html,cnbc.com,9,death come amazon face continued criticism treatment warehouse worker pandemic,-0.7269,-0.65421,0.09241842105,-0.746628421,Negative Impact
07/05/2020,118.739,118.80,117.16,118.38,118.38,67928000,2.13,76.34428766,1.192,0,9.3404,0.9034837908,0.2283735172,0.05,256.394,8979.660156,11121.66992,5936,4501.439941,2871.522949,31443.38086,14833.7002,103.4003899,94.69662983,107.6320031,97.29501806,116.6405003,125.9489923,107.3320082,49.46587929,4.013082218,4.799438794,-0.786356576,4.009106772,122.4900492,8800060000,50.87824237,40.79072756,31.44000053,Senators ask Jeff Bezos for answers on whether Amazon retaliated against coronavirus whistleblowers,Amazon has fired at least four workers in recent months who were outspoken critics of its labor policies.,https://www.cnbc.com/2020/05/07/senators-ask-jeff-bezos-for-more-info-on-amazon-firings.html,cnbc.com,9,amazon fired least four worker recent month outspoken critic labor policy,-0.6124,-0.55116,-0.005983889,-0.545176111,Negative Impact
08/05/2020,118.607,119.36,117.85,118.98,118.98,64132000,2.13,76.34428766,1.192,0,9.3404,0.9034837908,0.2283735172,0.05,256.394,9121.320313,11354.33984,5936,4549.640137,2895.340088,31642.69922,14966.59961,103.8956999,94.79132984,108.0770422,97.51079399,117.4826252,123.8494425,111.1158079,48.97837473,3.886853292,4.616921694,-0.730068401,3.867178236,122.1032073,8864192000,56.36720484,50.21499477,27.97999954,Amazon Original-Serie Regular Heroes mit Geschichten ÃÂÃÂ¼ber mutiges Engagement an vorderster Front von COVID-19 kommt am 8. Mai heraus,"CULVER CITY, Kalifornien--(BUSINESS WIRE)--Regular Heroes (ÃÂÃÂAlltagsheldenÃÂÃÂ) ist eine achtteilige Dokuserie, in der die BeitrÃÂÃÂ¤ge und persÃÂÃÂ¶nlichen Opfer von besonders engagierten Einzelpersonen prÃÂÃÂ¤sentiert werden, die gerade viel mehr leisten, als sie eigentlich mÃÂÃÂ¼ssten, um ihre Communitys wÃÂÃÂ¤hrend der COVID-19-Krise zu unterstÃÂÃÂ¼tzen. Die Serie wird am Freitag, den 8. Mai in den USA, dem Vereinigten KÃÂÃÂ¶nigreich, Kanada und Australien erstmals auf Amazon Prime Video gezeigt. In der Serie wird nicht nur die unermÃÂÃÂ¼dliche Arbeit der Helden herausgestellt und nÃÂÃÂ¤her auf deren BemÃÂÃÂ¼hungen in StÃÂÃÂ¤dten wie u. a. New York, Los Angeles, New Orleans, Chicago und Seattle eingegangen; es gibt ferner direkte UnterstÃÂÃÂ¼tzung und Hilfe mit Spenden u. a. von Waren und Dienstleistungen, damit diese Leute weitermachen und ihren Communitys helfen kÃÂÃÂ¶nnen. Neue Episoden von Regular Heroes werden jeweils freitags zu sehen sein. Die Serie wird am 12. Mai 2020 in allen anderen Gebieten herauskommen, in denen Amazon Prime Video verfÃÂÃÂ¼gbar ist. In der ersten Episode von Regular Heroes wird die gebÃÂÃÂ¼rtige New Yorkerin und 15-fache Grammy-Gewinnerin, SÃÂÃÂ¤ngerin, Produzentin und Autorin Alicia Keys auf Trevor Henry, Burnell Cotlon und Athena Hayley hinweisen, die alle jeweils persÃÂÃÂ¶nliche Opfer fÃÂÃÂ¼r ihre Familien und Communitys bringen. AuÃÂÃÂerdem wird KeysÃÂÃÂ bewegender neuer Song ÃÂÃÂGood JobÃÂÃÂ in der Serie zu hÃÂÃÂ¶ren sein. Die folgenden Episoden mit weiteren Talenten und Helden sollen zu einem spÃÂÃÂ¤teren Zeitpunkt angekÃÂÃÂ¼ndigt werden. ÃÂÃÂDiese Sendung ist toooooll!!! So echt und authentisch! Ich freue mich, weil ich weiÃÂÃÂ, dass diese Serie fÃÂÃÂ¼r so tolle Leute wie Trevor, Burnell und Hayley nicht nur UnterstÃÂÃÂ¼tzung, sondern auch Sichtbarkeit schaffen wird. Diesen Menschen applaudieren wir jeden Abend um 19:00 in New York. Das sind die Helden. Und es ist mir eine groÃÂÃÂe Ehre, sie zu feiern!!ÃÂÃÂ sagte Keys. ÃÂÃÂWir sind sehr stolz, dass wir Menschen feiern kÃÂÃÂ¶nnen, die so viel tun, um die LebensqualitÃÂÃÂ¤t der Menschen in ihren Communitys zu verÃÂÃÂ¤ndern. Diese Sendung ist inspiriert von den Einzelpersonen, die anderen an jedem Tag des Jahres so viel geben ÃÂÃÂ noch mehr aber zu dieser schwierigen Zeit. Sie sind wahre Vorbilder, und wir kÃÂÃÂ¶nnen es nicht erwarten, ihre Geschichten den Kunden von Prime Video ÃÂÃÂ¼berall zu zeigenÃÂÃÂ, sagte Jennifer Salke, Leiterin von Amazon Studios. Episode eins (8. Mai 2020): ÃÂÃÂA New Type Of HeroÃÂÃÂ (ÃÂÃÂEine neue Art von HeldÃÂÃÂ) mit Alicia Keys als Stargast. Mit: TREVOR HENRY (NEW YORK) Trevor Henry, geboren und aufgewachsen in der Bronx, ist Ehemann und Vater von vier Kindern. Er arbeitet als leitender Logistiker am HSS (Hospital for Special Surgery, Klinik fÃÂÃÂ¼r Spezialchirurgie). Er hat einen Zehn-Stunden-Tag und unterstÃÂÃÂ¼tzt ÃÂÃÂrzte und PflegekrÃÂÃÂ¤fte, die sich um die krÃÂÃÂ¤nksten COVID-19-Patienten in der Klinik kÃÂÃÂ¼mmern. Wenn Trevor nicht in der Klinik ist, hilft er seinen Kindern bei den Hausaufgaben und wechselt sich dabei mit seiner Frau ab, die in einer anderen Klinik in New York ebenfalls eine unentbehrliche Fachkraft ist. BURNELL COTLON (NEW ORLEANS) Seit zehn Jahren gehÃÂÃÂ¶rt Burnell Cotlon zum New Orleanser Stadtteil Lower 9th Ward. Nachdem der Hurrikan Katrina alle existenzfÃÂÃÂ¤higen Unternehmen der Stadt ruiniert hatte, investierte Burnell seine Ersparnisse in den Aufbau eines LebensmittelgeschÃÂÃÂ¤fts ÃÂÃÂ ÃÂÃÂBurnellÃÂÃÂs 9th Ward GroceryÃÂÃÂ. Als einziges LebensmittelgeschÃÂÃÂ¤ft innerhalb eines Radius von fÃÂÃÂ¼nf Meilen bedient Burnell seine Kunden weiterhin, nachdem diese von massiven Entlassungen betroffen waren. So spendet er auch Lebensmittel an BedÃÂÃÂ¼rftige. Er hat es sich zur Lebensaufgabe gemacht, dass der Lower 9th Ward wieder den gleichen Standard erreicht wie der Rest von New Orleans. ATHENA HAYLEY (LOS ANGELES) Nachdem sie aus der Obdachlosigkeit herausgekommen war, nahm sich Athena Hayley, die unter ihrem Nachnamen bekannt ist, vor, anderen zu helfen, die in die gleiche Lage geraten sind. Als eine, die nie aufgibt, vermietete Hayley das Wohnzimmer ihrer Wohnung weiter, sobald sie nicht mehr auf der StraÃÂÃÂe leben musste. So hatte sie gerade genug zum Leben und konnte etwas Geld zur Seite legen, um die ÃÂÃÂLove My Neighbor FoundationÃÂÃÂ zu grÃÂÃÂ¼nden. In den letzten fÃÂÃÂ¼nf Jahren war Hayley eine sehr wichtige PersÃÂÃÂ¶nlichkeit fÃÂÃÂ¼r die Bewohner der berÃÂÃÂ¼chtigten Skid Row. ÃÂÃÂber ihre Organisation hilft sie mit bei der Versorgung von BedÃÂÃÂ¼rftigen mit Lebensmitteln und Kleidung. In Regular Heroes sollen Menschen aus allen Lebensbereichen gezeigt werden, die in ihren StÃÂÃÂ¤dten und Communitys etwas bewegen: GesundheitsfachkrÃÂÃÂ¤fte und RettungskrÃÂÃÂ¤fte, Mitarbeiter von LebensmittelgeschÃÂÃÂ¤ften, Bauern, Busfahrer, Zustellpersonal, StadtreinigungskrÃÂÃÂ¤fte, Polizeibeamte und andere. Wenn Sie oder jemand aus Ihrem Umfeld AuÃÂÃÂergewÃÂÃÂ¶hnliches in seiner Community leistet, bewerben Sie sich bitte ÃÂÃÂ¼ber Regular-Heroes.com. Regular Heroes wird produziert von Amazon Studios in Zusammenarbeit mit Philymack, TyTy & Jay Brown Productions und MGMÃÂÃÂs Big Fish Entertainment. Philip McIntyre, John Lloyd Taylor, Laurence ÃÂÃÂJayÃÂÃÂ Brown, Tyran ÃÂÃÂTy TyÃÂÃÂ Smith, Dan Cesareo, Lucilla DÃÂÃÂAgostino und Jordana Starr fungieren als Executive Producers. ÃÂÃÂber Prime Video Mit Prime Video erhalten die Kunden eine breite Sammlung digitaler Videos ÃÂÃÂ die man sich jeweils auf praktisch jedem GerÃÂÃÂ¤t ansehen kann. Prime Video umfasst: Viele beliebte Spielfilme und Fernsehsendungen, preisgekrÃÂÃÂ¶nte Amazon Originals und andere ExklusivbeitrÃÂÃÂ¤ge, Sport und mehr. Die mit dem Think Emmy Award ausgezeichneten Sendungen Fleabag und The Marvelous Mrs. Maisel, Tom ClancyÃÂÃÂs Jack Ryan, Mindy KalingÃÂÃÂs Late Night, Donald GloverÃÂÃÂs Guava Island, das fÃÂÃÂ¼r den Academy Award nominierte The Big Sick, Troop Zero, The Boys, Homecoming, Thursday Night Football sowie lizenzierte und selbst verÃÂÃÂ¶ffentlichte Inhalte. Prime Video ist weltweit in mehr als 240 LÃÂÃÂ¤ndern und Territorien verfÃÂÃÂ¼gbar (Angebote und Titel variieren je nach Standort). KanÃÂÃÂ¤le von Prime Video: Prime-Mitglieder kÃÂÃÂ¶nnen KanÃÂÃÂ¤le wie HBO, Cinemax, STARZ, SHOWTIME, CBS All Access, NBA League Pass und MLB.tv hinzufÃÂÃÂ¼gen ÃÂÃÂ ohne dass Extra-Apps heruntergeladen werden mÃÂÃÂ¼ssen oder Kabel notwendig wÃÂÃÂ¤ren. Sie zahlen nur fÃÂÃÂ¼r jene KanÃÂÃÂ¤le, die Sie wollen, und kÃÂÃÂ¶nnen sie jederzeit kÃÂÃÂ¼ndigen. Die vollstÃÂÃÂ¤ndige Liste der verfÃÂÃÂ¼gbaren KanÃÂÃÂ¤le finden Sie unter amazon.com/channels. Ausleihen oder Kaufen: Freuen Sie sich ÃÂÃÂ¼ber neu herausgekommene Spielfilme, die Sie ausleihen oder kaufen kÃÂÃÂ¶nnen, gesamte Staffeln aktueller Fernsehsendungen, die Sie jetzt kaufen kÃÂÃÂ¶nnen, und spezielle Angebote fÃÂÃÂ¼r Prime-Mitglieder. Sofortiger Zugriff: Sehen Sie sich alles zu Hause oder unterwegs mit dem GerÃÂÃÂ¤t Ihrer Wahl an ÃÂÃÂ Hunderte von GerÃÂÃÂ¤ten sind kompatibel. Streamen Sie aus dem Netz oder ÃÂÃÂ¼ber die Prime Video-App auf Smartphone, Tablet, Set-Top-Box, Spielkonsole oder einem ausgewÃÂÃÂ¤hlten Smart-TV. Eine vollstÃÂÃÂ¤ndige Liste der kompatiblen GerÃÂÃÂ¤te finden Sie unter amazon.com/howtostream. Verbesserte Erfahrungen: Mit 4K Ultra HD- und High Dynamic Range (HDR)-kompatiblen Inhalten kÃÂÃÂ¶nnen Sie das Beste aus jeder Wiedergabe herausholen. Blicken Sie hinter die Kulissen Ihrer Lieblingsfilme und -fernsehsendungen mit exklusivem X-Ray-Zugang, unterstÃÂÃÂ¼tzt von IMDb. Speichern Sie es fÃÂÃÂ¼r spÃÂÃÂ¤ter mit ausgewÃÂÃÂ¤hlten mobilen Downloads zur Offline-Betrachtung. Prime Video ist nur einer der vielen Vorteile, die bei der Prime-Mitgliedschaft mit dabei sind. Ebenfalls angeboten wird die kostenlose Lieferung von Millionen von Artikeln auf Amazon.com, unbegrenzter Speicherplatz fÃÂÃÂ¼r Fotos, exklusive Angebote und Rabatte sowie Zugang auf werbefreie Musik und Kindle-E-Books. Melden Sie sich fÃÂÃÂ¼r Amazon Prime an, oder testen Sie es kostenlos: amazon.com/prime. Die Ausgangssprache, in der der Originaltext verÃÂÃÂ¶ffentlicht wird, ist die offizielle und autorisierte Version. ÃÂÃÂbersetzungen werden zur besseren VerstÃÂÃÂ¤ndigung mitgeliefert. Nur die Sprachversion, die im Original verÃÂÃÂ¶ffentlicht wurde, ist rechtsgÃÂÃÂ¼ltig. Gleichen Sie deshalb ÃÂÃÂbersetzungen mit der originalen Sprachversion der VerÃÂÃÂ¶ffentlichung ab.",https://www.businesswire.com/news/home/20200508005558/de/,businesswire.com,5,culver city kalifornienbusiness wireregular hero alltagshelden ist eine achtteilige dokuserie der die beitrge und persnlichen opfer von besonders engagierten einzelpersonen prsentiert werden die gerade viel mehr leisten al sie eigentlich mssten um ihre community whrend der covidkrise zu untersttzen die serie wird freitag den mai den usa dem vereinigten knigreich kanada und australien erstmals auf amazon prime video gezeigt der serie wird nicht nur die unermdliche arbeit der helden herausgestellt und nher auf deren bemhungen stdten wie u new york los angeles new orleans chicago und seattle eingegangen e gibt ferner direkte untersttzung und hilfe mit spenden u von waren und dienstleistungen damit diese leute weitermachen und ihren community helfen knnen neue episoden von regular hero werden jeweils freitags zu sehen sein die serie wird mai allen anderen gebieten herauskommen denen amazon prime video verfgbar ist der ersten episode von regular hero wird die gebrtige new yorkerin und fache grammygewinnerin sngerin produzentin und autorin alicia key auf trevor henry burnell cotlon und athena hayley hinweisen die alle jeweils persnliche opfer fr ihre familien und community bringen auerdem wird key bewegender neuer song good job der serie zu hren sein die folgenden episoden mit weiteren talenten und helden sollen zu einem spteren zeitpunkt angekndigt werden diese sendung ist toooooll echt und authentisch ich freue mich weil ich wei das diese serie fr tolle leute wie trevor burnell und hayley nicht nur untersttzung sondern auch sichtbarkeit schaffen wird diesen menschen applaudieren wir jeden abend um new york da sind die helden und e ist mir eine groe ehre sie zu feiern sagte key wir sind sehr stolz das wir menschen feiern knnen die viel tun um die lebensqualitt der menschen ihren community zu verndern diese sendung ist inspiriert von den einzelpersonen die anderen jedem tag de jahres viel geben noch mehr aber zu dieser schwierigen zeit sie sind wahre vorbilder und wir knnen e nicht erwarten ihre geschichten den kunden von prime video berall zu zeigen sagte jennifer salke leiterin von amazon studio episode eins mai new type hero eine neue art von held mit alicia key al stargast mit trevor henry new york trevor henry geboren und aufgewachsen der bronx ist ehemann und vater von vier kindern er arbeitet al leitender logistiker hs hospital special surgery klinik fr spezialchirurgie er hat einen zehnstundentag und untersttzt rzte und pflegekrfte die sich um die krnksten covidpatienten der klinik kmmern wenn trevor nicht der klinik ist hilft er seinen kindern bei den hausaufgaben und wechselt sich dabei mit seiner frau ab die einer anderen klinik new york ebenfalls eine unentbehrliche fachkraft ist burnell cotlon new orleans seit zehn jahren gehrt burnell cotlon zum new orleanser stadtteil lower th ward nachdem der hurrikan katrina alle existenzfhigen unternehmen der stadt ruiniert hatte investierte burnell seine ersparnisse den aufbau eines lebensmittelgeschfts burnells th ward grocery al einziges lebensmittelgeschft innerhalb eines radius von fnf meilen bedient burnell seine kunden weiterhin nachdem diese von massiven entlassungen betroffen waren spendet er auch lebensmittel bedrftige er hat e sich zur lebensaufgabe gemacht das der lower th ward wieder den gleichen standard erreicht wie der rest von new orleans athena hayley los angeles nachdem sie au der obdachlosigkeit herausgekommen war nahm sich athena hayley die unter ihrem nachnamen bekannt ist vor anderen zu helfen die die gleiche lage geraten sind al eine die nie aufgibt vermietete hayley da wohnzimmer ihrer wohnung weiter sobald sie nicht mehr auf der strae leben musste hatte sie gerade genug zum leben und konnte etwas geld zur seite legen um die love neighbor foundation zu grnden den letzten fnf jahren war hayley eine sehr wichtige persnlichkeit fr die bewohner der berchtigten skid row ber ihre organisation hilft sie mit bei der versorgung von bedrftigen mit lebensmitteln und kleidung regular hero sollen menschen au allen lebensbereichen gezeigt werden die ihren stdten und community etwas bewegen gesundheitsfachkrfte und rettungskrfte mitarbeiter von lebensmittelgeschften bauern busfahrer zustellpersonal stadtreinigungskrfte polizeibeamte und andere wenn sie oder jemand au ihrem umfeld auergewhnliches seiner community leistet bewerben sie sich bitte ber regularheroescom regular hero wird produziert von amazon studio zusammenarbeit mit philymack tyty jay brown production und mgms big fish entertainment philip mcintyre john lloyd taylor laurence jay brown tyran ty ty smith dan cesareo lucilla dagostino und jordana starr fungieren al executive producer ber prime video mit prime video erhalten die kunden eine breite sammlung digitaler video die man sich jeweils auf praktisch jedem gert ansehen kann prime video umfasst viele beliebte spielfilme und fernsehsendungen preisgekrnte amazon original und andere exklusivbeitrge sport und mehr die mit dem think emmy award ausgezeichneten sendungen fleabag und marvelous mr maisel tom clancys jack ryan mindy kalings late night donald glovers guava island da fr den academy award nominierte big sick troop zero boy homecoming thursday night football sowie lizenzierte und selbst verffentlichte inhalte prime video ist weltweit mehr al lndern und territorien verfgbar angebote und titel variieren je nach standort kanle von prime video primemitglieder knnen kanle wie hbo cinemax starz showtime cbs access nba league pas und mlbtv hinzufgen ohne das extraapps heruntergeladen werden mssen oder kabel notwendig wren sie zahlen nur fr jene kanle die sie wollen und knnen sie jederzeit kndigen die vollstndige liste der verfgbaren kanle finden sie unter amazoncomchannels ausleihen oder kaufen freuen sie sich ber neu herausgekommene spielfilme die sie ausleihen oder kaufen knnen gesamte staffeln aktueller fernsehsendungen die sie jetzt kaufen knnen und spezielle angebote fr primemitglieder sofortiger zugriff sehen sie sich alles zu hause oder unterwegs mit dem gert ihrer wahl hunderte von gerten sind kompatibel streamen sie au dem netz oder ber die prime videoapp auf smartphone tablet settopbox spielkonsole oder einem ausgewhlten smarttv eine vollstndige liste der kompatiblen gerte finden sie unter amazoncomhowtostream verbesserte erfahrungen mit k ultra hd und high dynamic range hdrkompatiblen inhalten knnen sie da beste au jeder wiedergabe herausholen blicken sie hinter die kulissen ihrer lieblingsfilme und fernsehsendungen mit exklusivem xrayzugang untersttzt von imdb speichern sie e fr spter mit ausgewhlten mobilen downloads zur offlinebetrachtung prime video ist nur einer der vielen vorteile die bei der primemitgliedschaft mit dabei sind ebenfalls angeboten wird die kostenlose lieferung von millionen von artikeln auf amazoncom unbegrenzter speicherplatz fr fotos exklusive angebote und rabatte sowie zugang auf werbefreie musik und kindleebooks melden sie sich fr amazon prime oder testen sie e kostenlos amazoncomprime die ausgangssprache der der originaltext verffentlicht wird ist die offizielle und autorisierte version bersetzungen werden zur besseren verstndigung mitgeliefert nur die sprachversion die im original verffentlicht wurde ist rechtsgltig gleichen sie deshalb bersetzungen mit der originalen sprachversion der verffentlichung ab,-0.9986,-0.4993,0.1314577778,-0.630757778,Negative Impact
11/05/2020,118.735,120.98,118.61,120.45,120.45,65184000,2.13,76.34428766,1.192,0,9.3404,0.9034837908,0.2283735172,0.05,256.394,9192.339844,11281.37012,5939.700195,4490.220215,2894.800049,31561.2207,15103.2002,104.4209499,94.90012482,108.5622561,97.73904477,118.0829502,122.9482812,113.2176192,56.23035731,3.860886248,4.465714604,-0.604828357,3.506142753,121.731839,8929376000,69.81060172,59.01868298,27.56999969,"60 Minutes shows AmazonÃÂÃÂs virus-killing robot, says company uses AI to enforce social distancing","Amazon is developing a robot that would roll through grocery stores and distribution centers, using banks of ultraviolet light to kill viruses on surfaces.",https://www.geekwire.com/2020/60-minutes-shows-amazons-virus-killing-robot-says-company-uses-ai-enforce-social-distancing/,geekwire.com,5,amazon developing robot would roll grocery store distribution center using bank ultraviolet light kill virus surface,-0.6124,-0.3062,0.3055970588,-0.611797059,Negative Impact
12/05/2020,120.5925,120.95,117.75,117.85,117.85,61498000,2.13,76.34428766,1.192,0,9.3404,0.9034837908,0.2283735172,0.05,256.394,9002.549805,11055.58008,5994.799805,4472.5,2891.555908,31371.11914,14881.2002,104.8239499,95.00359985,108.9263834,97.93912894,118.2670254,122.773737,113.7603138,49.50883794,3.588936691,4.290359022,-0.70142233,3.49942834,121.3753255,8867878000,46.00222789,57.39334482,33.04000092,"Coalition of U.S. attorneys general ask Amazon for data on COVID-linked worker deaths, infections",A group of 13 U.S. attorneys general asked Amazon.com on Tuesday to provide data on infections and deaths among its workforce along with evidence of the company's compliance with paid sick leave laws amid the coronavirus crisis.,https://www.reuters.com/article/us-health-coronavirus-amazon-com/coalition-of-u-s-attorneys-general-ask-amazon-for-data-on-covid-linked-worker-deaths-infections-idUSKBN22O2LQ,reuters.com,10,group u attorney general asked amazoncom tuesday provide data infection death among workforce along evidence company compliance paid sick leave law amid coronavirus crisis,-0.91,-0.91,0.03964588235,-0.949645882,Negative Impact
13/05/2020,118.34,120.39,116.89,118.40,118.40,95658000,2.13,76.34428766,1.192,0,9.3404,0.9034837908,0.2283735172,0.05,256.394,8863.169922,10829.44043,5904.100098,4344.950195,2898.050049,32008.60938,14503.2002,105.2828799,95.11746738,109.2977411,98.14267993,118.4176254,122.7151361,114.1201147,47.539677,3.378726227,4.108032463,-0.729306236,3.532178606,121.0330724,8963536000,51.02006773,55.61096578,35.27999878,"Amazon Is Eliminating Waitlists and Quantity Limits, Restoring Some Services",The moves indicate that the worst of COVID-19's effects may be over at its warehouses.,https://www.fool.com/investing/2020/05/13/amazon-is-eliminating-waitlists-and-quantity-limit.aspx,fool.com,7,move indicate worst covids effect may warehouse,-0.6249,-0.43743,0.2021890909,-0.639619091,Negative Impact
14/05/2020,118.0505,119.57,117.66,119.44,119.44,72962000,2.13,76.34428766,1.192,0,9.3404,0.9034837908,0.2283735172,0.05,256.394,8943.719727,10927.41016,5741.5,4273.129883,2870.342041,31122.89063,14509.7002,105.6959,95.24004738,109.6955747,98.35461841,118.3692753,122.5935631,114.1449875,48.35849431,3.259008381,3.938227647,-0.679219265,3.531214033,120.9499969,9036498000,60.59369826,52.53866463,32.61000061,Amazon's livestreaming platform Twitch announces safety advisory council,"Amazon Inc (AMZN.O)ÃÂÃÂs video game live-streaming platform Twitch is forming an advisory council of experienced users, online safety experts and anti-bullying advocates to help improve safety on the site, Twitch said in a blog post on Thursday.",https://www.reuters.com/article/us-amazon-twitch-safety/amazons-livestreaming-platform-twitch-announces-safety-advisory-council-idUSKBN22Q2Q6,reuters.com,10,amazon inc amznos video game livestreaming platform twitch forming advisory council experienced user online safety expert antibullying advocate help improve safety site twitch said blog post thursday,0.8979,0.8979,0.193752,0.704148,Positive Impact
15/05/2020,118.426,120.55,117.82,120.49,120.49,84700000,2.13,76.34428766,1.192,0,9.3404,0.9034837908,0.2283735172,0.05,256.394,9014.55957,10947.32031,5799.799805,4277.629883,2868.458984,31097.73047,14638.90039,106.1816499,95.37579739,110.1188462,98.574861,118.4562252,122.7838343,114.1286161,52.64882501,3.211554226,3.792892962,-0.581338737,3.433892931,120.6247571,9121198000,70.16739859,60.59372153,31.88999939,Amazon declines to commit to Jeff Bezos testimony in Congress,"Earlier this month, members of the House Judiciary Committee accused Amazon of lying to Congress over its private label strategy.",https://www.cnbc.com/2020/05/15/amazon-declines-to-commit-to-jeff-bezos-testimony-in-congress.html,cnbc.com,9,earlier month member house judiciary committee accused amazon lying congress private label strategy,-0.5994,-0.53946,-0.057163125,-0.482296875,Negative Impact
18/05/2020,120.2175,121.65,119.20,121.31,121.31,87144000,2.13,76.34428766,1.192,0,9.3404,0.9034837908,0.2283735172,0.05,256.394,9234.830078,11402.23047,6048.600098,4498.339844,2875.417969,30028.98047,14638.90039,106.7068201,95.51853241,110.5578328,98.80111117,118.5378506,123.0214591,114.054242,59.47147143,3.203508738,3.675016118,-0.471507379,3.358857291,112.8190002,9208342000,77.70563979,69.48891222,29.29999924,Amazon's French warehouses to resume work with 30% of staff on Tuesday: unions,"Amazon's French warehouses are set to re-open on Tuesday with about 30% of employees, three union officials said, following an agreement with staff representatives last week.",https://www.reuters.com/article/us-health-coronavirus-amazon-france/amazons-french-warehouses-to-resume-work-with-30-of-staff-on-tuesday-unions-idUSKBN22U27I,reuters.com,10,amazon french warehouse set reopen tuesday employee three union official said following agreement staff representative last week,0.5994,0.5994,0.203854,0.395546,Positive Impact
19/05/2020,121.4915,124.25,121.45,122.47,122.47,86410000,2.13,76.34428766,1.192,0,9.3404,0.9034837908,0.2283735172,0.05,256.394,9185.099609,11248.96973,6002.200195,4458.160156,2898.575928,30196.16992,14885.5,107.35554,95.67505489,111.0248393,99.03658767,118.8408756,123.5322124,114.1495388,56.8823734,3.25271483,3.59055586,-0.33784103,3.276178632,112.9956203,9294752000,84.39768428,77.42357422,30.53000069,"As Amazon Reportedly Eyes Bankrupt J.C. Penney, Coronavirus May Be Heating Up M&A Deal Activities","After its 2017 purchase of Whole Foods, Amazon is reportedly eyeing bankrupt J.C. Penney for some deal as retail and consumer M&A activity scene is expected to heat up in the coronavirus era.",https://www.forbes.com/sites/andriacheng/2020/05/19/as-amazon-reportedly-eyes-bankrupt-jc-penney-coronavirus-may-be-heating-up-ma-deal-activities/,forbes.com,8,purchase whole food amazon reportedly eyeing bankrupt jc penney deal retail consumer activity scene expected heat coronavirus era,-0.4404,-0.35232,0.20701625,-0.55933625,Negative Impact
20/05/2020,123.8935,125.00,123.36,124.90,124.90,79962000,2.13,76.34428766,1.192,0,9.3404,0.9034837908,0.2283735172,0.05,256.394,9375.780273,11420.04004,6067.200195,4496.97998,2883.738037,30818.60938,14997.59961,107.96166,95.85825741,111.5688457,99.29390524,119.1770008,124.5770801,113.7769215,52.37520248,3.448084982,3.562061684,-0.113976702,3.091857365,113.4457955,9374714000,99.15034817,87.08455741,27.98999977,"Amazon launches its first big-budget game, a shooter called Crucible","Amazon's content strategy has been centered around boosting subscriptions to Amazon Prime, the company's subscription program, which is an increasingly vital part of its business.",https://www.cnbc.com/2020/05/20/amazon-launches-crucible-first-big-budget-game.html,cnbc.com,9,amazon content strategy centered around boosting subscription amazon prime company subscription program increasingly vital part business,0.7184,0.64656,0.229144,0.417416,Positive Impact
21/05/2020,125,126.27,122.13,122.34,122.34,102288000,2.13,76.34428766,1.192,0,9.3404,0.9034837908,0.2283735172,0.05,256.394,9284.879883,11351.59961,6015.299805,4445.450195,2867.924072,30932.90039,14884.90039,108.58754,96.02298489,111.9911262,99.52318974,119.2952255,124.8693628,113.7210882,71.88180584,3.357641411,3.52117763,-0.163536218,2.617214748,114.1390779,9272426000,70.74737847,84.76513697,29.53000069,Crucible ÃÂÃÂ Free-to-play Shooter von Amazon Games ab sofort erhÃÂÃÂ¤ltlich,"SEATTLE--(BUSINESS WIRE)--(NASDAQ: AMZN): Crucible, der free-to-play Team-Action-Shooter von Amazon Games wird von Relentless Studios entwickelt und ist ab sofort als Download fÃÂÃÂ¼r PC erhÃÂÃÂ¤ltlich. In Crucible arbeiten die Spieler mit ihren Teamkameraden zusammen, um Gegner zu jagen und feindliche Kreaturen zu besiegen ÃÂÃÂ das alles auf einem vagabundierenden Planeten und auf der Suche nach der ÃÂÃÂEssenzÃÂÃÂ, einer wertvollen Ressource, die die KrÃÂÃÂ¤fte der JÃÂÃÂ¤ger verstÃÂÃÂ¤rkt. Den Launch-Trailer gibt es hier: https://youtu.be/ZnPp6pXZ3XI Bild- und Videomaterial ist unter folgendem Link verfÃÂÃÂ¼gbar: https://msm.download/Crucible_Launch_Assets Zu Beginn treffen die Spieler ihre Wahl aus einem abwechslungsreichen Kader mit zehn JÃÂÃÂ¤gern ÃÂÃÂ unter anderem Earl, einem interstellaren Trucker, Summer, einer frÃÂÃÂ¼heren SchweiÃÂÃÂerin mit Doppel-Flammenwerfer und Bugg, einem Robot-Botaniker. Jeder der JÃÂÃÂ¤ger in Crucible verfÃÂÃÂ¼gt ÃÂÃÂ¼ber einzigartige Waffen und FÃÂÃÂ¤higkeiten. WÃÂÃÂ¤hrend sie Gegner bezwingen und gegen die Flora und Fauna des Planeten bestehen, leveln sie hoch, gewinnen an Kraft und verbessern ihre FÃÂÃÂ¤higkeiten. Crucibles schnelle Gefechte erfordern es, dass die Spieler ihre Strategien permanent anpassen ÃÂÃÂ an das Vorgehen ihrer Gegner, den stÃÂÃÂ¤ndig im Wandel befindlichen Planeten und sich entwickelnde Situationen. ÃÂÃÂIch wusste bereits beim ersten Spiel, dass Crucible etwas Besonderes ist, und irgendwie wird es immer besserÃÂÃÂ, so Twitch-Creator Sasslyn. ÃÂÃÂDie JÃÂÃÂ¤ger sind einzigartig, doch auf angenehme Weise bekannt. Ganz gleich, ob man sich auf einen festlegt oder Allrounder ist, es gibt immer einen JÃÂÃÂ¤ger, der zu einem bevorzugten Spielstil passt. Die ganze Entwicklung von Crucible hindurch hatte ich das VergnÃÂÃÂ¼gen, erleben zu kÃÂÃÂ¶nnen, wie sehr das Team auf seine Spieler eingeht, und auf welche Art und Weise es Feedback ernst nimmt und nutzt, um aus Crucible einen noch innovativeren und einzigartigeren Titel zu machen.ÃÂÃÂ ÃÂÃÂEtwas, das Crucible von anderen Titeln abhebt, ist die Vielfalt seiner CharaktereÃÂÃÂ, so Twitch-Creator Bartonologist. ÃÂÃÂFÃÂÃÂ¼r jeden Geschmack ist etwas da. Jeder Charakter geht das Spiel auf seine Weise an und ist den anderen JÃÂÃÂ¤gern auf einzigartige Weise ebenbÃÂÃÂ¼rtig. Das bringt Strategie und Wettbewerb auf einem ganz neuen Level in die Spielwelt.ÃÂÃÂ ÃÂÃÂDie drei Spielmodi von Crucible erfordern drei komplett verschiedene Arten von Teamwork, um letzten Endes erfolgreich zu seinÃÂÃÂ, so Twitch-Creator Stevo. ÃÂÃÂEs gibt zahllose MÃÂÃÂ¶glichkeiten fÃÂÃÂ¼r siegreiche Strategien und Team-Zusammensetzungen, doch natÃÂÃÂ¼rlich weiÃÂÃÂ man nie, wie die Gegner aufgestellt sein werden!ÃÂÃÂ In Crucible startet heute eine acht Wochen dauernde Pre-Saison. In dieser Zeit kÃÂÃÂ¶nnen die Gamer das Spiel lernen, die FÃÂÃÂ¤higkeiten ihrer liebsten JÃÂÃÂ¤ger entdecken und ausbauen und ihre Strategie optimieren, damit sie fÃÂÃÂ¼r Saison 1 bereit sind. Spieler, die sich bis zum 2. Juni bei Crucible anmelden, erhalten ein FrÃÂÃÂ¼hstarter-Geschenk von 1.000 Credits, das in ihrem Spielkonto deponiert wird. Credits kÃÂÃÂ¶nnen fÃÂÃÂ¼r kosmetische SpielgegenstÃÂÃÂ¤nde wie Skins und Emotes ausgegeben werden, sowie fÃÂÃÂ¼r einen Vorsaison-Battle Pass, der fÃÂÃÂ¼r 950 Credits zu haben ist. Der Pre-Saison-Battle Pass bietet Spielern eine Reihe von Herausforderungen und Belohnungen wie Optionen zur Anpassung von JÃÂÃÂ¤ger und Konto. ÃÂÃÂWÃÂÃÂ¤hrend sich Spieler auf der ganzen Welt heute zum ersten Mal bei Crucible anmelden, verfolgen wir gespannt, wie sie ihre Strategien anpassen, um in der sich stÃÂÃÂ¤ndig verÃÂÃÂ¤ndernden Welt zu jagen und zu ÃÂÃÂ¼berlebenÃÂÃÂ, so Christoph Hartmann, Vice President bei Amazon Games. ÃÂÃÂJedes neue Match in Crucible erfordert schnelles Denken und schnelle Anpassungen, um die Herausforderungen zu bestehen, die einem begegnen.ÃÂÃÂ Crucible startet mit drei Spielmodi: HerzstÃÂÃÂ¼ck der SchwÃÂÃÂ¤rme: Ein 4v4-Gefecht gegen gewaltige Boss-Hives, die ÃÂÃÂ¼berall in der Welt erscheinen. Jeder Hive enthÃÂÃÂ¤lt ein wertvolles Herz, und das erste Team, das sich drei Herzen erkÃÂÃÂ¤mpft, gewinnt das Match ÃÂÃÂ wodurch jedes einzelne Match eine empfindliche Balance zwischen dem Kampf mit dem gegnerischen Team und dem Bestehen gegen die mÃÂÃÂ¤chtigen Hives entwickelt. AlphajÃÂÃÂ¤ger: In AlphajÃÂÃÂ¤ger kÃÂÃÂ¤mpfen acht Zweier-Teams darum, das Gefecht als einzige zu ÃÂÃÂ¼berleben. Erntemaschinenkommando: Erntemaschinenkommando fordert zwei Teams mit jeweils acht Spielern heraus, auf der Karte verteilte Harvester einzunehmen und zu halten ÃÂÃÂ um die Kontrolle ÃÂÃÂ¼ber die Essenz zu ÃÂÃÂ¼bernehmen, die alle auf den Planeten gebracht hat. Teams verdienen sich Punkte, indem sie Harvester kontrollieren und Gegner besiegen. Dem ersten Team mit 100 Punkten gehÃÂÃÂ¶rt der Sieg. Crucible ist auf Steam gratis fÃÂÃÂ¼r PC erhÃÂÃÂ¤ltlich. GrÃÂÃÂ¼nderpakete mit exklusiven Skins und GegenstÃÂÃÂ¤nden zur Anpassung ÃÂÃÂ wie Verzierungen und SpielwÃÂÃÂ¤hrung ÃÂÃÂ sind auf Amazon und Steam kÃÂÃÂ¤uflich erhÃÂÃÂ¤ltlich. Crucible wurde von den Relentless Studios entwickelt, einem in Seattle ansÃÂÃÂ¤ssigen Entwicklungsstudio von Amazon Games. Das Studio wird von Louis Castle geleitet, einem MitgrÃÂÃÂ¼nder der Westwood Studios, und beschÃÂÃÂ¤ftigt Industrieveteranen mit Erfahrung von Unternehmen wie Activision Blizzard, ArenaNet und Electronic Arts. Dem Start von Crucible wird am 25. August ÃÂÃÂ ebenfalls von Amazon Games ÃÂÃÂ der Start von New World folgen. Weitere Informationen zu Crucible gibt es auf http://playcrucible.com. Das Spiel hat eine USK-Freigabe von 12 Jahren. ÃÂÃÂber Amazon Games Amazon Games hat das Ziel, wegweisende neue Spielerfahrungen zu schaffen, die Gemeinschaften in Spielen und um sie herum fÃÂÃÂ¶rdern. Das Team aus Veteranen der Spieleindustrie arbeitet innerhalb der Sandbox der Amazon Web Services (AWS), Twitch und weiteren, um die Grenzen des Machbaren zu erweitern und den Kunden viele fesselnde Erfahrungen zu bieten. Zu den gegenwÃÂÃÂ¤rtigen Projekten von Amazon Games zÃÂÃÂ¤hlen New World, ein MMO auf einem ÃÂÃÂ¼bernatÃÂÃÂ¼rlichen Kontinent im 17. Jahrhundert, der Multiplayer-Shooter Crucible sowie das kommende Der Herr der Ringe-MMO. ÃÂÃÂber Amazon Amazon wird von vier Grundprinzipien geleitet: Fokus auf den Kunden statt auf den Wettbewerb, Leidenschaft fÃÂÃÂ¼rs Erfinden, Verpflichtung zu operativer Exzellenz und langfristiges Denken. Kundenrezensionen, 1-Click Shopping, personalisierte Empfehlungen, Prime, Versand durch Amazon, AWS, Kindle Direct Publishing, Kindle, Fire Tablets, Fire TV, Amazon Echo und Alexa sind nur einige der Produkte und Services, fÃÂÃÂ¼r die Amazon Pionierarbeit geleistet hat. ZusÃÂÃÂ¤tzliche Informationen finden Sie unter amazon.com/about.",https://www.businesswire.com/news/home/20200520005942/de/,businesswire.com,5,seattlebusiness wirenasdaq amzn crucible der freetoplay teamactionshooter von amazon game wird von relentless studio entwickelt und ist ab sofort al download fr pc erhltlich crucible arbeiten die spieler mit ihren teamkameraden zusammen um gegner zu jagen und feindliche kreaturen zu besiegen da alles auf einem vagabundierenden planeten und auf der suche nach der essenz einer wertvollen ressource die die krfte der jger verstrkt den launchtrailer gibt e hier bild und videomaterial ist unter folgendem link verfgbar zu beginn treffen die spieler ihre wahl au einem abwechslungsreichen kader mit zehn jgern unter anderem earl einem interstellaren trucker summer einer frheren schweierin mit doppelflammenwerfer und bugg einem robotbotaniker jeder der jger crucible verfgt ber einzigartige waffen und fhigkeiten whrend sie gegner bezwingen und gegen die flora und fauna de planeten bestehen leveln sie hoch gewinnen kraft und verbessern ihre fhigkeiten crucible schnelle gefechte erfordern e das die spieler ihre strategien permanent anpassen da vorgehen ihrer gegner den stndig im wandel befindlichen planeten und sich entwickelnde situationen ich wusste bereits beim ersten spiel das crucible etwas besonderes ist und irgendwie wird e immer besser twitchcreator sasslyn die jger sind einzigartig doch auf angenehme weise bekannt ganz gleich ob man sich auf einen festlegt oder allrounder ist e gibt immer einen jger der zu einem bevorzugten spielstil passt die ganze entwicklung von crucible hindurch hatte ich da vergngen erleben zu knnen wie sehr da team auf seine spieler eingeht und auf welche art und weise e feedback ernst nimmt und nutzt um au crucible einen noch innovativeren und einzigartigeren titel zu machen etwas da crucible von anderen titeln abhebt ist die vielfalt seiner charaktere twitchcreator bartonologist fr jeden geschmack ist etwas da jeder charakter geht da spiel auf seine weise und ist den anderen jgern auf einzigartige weise ebenbrtig da bringt strategie und wettbewerb auf einem ganz neuen level die spielwelt die drei spielmodi von crucible erfordern drei komplett verschiedene arten von teamwork um letzten endes erfolgreich zu sein twitchcreator stevo e gibt zahllose mglichkeiten fr siegreiche strategien und teamzusammensetzungen doch natrlich wei man nie wie die gegner aufgestellt sein werden crucible startet heute eine acht wochen dauernde presaison dieser zeit knnen die gamer da spiel lernen die fhigkeiten ihrer liebsten jger entdecken und ausbauen und ihre strategie optimieren damit sie fr saison bereit sind spieler die sich bi zum juni bei crucible anmelden erhalten ein frhstartergeschenk von credit da ihrem spielkonto deponiert wird credit knnen fr kosmetische spielgegenstnde wie skin und emotes ausgegeben werden sowie fr einen vorsaisonbattle pas der fr credit zu haben ist der presaisonbattle pas bietet spielern eine reihe von herausforderungen und belohnungen wie optionen zur anpassung von jger und konto whrend sich spieler auf der ganzen welt heute zum ersten mal bei crucible anmelden verfolgen wir gespannt wie sie ihre strategien anpassen um der sich stndig verndernden welt zu jagen und zu berleben christoph hartmann vice president bei amazon game jedes neue match crucible erfordert schnelles denken und schnelle anpassungen um die herausforderungen zu bestehen die einem begegnen crucible startet mit drei spielmodi herzstck der schwrme ein vgefecht gegen gewaltige bosshives die berall der welt erscheinen jeder hive enthlt ein wertvolles herz und da erste team da sich drei herzen erkmpft gewinnt da match wodurch jedes einzelne match eine empfindliche balance zwischen dem kampf mit dem gegnerischen team und dem bestehen gegen die mchtigen hive entwickelt alphajger alphajger kmpfen acht zweierteams darum da gefecht al einzige zu berleben erntemaschinenkommando erntemaschinenkommando fordert zwei team mit jeweils acht spielern heraus auf der karte verteilte harvester einzunehmen und zu halten um die kontrolle ber die essenz zu bernehmen die alle auf den planeten gebracht hat team verdienen sich punkte indem sie harvester kontrollieren und gegner besiegen dem ersten team mit punkten gehrt der sieg crucible ist auf steam gratis fr pc erhltlich grnderpakete mit exklusiven skin und gegenstnden zur anpassung wie verzierungen und spielwhrung sind auf amazon und steam kuflich erhltlich crucible wurde von den relentless studio entwickelt einem seattle ansssigen entwicklungsstudio von amazon game da studio wird von louis castle geleitet einem mitgrnder der westwood studio und beschftigt industrieveteranen mit erfahrung von unternehmen wie activision blizzard arenanet und electronic art dem start von crucible wird august ebenfalls von amazon game der start von new world folgen weitere informationen zu crucible gibt e auf da spiel hat eine uskfreigabe von jahren ber amazon game amazon game hat da ziel wegweisende neue spielerfahrungen zu schaffen die gemeinschaften spielen und um sie herum frdern da team au veteranen der spieleindustrie arbeitet innerhalb der sandbox der amazon web service aws twitch und weiteren um die grenzen de machbaren zu erweitern und den kunden viele fesselnde erfahrungen zu bieten zu den gegenwrtigen projekten von amazon game zhlen new world ein mmo auf einem bernatrlichen kontinent im jahrhundert der multiplayershooter crucible sowie da kommende der herr der ringemmo ber amazon amazon wird von vier grundprinzipien geleitet fokus auf den kunden statt auf den wettbewerb leidenschaft fr erfinden verpflichtung zu operativer exzellenz und langfristiges denken kundenrezensionen click shopping personalisierte empfehlungen prime versand durch amazon aws kindle direct publishing kindle fire tablet fire tv amazon echo und alexa sind nur einige der produkte und service fr die amazon pionierarbeit geleistet hat zustzliche informationen finden sie unter amazoncomabout,-0.9979,-0.49895,0.1412625,-0.6402125,Negative Impact
22/05/2020,122.7505,123.49,121.51,121.84,121.84,57342000,2.13,76.34428766,1.192,0,9.3404,0.9034837908,0.2283735172,0.05,256.394,9324.589844,11331.96973,5993.299805,4444.560059,2813.764893,30672.58984,14913.59961,109.3478101,96.1838549,112.3775135,99.74528738,119.3618755,125.0283343,113.6954168,67.41380303,3.209190011,3.458780106,-0.249590095,2.506929125,115.1097516,9215084000,59.43113626,76.4429543,28.15999985,"Amazon to hire 50,000 temp workers in India as lockdown boosts demand","Amazon.com Inc's India unit said it would hire 50,000 temporary workers to meet a surge in online shopping in the country, where customers have been stuck indoors for two months in a lockdown to fight the coronavirus outbreak.",https://www.reuters.com/article/us-amazon-com-india/amazon-to-hire-50000-temp-workers-in-india-as-lockdown-boosts-demand-idUSKBN22Y166,reuters.com,10,amazoncom inc india unit said would hire temporary worker meet surge online shopping country customer stuck indoors two month lockdown fight coronavirus outbreak,-0.5574,-0.5574,0.10166,-0.65906,Negative Impact
26/05/2020,122.9,123.10,120.70,121.09,121.09,71364000,2.13,76.34428766,1.192,0,9.3404,0.9034837908,0.2283735172,0.05,256.394,9340.219727,11603,6067.799805,4606.240234,2846.547119,30609.30078,15148.09961,109.9846701,96.33109741,112.7192973,99.95770245,119.4765255,125.1877295,113.7653215,64.43995745,2.996401179,3.366304321,-0.369903141,2.521464212,116.0027714,9143720000,49.57899998,59.91917157,28.01000023,Amazon Web Services und die Bundesliga liefern mit ÃÂÃÂBundesliga Match Facts Powered by AWSÃÂÃÂ Spielanalysen in Echtzeit,"SEATTLE--(BUSINESS WIRE)--Amazon Web Services (AWS), ein Amazon.com-Unternehmen (NASDAQ: AMZN), und die Deutsche Bundesliga geben heute Abend um 18:30 Uhr MEZ im Rahmen des Highlight-Spiels Borussia Dortmund gegen Bayern MÃÂÃÂ¼nchen im Fernsehen in ÃÂÃÂ¼ber 200 LÃÂÃÂ¤ndern das DebÃÂÃÂ¼t der ersten beiden Bundesliga Match Facts powered by AWS. Die beiden neuen Statistiken, Durchschnittliche Positionen und Erwartete Tore (xGoals), geben den Fans tiefere Einblicke in die beabsichtigte Spielweise einer Mannschaft, basierend auf Echtzeit-Analysen von Daten, die aus der Verfolgung von Spielerpositionen auf dem Spielfeld erfasst wurden, und der Wahrscheinlichkeit, mit der ein Spieler ein Tor erzielt. Die hÃÂÃÂ¶chste deutsche FuÃÂÃÂball-Bundesliga wird das unÃÂÃÂ¼bertroffene Angebot von AWS an Cloud-Diensten, einschlieÃÂÃÂlich maschinellen Lernens und Analysen, dazu einsetzen, im Jahr 2020 und in den kommenden Spielzeiten zusÃÂÃÂ¤tzliche erweiterte Statistiken einzufÃÂÃÂ¼hren. AWS und die Bundesliga sind die ersten, die diese einzigartige Kombination aus fortschrittlichen Echtzeit-Statistiken und Spielanalysen fÃÂÃÂ¼r FuÃÂÃÂballfans auf der ganzen Welt bereitstellen. Bundesliga Match Facts werden durch das Sammeln von Daten aus den Live-Spielvideo-Feeds generiert, die zur Analyse in AWS gestreamt und dann den Zuschauern weltweit in Echtzeit als Statistiken zur VerfÃÂÃÂ¼gung gestellt werden. Diese Statistiken helfen den Zuschauern dabei, Dinge wie die Strategie bei Entscheidungen auf dem Spielfeld und die Wahrscheinlichkeit eines Tores fÃÂÃÂ¼r jeden Schuss besser zu verstehen. Ab dem 26. Mai stehen bei zukÃÂÃÂ¼nftigen ÃÂÃÂbertragungen von Bundesliga-Spielen Durchschnittspositionen zur VerfÃÂÃÂ¼gung, wÃÂÃÂ¤hrend xGoals bei Highlight-Spielen verfÃÂÃÂ¼gbar sein wird. Ein Blick auf die beiden neuen Bundesliga Match Facts powered by AWS Durchschnittliche Positionen: Die Fans kÃÂÃÂ¶nnen nun die Position der Spieler einer Mannschaft auf dem Spielfeld sehen und erhalten einen Einblick in die beabsichtigte Spielweise der Mannschaft. Die Durchschnittspositionen bieten auf der Grundlage der Analyse von Daten, die bei der Verfolgung der durchschnittlichen Position eines Spielers auf dem Spielfeld erfasst wurden, neue Erkenntnisse, die dann in Echtzeit angezeigt werden. Diese Bundesliga-Spielbilanz ermÃÂÃÂ¶glicht es den Zuschauern, die aktuelle Dynamik auf dem Spielfeld zu erkennen und taktische VerÃÂÃÂ¤nderungen zu verstehen. Die neue Statistik hilft dabei, festzustellen, ob eine Mannschaft im Angriffs- oder Verteidigungsstil aufgestellt ist, die Mitte nach oben drÃÂÃÂ¼ckt oder die Seiten benutzt. Durch die Anzeige des durchschnittlichen Standorts und der durchschnittlichen Position jedes Spielers in Echtzeit hilft die Durchschnittsposition den Fans, taktische ÃÂÃÂnderungen im Spielverlauf zu verstehen. xGoals: Durch den Einsatz von Amazon SageMaker, einem vollstÃÂÃÂ¤ndig verwalteten Dienst zur Erstellung, zum Training und zum Einsatz von Machine-Learning-Modellen, kann die Bundesliga nun die Wahrscheinlichkeit einschÃÂÃÂ¤tzen, mit der ein Spieler ein Tor erzielt, wenn er von einer beliebigen Position auf dem Spielfeld schieÃÂÃÂt. Die Torwahrscheinlichkeit wird in Echtzeit fÃÂÃÂ¼r jeden Schuss berechnet, um den Zuschauern einen Einblick in die Schwierigkeit eines Schusses und die Wahrscheinlichkeit eines Tores zu geben. Um die PrÃÂÃÂ¤zision von xGoals zu berechnen, wurden Machine-Learning-Modelle trainiert, indem 40.000 historische TorschÃÂÃÂ¼sse zusÃÂÃÂ¤tzlich zu einer Reihe von Merkmalen analysiert wurden, die aus Positionsdaten abgeleitet wurden, darunter Entfernung zum Tor, Winkel zum Tor, Geschwindigkeit der Spieler, Anzahl der Verteidiger in der Schusslinie und TorhÃÂÃÂ¼terabdeckung. ÃÂÃÂWir in der Bundesliga kÃÂÃÂ¶nnen diese moderne Technologie von AWS, einschlieÃÂÃÂlich Statistik, Analytik und Machine Learning, nutzen, um die Daten zu interpretieren und einen tieferen Einblick und ein besseres VerstÃÂÃÂ¤ndnis fÃÂÃÂ¼r die im Bruchteil einer Sekunde auf dem Spielfeld getroffenen Entscheidungen zu erhaltenÃÂÃÂ, sagte Andreas Heyden, Executive Vice President Digital Innovations der DFL-Gruppe. ÃÂÃÂDer Einsatz von Bundesliga Match Facts ermÃÂÃÂ¶glicht es den Zuschauern, einen tieferen Einblick in die wichtigsten Entscheidungen in jedem Spiel zu gewinnen.ÃÂÃÂ ÃÂÃÂAWS hilft der Bundesliga, das Fernseherlebnis durch tiefere Einblicke in das Spiel zu verbessern, die es vorher nicht gabÃÂÃÂ, sagte Andy Isherwood, Vice President und Managing Director EMEA, AWS. ÃÂÃÂMit AWS ist die Bundesliga in der Lage, Echtzeit-Statistiken zu liefern, um zukÃÂÃÂ¼nftige Spiele und Ergebnisse vorherzusagen. Diese beiden neuen Statistiken sind nur der Anfang dessen, was wir den FuÃÂÃÂballfans liefern kÃÂÃÂ¶nnen, denn wir freuen uns darauf, neue Wege zu erÃÂÃÂ¶ffnen, um die Zuschauer auf der ganzen Welt besser zu informieren, zu begeistern und zu unterhalten.ÃÂÃÂ FuÃÂÃÂballfans kÃÂÃÂ¶nnen alle aktuellen Bundesliga-Aktionen mit Match Facts powered by AWS auf Bundesliga.com und ÃÂÃÂ¼ber die offiziellen KanÃÂÃÂ¤le Facebook, Twitter und Instagram verfolgen. ÃÂÃÂber Amazon Web Services Seit 14 Jahren ist Amazon Web Services die umfassendste und am weitesten verbreitete Cloud-Plattform der Welt. AWS bietet ÃÂÃÂ¼ber 175 voll ausgestattete Dienste fÃÂÃÂ¼r Computing, Speicher, Datenbanken, Networking, Analytik, Robotertechnik, maschinelles Lernen und kÃÂÃÂ¼nstliche Intelligenz (KI), das Internet der Dinge (Internet of Things, IoT), mobile Technologien, Sicherheit, Hybrid, Virtual und Augmented Reality (VR und AR), Medien und Anwendungsentwicklung, Bereitstellung sowie Management aus 76 VerfÃÂÃÂ¼gbarkeitszonen (Availability Zones, AZs) in 24 geografischen Regionen. PlÃÂÃÂ¤ne fÃÂÃÂ¼r weitere neun VerfÃÂÃÂ¼gbarkeitszonen und drei weitere AWS-Regionen in Indonesien, Japan und Spanien wurden angekÃÂÃÂ¼ndigt. Millionen von Kunden ÃÂÃÂ darunter die am schnellsten wachsenden Start-ups, grÃÂÃÂ¶ÃÂÃÂten Unternehmen und fÃÂÃÂ¼hrenden RegierungsbehÃÂÃÂ¶rden ÃÂÃÂ vertrauen AWS, um ihre Infrastruktur mit Strom zu versorgen, agiler zu werden und Kosten zu senken. Mehr Informationen zu AWS erhalten Sie unter aws.amazon.com. ÃÂÃÂber Amazon Amazon orientiert sich an vier GrundsÃÂÃÂ¤tzen: Orientierung am Kunden statt an der Konkurrenz, Leidenschaft fÃÂÃÂ¼r Neuerungen, Einsatz fÃÂÃÂ¼r betriebliche Optimierung sowie langfristiges Denken. Kundenrezensionen, 1-Klick-EinkÃÂÃÂ¤ufe, persÃÂÃÂ¶nliche Empfehlungen, Prime, Versand durch Amazon, AWS, Kindle Direct Publishing, Kindle, Fire-Tablets, Fire TV, Amazon Echo und Alexa sind nur einige der von Amazon angebotenen Produkte und Dienstleistungen. FÃÂÃÂ¼r weitere Informationen besuchen Sie amazon.com/about und folgen Sie @AmazonNews. ÃÂÃÂber die Bundesliga Die Bundesliga ist die hÃÂÃÂ¶chste professionelle VerbandsfuÃÂÃÂballliga in Deutschland. Die Liga wurde 1963 gegrÃÂÃÂ¼ndet und besteht aus 18 Mannschaften, die zusammen mit der 2. Bundesliga nach einem Abstiegs- bzw. Aufstiegssystem organisiert sind. Die Spiele der Bundesliga, die der DFL (Deutsche FuÃÂÃÂball Liga) angehÃÂÃÂ¶rt, werden in ÃÂÃÂ¼ber 200 LÃÂÃÂ¤ndern im Fernsehen ÃÂÃÂ¼bertragen. Die Ausgangssprache, in der der Originaltext verÃÂÃÂ¶ffentlicht wird, ist die offizielle und autorisierte Version. ÃÂÃÂbersetzungen werden zur besseren VerstÃÂÃÂ¤ndigung mitgeliefert. Nur die Sprachversion, die im Original verÃÂÃÂ¶ffentlicht wurde, ist rechtsgÃÂÃÂ¼ltig. Gleichen Sie deshalb ÃÂÃÂbersetzungen mit der originalen Sprachversion der VerÃÂÃÂ¶ffentlichung ab.",https://www.businesswire.com/news/home/20200526005846/de/,businesswire.com,5,seattlebusiness wireamazon web service aws ein amazoncomunternehmen nasdaq amzn und die deutsche bundesliga geben heute abend um uhr mez im rahmen de highlightspiels borussia dortmund gegen bayern mnchen im fernsehen ber lndern da debt der ersten beiden bundesliga match fact powered aws die beiden neuen statistiken durchschnittliche positionen und erwartete tore xgoals geben den fan tiefere einblicke die beabsichtigte spielweise einer mannschaft basierend auf echtzeitanalysen von daten die au der verfolgung von spielerpositionen auf dem spielfeld erfasst wurden und der wahrscheinlichkeit mit der ein spieler ein tor erzielt die hchste deutsche fuballbundesliga wird da unbertroffene angebot von aws clouddiensten einschlielich maschinellen lernens und analysen dazu einsetzen im jahr und den kommenden spielzeiten zustzliche erweiterte statistiken einzufhren aws und die bundesliga sind die ersten die diese einzigartige kombination au fortschrittlichen echtzeitstatistiken und spielanalysen fr fuballfans auf der ganzen welt bereitstellen bundesliga match fact werden durch da sammeln von daten au den livespielvideofeeds generiert die zur analyse aws gestreamt und dann den zuschauern weltweit echtzeit al statistiken zur verfgung gestellt werden diese statistiken helfen den zuschauern dabei dinge wie die strategie bei entscheidungen auf dem spielfeld und die wahrscheinlichkeit eines tore fr jeden schuss besser zu verstehen ab dem mai stehen bei zuknftigen bertragungen von bundesligaspielen durchschnittspositionen zur verfgung whrend xgoals bei highlightspielen verfgbar sein wird ein blick auf die beiden neuen bundesliga match fact powered aws durchschnittliche positionen die fan knnen nun die position der spieler einer mannschaft auf dem spielfeld sehen und erhalten einen einblick die beabsichtigte spielweise der mannschaft die durchschnittspositionen bieten auf der grundlage der analyse von daten die bei der verfolgung der durchschnittlichen position eines spielers auf dem spielfeld erfasst wurden neue erkenntnisse die dann echtzeit angezeigt werden diese bundesligaspielbilanz ermglicht e den zuschauern die aktuelle dynamik auf dem spielfeld zu erkennen und taktische vernderungen zu verstehen die neue statistik hilft dabei festzustellen ob eine mannschaft im angriffs oder verteidigungsstil aufgestellt ist die mitte nach oben drckt oder die seiten benutzt durch die anzeige de durchschnittlichen standorts und der durchschnittlichen position jedes spielers echtzeit hilft die durchschnittsposition den fan taktische nderungen im spielverlauf zu verstehen xgoals durch den einsatz von amazon sagemaker einem vollstndig verwalteten dienst zur erstellung zum training und zum einsatz von machinelearningmodellen kann die bundesliga nun die wahrscheinlichkeit einschtzen mit der ein spieler ein tor erzielt wenn er von einer beliebigen position auf dem spielfeld schiet die torwahrscheinlichkeit wird echtzeit fr jeden schuss berechnet um den zuschauern einen einblick die schwierigkeit eines schusses und die wahrscheinlichkeit eines tore zu geben um die przision von xgoals zu berechnen wurden machinelearningmodelle trainiert indem historische torschsse zustzlich zu einer reihe von merkmalen analysiert wurden die au positionsdaten abgeleitet wurden darunter entfernung zum tor winkel zum tor geschwindigkeit der spieler anzahl der verteidiger der schusslinie und torhterabdeckung wir der bundesliga knnen diese moderne technologie von aws einschlielich statistik analytik und machine learning nutzen um die daten zu interpretieren und einen tieferen einblick und ein besseres verstndnis fr die im bruchteil einer sekunde auf dem spielfeld getroffenen entscheidungen zu erhalten sagte andreas heyden executive vice president digital innovation der dflgruppe der einsatz von bundesliga match fact ermglicht e den zuschauern einen tieferen einblick die wichtigsten entscheidungen jedem spiel zu gewinnen aws hilft der bundesliga da fernseherlebnis durch tiefere einblicke da spiel zu verbessern die e vorher nicht gab sagte andy isherwood vice president und managing director emea aws mit aws ist die bundesliga der lage echtzeitstatistiken zu liefern um zuknftige spiele und ergebnisse vorherzusagen diese beiden neuen statistiken sind nur der anfang dessen wir den fuballfans liefern knnen denn wir freuen un darauf neue wege zu erffnen um die zuschauer auf der ganzen welt besser zu informieren zu begeistern und zu unterhalten fuballfans knnen alle aktuellen bundesligaaktionen mit match fact powered aws auf bundesligacom und ber die offiziellen kanle facebook twitter und instagram verfolgen ber amazon web service seit jahren ist amazon web service die umfassendste und weitesten verbreitete cloudplattform der welt aws bietet ber voll ausgestattete dienste fr computing speicher datenbanken networking analytik robotertechnik maschinelles lernen und knstliche intelligenz ki da internet der dinge internet thing iot mobile technologien sicherheit hybrid virtual und augmented reality vr und ar medien und anwendungsentwicklung bereitstellung sowie management au verfgbarkeitszonen availability zone az geografischen regionen plne fr weitere neun verfgbarkeitszonen und drei weitere awsregionen indonesien japan und spanien wurden angekndigt millionen von kunden darunter die schnellsten wachsenden startup grten unternehmen und fhrenden regierungsbehrden vertrauen aws um ihre infrastruktur mit strom zu versorgen agiler zu werden und kosten zu senken mehr informationen zu aws erhalten sie unter awsamazoncom ber amazon amazon orientiert sich vier grundstzen orientierung kunden statt der konkurrenz leidenschaft fr neuerungen einsatz fr betriebliche optimierung sowie langfristiges denken kundenrezensionen klickeinkufe persnliche empfehlungen prime versand durch amazon aws kindle direct publishing kindle firetablets fire tv amazon echo und alexa sind nur einige der von amazon angebotenen produkte und dienstleistungen fr weitere informationen besuchen sie amazoncomabout und folgen sie amazonnews ber die bundesliga die bundesliga ist die hchste professionelle verbandsfuballliga deutschland die liga wurde gegrndet und besteht au mannschaften die zusammen mit der bundesliga nach einem abstiegs bzw aufstiegssystem organisiert sind die spiele der bundesliga die der dfl deutsche fuball liga angehrt werden ber lndern im fernsehen bertragen die ausgangssprache der der originaltext verffentlicht wird ist die offizielle und autorisierte version bersetzungen werden zur besseren verstndigung mitgeliefert nur die sprachversion die im original verffentlicht wurde ist rechtsgltig gleichen sie deshalb bersetzungen mit der originalen sprachversion der verffentlichung ab,-0.9996,-0.4998,0.1725536364,-0.672353636,Negative Impact
27/05/2020,120.2495,120.68,116.50,120.52,120.52,101138000,2.13,76.34428766,1.192,0,9.3404,0.9034837908,0.2283735172,0.05,256.394,9412.360352,11837.53027,6144.299805,4688.740234,2836.803955,31605.2207,15272,110.7059102,96.48179993,113.0251877,100.1622975,119.7173004,125.1584924,114.2761084,58.7385073,2.749789846,3.243001426,-0.493211579,2.707928794,126.2724991,9042582000,41.13073532,50.04695719,27.62000084,Amazon CEO Jeff Bezos rebuffs warehouse safety concerns: 'We've taken this seriously from the beginning',The Amazon CEO pushed back against criticism that the company hasn't done enough to protect workers from the virus.,https://www.cnbc.com/2020/05/27/amazon-ceo-jeff-bezos-rebuffs-warehouse-safety-concerns.html,cnbc.com,9,amazon ceo pushed back criticism company hasnt done enough protect worker virus,-0.5242,-0.47178,0.1347511538,-0.606531154,Negative Impact
28/05/2020,119.2165,121.85,118.91,120.06,120.06,63804000,2.13,76.34428766,1.192,0,9.3404,0.9034837908,0.2283735172,0.05,256.394,9368.990234,11804.91016,6218.799805,4771.390137,2846.221924,32200.58984,15262.7002,111.2991702,96.63584492,113.3008666,100.3602348,119.7882755,125.2070383,114.3695127,55.05479017,2.488185038,3.092038148,-0.60385311,2.800250462,126.0770491,8978778000,36.37759671,42.362444,28.59000015,"Lights, camera, Amazon: Should the tech giant buy SeattleÃÂÃÂs iconic Cinerama movie theater?",Seattleites love coming in out of the rain for a movie.,https://www.geekwire.com/2020/lights-camera-amazon-tech-giant-buy-seattles-iconic-cinerama-movie-theater/,geekwire.com,5,seattleites love coming rain movie,0.6369,0.31845,0.06742058824,0.2510294118,Positive Impact
29/05/2020,120.797,122.12,119.91,122.12,122.12,70198000,2.13,76.34428766,1.192,0,9.3404,0.9034837908,0.2283735172,0.05,256.394,9489.870117,11802.9502,6076.600098,4695.439941,2852.351074,32424.09961,15192.7998,111.9115402,96.7903524,113.6466561,100.5767349,119.7092007,124.930161,114.4882403,58.70361608,2.419478263,2.957526171,-0.538047908,2.850000109,125.8855081,9048976000,57.49296784,45.00043329,27.51000023,"The Value Of Amazon Buying J.C. Penney Could Far Exceed That Of Buying Target, KohlÃÂÃÂs, Or Anyone Else",Amazon buying J.C. Penney could become one the smartest moves Amazon has ever made.,https://www.forbes.com/sites/christopherwalton/2020/05/29/the-value-of-amazon-buying-jc-penney-could-far-exceed-that-of-buying-target-kohls-or-anyone-else/,forbes.com,8,amazon buying jc penney could become one smartest move amazon ever made,0.7506,0.60048,0.21162,0.38886,Positive Impact
01/06/2020,122.4,123.85,122.21,123.55,123.55,58578000,2.13,76.34428766,1.192,0,9.3404,0.9034837908,0.2283735172,0.08,257.797,9552.049805,11900.24023,6166.399902,4762.779785,2915.430908,33303.51953,15236.2002,112.5016502,96.9673724,114.0351011,100.8053446,120.1717007,124.9998795,115.3435218,58.62099235,2.452429219,2.856506781,-0.404077562,2.803571429,125.697798,9107554000,72.16170492,55.34408982,28.22999954,"Amazon Curtails Some Service, Highways Closed, As Protests Impact Freight And Driver Safety","As protests over the death of George Floyd continued around the country on Saturday and into this morning, many turning violent, their impact is now spreading to the freight world.",https://www.benzinga.com/news/20/06/16150798/amazon-curtails-some-service-highways-closed-as-protests-impact-freight-and-driver-safety,benzinga.com,5,protest death george floyd continued around country saturday morning many turning violent impact spreading freight world,-0.8689,-0.43445,0.09933090909,-0.533780909,Negative Impact
02/06/2020,123.35,123.68,122.27,123.62,123.62,50598000,2.13,76.34428766,1.192,0,9.3404,0.9034837908,0.2283735172,0.08,257.797,9608.379883,12046.41016,6220.100098,4858.970215,2921.397949,33825.53125,15394.40039,113.1279703,97.14144489,114.410999,101.032361,120.5627506,125.1613406,115.9641607,68.67436993,2.455761708,2.776357766,-0.320596058,2.67578561,125.513842,9158152000,72.8626178,67.50576352,26.84000015,"Amazon's details on COVID-19 infections aren't good enough, workers and officials say",Calls to release nationwide coronavirus statistics have come from Amazon's workers and 13 state attorneys general.,https://www.cnet.com/news/amazons-details-on-covid-19-infections-arent-good-enough-workers-and-officials-say/,cnet.com,5,call release nationwide coronavirus statistic come amazon worker state attorney general,0.1779,0.08895,0.3254911111,-0.236541111,Negative Impact
03/06/2020,123.4005,124.40,123.06,123.92,123.92,53420000,2.13,76.34428766,1.192,0,9.3404,0.9034837908,0.2283735172,0.08,257.797,9682.910156,12302.19043,6382.399902,5022.379883,2923.371094,34109.53906,15575.09961,113.7035402,97.31290237,114.7839009,101.2600987,120.9642506,125.2355958,116.6929053,68.16147547,2.454278443,2.711941901,-0.257663459,2.521963937,125.3335652,9211572000,75.92733552,73.65055275,25.65999985,"Amazon is sued over warehouses after New York worker brings coronavirus home, cousin dies","Amazon.com Inc has been sued for allegedly fostering the spread of the coronavirus by mandating unsafe working conditions, causing at least one employee to contract COVID-19, bring it home, and see her cousin die.",https://www.reuters.com/article/us-health-coronavirus-amazon-com-lawsuit/amazon-is-sued-over-warehouses-after-new-york-worker-brings-coronavirus-home-cousin-dies-idUSKBN23A3FI,reuters.com,10,amazoncom inc sued allegedly fostering spread coronavirus mandating unsafe working condition causing least one employee contract covid bring home see cousin die,-0.5994,-0.5994,0.01585375,-0.61525375,Negative Impact
04/06/2020,123.8715,125.38,122.50,123.03,123.03,58974000,2.13,76.34428766,1.192,0,9.3404,0.9034837908,0.2283735172,0.08,257.797,9615.80957,12286.98047,6341.399902,5011.97998,2919.250977,33980.69922,15527.90039,114.2240402,97.47402237,115.1072773,101.4767146,121.2376003,125.2863893,117.1888114,61.91741715,2.354150253,2.640383572,-0.286233319,2.591142382,116.5,9152598000,66.82015238,71.87003523,25.80999947,The Wall Street Journal: Elon Musk lashes out at Amazon for rejecting book questioning COVID-19ÃÂÃÂs risks ÃÂÃÂ which it then reinstates,"Elon Musk on Thursday took aim at Amazon.com Inc. and its founder Jeff Bezos, calling for a breakup of the online retail giant after it had rejected a book questioning the risk of the coronavirus pandemic, a topic the Tesla Inc.",https://www.marketwatch.com/story/elon-musk-lashes-out-at-amazon-for-rejecting-book-questioning-covid-19s-risks-which-it-then-reinstates-2020-06-04,marketwatch.com,8,elon musk thursday took aim amazoncom inc founder jeff bezos calling breakup online retail giant rejected book questioning risk coronavirus pandemic topic tesla inc,-0.7003,-0.56024,0.08016541667,-0.640405417,Negative Impact
05/06/2020,122.2255,124.43,121.86,124.15,124.15,66128000,2.13,76.34428766,1.192,0,9.3404,0.9034837908,0.2283735172,0.08,257.797,9814.080078,12641.44043,6484.299805,5197.790039,2930.799072,34287.23828,15854.09961,114.8212003,97.64442738,115.461894,101.7023195,121.5260754,125.539736,117.5124147,62.10248352,2.338219266,2.579950711,-0.241731444,2.580035073,116.67754,9218726000,78.2809132,73.6761337,24.52000046,Elon Musk tweets 'break up Amazon' after coronavirus ebook temporarily blocked,Amazon reportedly said the self-published ebook was blocked in error. It's now available.,https://www.cnet.com/news/elon-musk-tweets-break-up-amazon-after-coronavirus-ebook-temporarily-blocked/,cnet.com,5,amazon reportedly said selfpublished ebook blocked error available,-0.4767,-0.23835,0.2098693333,-0.448219333,Negative Impact
08/06/2020,125.01,126.50,124.37,126.20,126.20,79414000,2.13,76.34428766,1.192,0,9.3404,0.9034837908,0.2283735172,0.08,257.797,9924.75,12836.59961,6472.600098,5175.52002,2937.770996,34370.57813,15974.90039,115.3897704,97.81955738,115.8831139,101.9461074,121.8872005,126.2232297,117.5511714,64.9504654,2.462863543,2.556533277,-0.093669734,2.572927747,116.8515292,9298140000,97.0300293,80.71036496,25.80999947,"Forget Microsoft, AMD, Intel And Check Out These 5 Stocks Instead","Looks like last week's optimism has spilled over to the strong Monday the markets are already having. With momentum shooting to the upside, here are several top buys today as identified by our AI technology.",https://www.forbes.com/sites/qai/2020/06/08/forget-microsoft-amd-intel-and-check-out-these-5-stocks-instead/,forbes.com,8,look like last week optimism spilled strong monday market already momentum shooting upside several top buy today identified ai technology,0.8779,0.70232,0.1718853333,0.5304346667,Positive Impact
09/06/2020,126.472,131.32,126.25,130.04,130.04,103520000,2.13,76.34428766,1.192,0,9.3404,0.9034837908,0.2283735172,0.08,257.797,9953.75,12619.51953,6335.700195,5095.109863,2956.112061,33956.69141,15833.7002,116.0905304,98.01860737,116.4384035,102.2256784,122.3668507,127.9705275,116.7631738,69.89574372,2.838776988,2.612982019,0.2257949687,2.728749411,117.237468,9401660000,91.37399598,88.89497949,27.56999969,Amazon says 'Black Lives Matter'. But the company has deep ties to policing,"Activists say the companyÃÂÃÂs work, which includes commercial partnerships with law enforcement, harms communities of color",https://www.theguardian.com/technology/2020/jun/09/amazon-black-lives-matter-police-ring-jeff-bezos,theguardian.com,5,activist say company work includes commercial partnership law enforcement harm community color,-0.5423,-0.27115,0.23992125,-0.51107125,Negative Impact
10/06/2020,132.25,136.12,131.31,132.37,132.37,98920000,2.13,76.34428766,1.192,0,9.3404,0.9034837908,0.2283735172,0.08,257.797,10020.34961,12449.21973,6329.100098,5053.419922,2943.75293,34247.05078,15701.2998,116.7740303,98.24306484,117.06327,102.5256468,123.0931004,129.8722537,116.313947,69.7351958,3.286774257,2.747740467,0.5390337906,2.981641497,118.0825101,9500580000,80.90991964,89.77131497,27.56999969,UK regulator gets more time for final ruling on Amazon's Deliveroo deal,Britain's competition regulator has given itself two more months to make a final ruling on Amazon's purchase of a minority stake in online delivery group Deliveroo so it can take full account of representations from all interested parties.,https://www.reuters.com/article/us-deliveroo-m-a-amazon/uk-regulator-gets-more-time-for-final-ruling-on-amazons-deliveroo-deal-idUSKBN23H27P,reuters.com,10,britain competition regulator given two month make final ruling amazon purchase minority stake online delivery group deliveroo take full account representation interested party,0.7269,0.7269,0.1041986364,0.6227013636,Positive Impact
11/06/2020,130.175,133.57,126.81,127.90,127.90,116002000,2.13,76.34428766,1.192,0,9.3404,0.9034837908,0.2283735172,0.08,257.797,9492.730469,11659.16992,6076.700195,4815.600098,2920.896973,33538.37109,15050.90039,117.3822704,98.44033737,117.4881615,102.778108,123.5682003,130.292944,116.8434566,63.33319187,3.243373385,2.846867051,0.3965063349,3.168212891,119.5253087,9384578000,58.10122024,76.79504528,40.79000092,"U.S. EPA orders Amazon, eBay to stop selling unsafe COVID-19 products: Bloomberg","E-commerce companies Amazon Inc and eBay Inc have been instructed by the U.S. Environmental Protection Agency (EPA) to stop selling unproven or unsafe disinfectants, including products falsely marketed as killing COVID-19, on their platforms, Bloomberg reported https://bloom.bg/3fcuLg5 on Thursday.",https://www.reuters.com/article/us-health-coronavirus-usa-epa/u-s-epa-orders-amazon-ebay-to-stop-selling-unsafe-covid-19-products-bloomberg-idUSKBN23I0V7,reuters.com,10,ecommerce company amazon inc ebay inc instructed u environmental protection agency epa stop selling unproven unsafe disinfectant including product falsely marketed killing covid platform bloomberg reported thursday,-0.7096,-0.7096,0.08237785714,-0.791977857,Negative Impact
12/06/2020,130.0605,131.07,125.17,127.25,127.25,108722000,2.13,76.34428766,1.192,0,9.3404,0.9034837908,0.2283735172,0.08,257.797,9588.80957,11867.16992,6105.200195,4839.259766,2919.740967,33780.89063,15256.59961,118.0195903,98.63613487,117.8710178,103.0216194,123.9586254,130.5807302,117.3365206,62.86890425,3.120795544,2.901652749,0.2191427951,3.448248727,120.8526834,9275856000,54.80312713,64.60475567,36.09000015,Amazon Prepares to Bring More Pain to Netflix in This Critical Market,Amazon could gain a significant advantage over Netflix thanks to this smart content acquisition effort.,https://www.fool.com/investing/2020/06/12/amazon-to-bring-more-pain-netflix-in-india.aspx,fool.com,7,amazon could gain significant advantage netflix thanks smart content acquisition effort,0.91,0.637,0.2324373333,0.4045626667,Positive Impact
15/06/2020,126.33,129.20,125.40,128.63,128.63,77302000,2.13,76.34428766,1.192,0,9.3404,0.9034837908,0.2283735172,0.08,257.797,9726.019531,11942.91016,6064.700195,4815.720215,2890.030029,33228.80078,15359.7002,118.6734404,98.83824238,118.2930957,103.276469,124.3658756,131.0905682,117.6411831,67.42375365,3.099519197,2.941226039,0.1582931583,3.548463004,122.0738681,9353158000,61.85297421,58.25244053,34.40000153,Amazon CEO Jeff Bezos is willing to testify before congress: letter,"Amazon Chief Executive Jeff Bezos is willing to testify to a congressional panel investigating potential violations of antitrust law by big tech firms, according to a letter to the committee.",https://www.reuters.com/article/us-amazon-com-congress-bezos/amazon-ceo-jeff-bezos-is-willing-to-testify-before-congress-letter-idUSKBN23M285,reuters.com,10,amazon chief executive jeff bezos willing testify congressional panel investigating potential violation antitrust law big tech firm according letter committee,-0.3612,-0.3612,0.06169238095,-0.422892381,Negative Impact
16/06/2020,131,131.00,128.80,130.76,130.76,71712000,2.13,76.34428766,1.192,0,9.3404,0.9034837908,0.2283735172,0.08,257.797,9895.870117,12161.46973,6242.799805,4952.459961,2931.75,33605.21875,15515.7998,119.3821205,99.0454599,118.7821313,103.5499718,124.8384007,131.9753483,117.701453,72.08140126,3.217402289,2.996461289,0.2209410003,3.389391218,123.1973581,9424870000,68.88300231,61.84636788,33.66999817,Retailers Step Up Same-Day Delivery Game: 7 Stocks in Focus,"As fears of a second wave of coronavirus grip markets, same-day delivery for groceries and other essential items may become a more viable option, at least in the immediate future.",https://www.zacks.com/stock/news/985988/retailers-step-up-same-day-delivery-game-7-stocks-in-focus,zacks.com,8,fear second wave coronavirus grip market sameday delivery grocery essential item may become viable option least immediate future,-0.4939,-0.39512,0.1960474194,-0.591167419,Negative Impact
17/06/2020,132.375,132.75,131.59,132.05,132.05,59186000,2.13,76.34428766,1.192,0,9.3404,0.9034837908,0.2283735172,0.08,257.797,9910.530273,12086.49023,6253.299805,4995.970215,2935.870117,33507.92188,15428.7002,120.0255104,99.26163239,119.3024005,103.8335442,125.3175255,133.0461007,117.5889502,74.96981374,3.37564165,3.072297361,0.3033442887,3.321497781,124.2309689,9484056000,74.89742735,68.54446796,33.47000122,Read the memo Jeff Bezos sent to Amazon employees about Juneteenth,"Bezos urged Amazon employees to cancel all meetings on Juneteenth, a day that commemorates the end of slavery in the U.S.",https://www.cnbc.com/2020/06/17/read-the-memo-jeff-bezos-sent-to-amazon-employees-about-juneteenth.html,cnbc.com,9,bezos urged amazon employee cancel meeting juneteenth day commemorates end slavery u,-0.7269,-0.65421,0.1763554286,-0.830565429,Negative Impact
18/06/2020,132.3505,132.98,131.81,132.70,132.70,49756000,2.13,76.34428766,1.192,0,9.3404,0.9034837908,0.2283735172,0.08,257.797,9943.049805,12072.58984,6224.100098,4958.75,2939.320068,34208.05078,15479.7998,120.6678905,99.47766743,119.8277575,104.1207627,125.7076256,134.1054636,117.3097875,73.40457274,3.513002088,3.160438307,0.3525637818,3.247783661,125.1818908,9533812000,76.02910737,73.26984568,32.93999863,Kohl's says its tie-up with Amazon 'underscores' importance of having stores,"Analysts have doubted Kohl's deal to accept Amazon returns has helped to boost sales at its stores, but the retailer's chief technology officer Paul Gaffney said Thursday that it is working to boost traffic and purchases.",https://www.cnbc.com/2020/06/18/kohls-says-its-tie-up-with-amazon-underscores-importance-of-stores.html,cnbc.com,9,analyst doubted kohl deal accept amazon return helped boost sale store retailer chief technology officer paul gaffney said thursday working boost traffic purchase,0.765,0.6885,0.2057437037,0.4827562963,Positive Impact
19/06/2020,133.904,134.87,132.95,133.75,133.75,115540000,2.13,76.34428766,1.192,0,9.3404,0.9034837908,0.2283735172,0.08,257.797,9946.120117,11980.12012,6292.600098,4979.450195,2967.629883,34731.73047,15474.2002,121.2999005,99.69626495,120.3737476,104.415586,126.2783009,135.2437415,117.3128602,72.94737789,3.664466669,3.261243979,0.40322269,3.279533931,126.0567389,9649352000,83.4023551,78.10962994,35.11999893,Amazon takes heat for chicken and waffles Juneteenth celebration at Chicago warehouse,"Amazon warehouse workers in Chicago expressed outrage at a flyer advertising a chicken and waffles event to commemorate Juneteenth, a celebration of the end of slavery in the U.",https://www.geekwire.com/2020/amazon-takes-heat-chicken-waffles-juneteenth-celebration-chicago-warehouse/,geekwire.com,5,amazon warehouse worker chicago expressed outrage flyer advertising chicken waffle event commemorate juneteenth celebration end slavery u,-0.8126,-0.4063,0.1177630769,-0.524063077,Negative Impact
22/06/2020,134.225,135.75,133.45,135.69,135.69,64176000,2.13,76.34428766,1.192,0,9.3404,0.9034837908,0.2283735172,0.08,257.797,10056.48047,12028.91016,6244.600098,4948.700195,2965.271973,34911.32031,15516.90039,121.9709604,99.91453991,120.9744239,104.7267841,126.9706505,136.6077463,117.3335546,75.0492878,3.896172177,3.388229619,0.5079425582,3.343034472,126.8615992,9713528000,97.00933599,85.48026616,31.77000046,Amazon to Expand in India With Booze Delivery Services,Amazon (AMZN) further expands presence in the e-commerce market of India by securing an approval to deliver alcohol in West Bengal.,https://www.zacks.com/stock/news/990136/amazon-to-expand-in-india-with-booze-delivery-services,zacks.com,8,amazon amzn expands presence ecommerce market india securing approval deliver alcohol west bengal,0.7579,0.60632,0.10316,0.50316,Positive Impact
23/06/2020,136.301,139.16,135.90,138.22,138.22,84634000,2.13,76.34428766,1.192,0,9.3404,0.9034837908,0.2283735172,0.08,257.797,10131.37012,12077.74023,6320.100098,5017.680176,2970.620117,35430.42969,15564.7998,122.5665005,100.1472649,121.6507408,105.0600549,127.8270256,138.2748366,117.3792146,77.16300213,4.235091322,3.557601959,0.6774893625,3.494677952,127.6020707,9798162000,94.59507854,91.66892321,31.37000084,"Amazon kÃÂÃÂ¼ndigt Climate Pledge Fund in HÃÂÃÂ¶he von 2 Milliarden USD fÃÂÃÂ¼r Investitionen in Firmen an, die Produkte, Dienstleistungen und Technologien zur Dekarbonisierung der Wirtschaft und zum Schutz der Erde entwickeln","SEATTLE--(BUSINESS WIRE)--Amazon (NASDAQ:AMZN) hat heute den Climate Pledge Fund zur UnterstÃÂÃÂ¼tzung der Entwicklung nachhaltiger Technologien und Dienstleistungen angekÃÂÃÂ¼ndigt, durch den Amazon und andere Unternehmen im Climate Pledge das Versprechen, bis 2040 kohlenstofffrei zu sein, einhalten kÃÂÃÂ¶nnen. Dieses Risikokapitalprogramm mit einer anfÃÂÃÂ¤nglichen Finanzausstattung in HÃÂÃÂ¶he von 2 Milliarden USD unterstÃÂÃÂ¼tzt weitsichtige Firmen, deren Produkte und Dienstleistungen den ÃÂÃÂbergang zu einer kohlenstofffreien Wirtschaft fÃÂÃÂ¶rdern werden. Im vergangenen Jahr wurde mit dem Climate Pledge von Amazon und Global Optimism gemeinsam das Versprechen abgegeben, das ÃÂÃÂbereinkommen von Paris bereits zehn Jahre frÃÂÃÂ¼her zu erfÃÂÃÂ¼llen und bis 2040 kohlenstofffrei zu sein. Verizon, Reckitt Benckiser (RB) und Infosys haben sich unlÃÂÃÂ¤ngst dem Versprechen angeschlossen und signalisieren dem Markt damit unmissverstÃÂÃÂ¤ndlich, dass die Nachfrage nach Produkten und Dienstleistungen, mit denen eine Senkung von Kohlenstoffemissionen erreicht werden kÃÂÃÂ¶nnen, rasch ansteigen wird. Der neue Climate Pledge Fund von Amazon wird Investitionen in Innovationen fÃÂÃÂ¼r die kohlenstofffreie Wirtschaft der Zukunft beschleunigen. ÃÂÃÂDer Climate Pledge Fund soll in weitsichtige Unternehmer und Erfinder investieren, die Produkte und Dienstleistungen entwickeln, mit denen Firmen ihre CO2-Bilanz verbessern und nachhaltiger wirtschaften kÃÂÃÂ¶nnenÃÂÃÂ, sagte Jeff Bezos, GrÃÂÃÂ¼nder und CEO von Amazon. ÃÂÃÂUnternehmen aus aller Welt in jeder GrÃÂÃÂ¶ÃÂÃÂe und Entwicklungsstufe werden berÃÂÃÂ¼cksichtigt, und zwar vor der Produktion stehende Start-ups bis hin zu etablierten Konzernen. Jede in Aussicht stehende Investition wird anhand ihres Potenzials zur Beschleunigung des Erreichens von Kohlenstofffreiheit und zum Schutz der Erde fÃÂÃÂ¼r zukÃÂÃÂ¼nftige Generationen beurteilt.ÃÂÃÂ Der Climate Pledge Fund wird in Firmen in unterschiedlichen Branchen investieren, darunter Transportwesen und Logistik, Energieerzeugung, -speicherung und -nutzung, Fertigung und Materialwirtschaft, Kreislaufwirtschaft sowie Lebensmittel und Landwirtschaft. Mit der Zeit wird Amazon zudem Gelegenheiten ins Auge fassen, um andere Unterzeichner des Climate Pledge in das Risikokapitalprogramm einzubeziehen. ÃÂÃÂAmazon beweist FÃÂÃÂ¼hrungsqualitÃÂÃÂ¤ten bei der ÃÂÃÂbernahme von kohlenstoffarmen Technologien in grÃÂÃÂ¶ÃÂÃÂerem MaÃÂÃÂstabÃÂÃÂ, sagte R.J. Scaringe, CEO von Rivian. ÃÂÃÂDie Investition in Rivian mit der anschlieÃÂÃÂenden Bestellung von 100.000 elektrischen Lieferfahrzeugen wird die CO2-Bilanz der Paketzustellung durch Amazon erheblich verbessern. Wir freuen uns auf eine Zukunft mit kohlenstofffreien Lieferdiensten.ÃÂÃÂ Amazon verÃÂÃÂ¶ffentlichte heute seinen Nachhaltigkeitsbericht fÃÂÃÂ¼r 2019 sowie eine Aktualisierung der Nachhaltigkeitsziele und -programme des Unternehmens: Amazon gab darin bekannt, dass seine Betriebe bis 2025 zu 100 % mit erneuerbaren Energien laufen werden ÃÂÃÂ fÃÂÃÂ¼nf Jahre frÃÂÃÂ¼her als geplant. Im Rahmen des Climate Pledge hatte sich Amazon dazu verpflichtet, bis 2024 ein Ziel von 80 % und 100 % erneuerbare Energien bis 2030 zu erreichen. Bisher hat Amazon 91 Projekte mit erneuerbaren Energien rund um die Welt angekÃÂÃÂ¼ndigt. Zusammen werden diese Projekte mit einer GesamtkapazitÃÂÃÂ¤t von ÃÂÃÂ¼ber 2.900 MW jÃÂÃÂ¤hrlich mehr als 7,6 Millionen MWh an erneuerbarer Energie liefern ÃÂÃÂ genug, um 680.000 US-Haushalte mit Strom zu versorgen. Amazon tÃÂÃÂ¤tigte zwei Investitionen ÃÂÃÂ¼ber seinen mit 100 Millionen USD ausgestatteten Right Now Climate Fund fÃÂÃÂ¼r naturnahe LÃÂÃÂ¶sungen und Wiederaufforstungsprojekte rund um die Welt. Diese umfassen ein Wiederaufforstungsprojekt in den Appalachen in den USA sowie eine stÃÂÃÂ¤dtische BegrÃÂÃÂ¼nungsinitiative in Berlin. Seit 2015 hat Amazon das Gewicht seiner Pakete um 33 % gesenkt und dadurch mehr als 880.000 Tonnen Verpackungsmaterialien eingespart, was etwa 1,5 Milliarden Versandkartons entspricht. Mehr ÃÂÃÂ¼ber die Nachhaltigkeitsziele und -programme von Amazon erfahren Sie unter https://blog.aboutamazon.com/sustainability/staying-the-course-on-our-commitment-to-sustainability ÃÂÃÂber Amazon Amazon orientiert sich an vier GrundsÃÂÃÂ¤tzen: Orientierung am Kunden statt an der Konkurrenz, Leidenschaft fÃÂÃÂ¼r Neuerungen, Einsatz fÃÂÃÂ¼r betriebliche Optimierung sowie langfristiges Denken. Kundenrezensionen, 1-Klick-EinkÃÂÃÂ¤ufe, persÃÂÃÂ¶nliche Empfehlungen, Prime, Versand durch Amazon, AWS, Kindle Direct Publishing, Kindle, Fire-Tablets, Fire TV, Amazon Echo und Alexa sind nur einige der von Amazon angebotenen Produkte und Dienstleistungen. FÃÂÃÂ¼r weitere Informationen besuchen Sie amazon.com/about und folgen Sie @AmazonNews. Die Ausgangssprache, in der der Originaltext verÃÂÃÂ¶ffentlicht wird, ist die offizielle und autorisierte Version. ÃÂÃÂbersetzungen werden zur besseren VerstÃÂÃÂ¤ndigung mitgeliefert. Nur die Sprachversion, die im Original verÃÂÃÂ¶ffentlicht wurde, ist rechtsgÃÂÃÂ¼ltig. Gleichen Sie deshalb ÃÂÃÂbersetzungen mit der originalen Sprachversion der VerÃÂÃÂ¶ffentlichung ab.",https://www.businesswire.com/news/home/20200623005945/de/,businesswire.com,5,seattlebusiness wireamazon nasdaqamzn hat heute den climate pledge fund zur untersttzung der entwicklung nachhaltiger technologien und dienstleistungen angekndigt durch den amazon und andere unternehmen im climate pledge da versprechen bi kohlenstofffrei zu sein einhalten knnen diesis risikokapitalprogramm mit einer anfnglichen finanzausstattung hhe von milliarden usd untersttzt weitsichtige firmen deren produkte und dienstleistungen den bergang zu einer kohlenstofffreien wirtschaft frdern werden im vergangenen jahr wurde mit dem climate pledge von amazon und global optimism gemeinsam da versprechen abgegeben da bereinkommen von paris bereits zehn jahre frher zu erfllen und bi kohlenstofffrei zu sein verizon reckitt benckiser rb und infosys haben sich unlngst dem versprechen angeschlossen und signalisieren dem markt damit unmissverstndlich das die nachfrage nach produkten und dienstleistungen mit denen eine senkung von kohlenstoffemissionen erreicht werden knnen rasch ansteigen wird der neue climate pledge fund von amazon wird investitionen innovationen fr die kohlenstofffreie wirtschaft der zukunft beschleunigen der climate pledge fund soll weitsichtige unternehmer und erfinder investieren die produkte und dienstleistungen entwickeln mit denen firmen ihre cobilanz verbessern und nachhaltiger wirtschaften knnen sagte jeff bezos grnder und ceo von amazon unternehmen au aller welt jeder gre und entwicklungsstufe werden bercksichtigt und zwar vor der produktion stehende startup bi hin zu etablierten konzernen jede aussicht stehende investition wird anhand ihres potenzials zur beschleunigung de erreichens von kohlenstofffreiheit und zum schutz der erde fr zuknftige generationen beurteilt der climate pledge fund wird firmen unterschiedlichen branchen investieren darunter transportwesen und logistik energieerzeugung speicherung und nutzung fertigung und materialwirtschaft kreislaufwirtschaft sowie lebensmittel und landwirtschaft mit der zeit wird amazon zudem gelegenheiten in auge fassen um andere unterzeichner de climate pledge da risikokapitalprogramm einzubeziehen amazon beweist fhrungsqualitten bei der bernahme von kohlenstoffarmen technologien grerem mastab sagte rj scaringe ceo von rivian die investition rivian mit der anschlieenden bestellung von elektrischen lieferfahrzeugen wird die cobilanz der paketzustellung durch amazon erheblich verbessern wir freuen un auf eine zukunft mit kohlenstofffreien lieferdiensten amazon verffentlichte heute seinen nachhaltigkeitsbericht fr sowie eine aktualisierung der nachhaltigkeitsziele und programme de unternehmens amazon gab darin bekannt das seine betriebe bi zu mit erneuerbaren energien laufen werden fnf jahre frher al geplant im rahmen de climate pledge hatte sich amazon dazu verpflichtet bi ein ziel von und erneuerbare energien bi zu erreichen bisher hat amazon projekte mit erneuerbaren energien rund um die welt angekndigt zusammen werden diese projekte mit einer gesamtkapazitt von ber mw jhrlich mehr al millionen mwh erneuerbarer energie liefern genug um ushaushalte mit strom zu versorgen amazon ttigte zwei investitionen ber seinen mit millionen usd ausgestatteten right climate fund fr naturnahe lsungen und wiederaufforstungsprojekte rund um die welt diese umfassen ein wiederaufforstungsprojekt den appalachen den usa sowie eine stdtische begrnungsinitiative berlin seit hat amazon da gewicht seiner pakete um gesenkt und dadurch mehr al tonnen verpackungsmaterialien eingespart etwa milliarden versandkartons entspricht mehr ber die nachhaltigkeitsziele und programme von amazon erfahren sie unter ber amazon amazon orientiert sich vier grundstzen orientierung kunden statt der konkurrenz leidenschaft fr neuerungen einsatz fr betriebliche optimierung sowie langfristiges denken kundenrezensionen klickeinkufe persnliche empfehlungen prime versand durch amazon aws kindle direct publishing kindle firetablets fire tv amazon echo und alexa sind nur einige der von amazon angebotenen produkte und dienstleistungen fr weitere informationen besuchen sie amazoncomabout und folgen sie amazonnews die ausgangssprache der der originaltext verffentlicht wird ist die offizielle und autorisierte version bersetzungen werden zur besseren verstndigung mitgeliefert nur die sprachversion die im original verffentlicht wurde ist rechtsgltig gleichen sie deshalb bersetzungen mit der originalen sprachversion der verffentlichung ab,-0.9801,-0.49005,0.1907428571,-0.680792857,Negative Impact
24/06/2020,139,139.80,136.05,136.72,136.72,90532000,2.13,76.34428766,1.192,0,9.3404,0.9034837908,0.2283735172,0.08,257.797,9909.169922,11726.54004,6123.700195,4871.359863,2979.551025,34868.98047,15294.40039,123.0175806,100.3730275,122.2416922,105.3750793,128.6370506,139.2106709,118.0634303,75.41397402,4.332664827,3.712614533,0.6200502945,3.557071141,128.7574139,9707630000,82.83500383,91.47980612,33.84000015,AWS und die Formel 1 kÃÂÃÂ¼ndigen neue Rennsport-Performancestatistiken fÃÂÃÂ¼r die Saison 2020 an,"SEATTLE--(BUSINESS WIRE)--Heute stellen Amazon Web Services, Inc. (AWS), ein Unternehmen von Amazon.com (NASDAQ: AMZN), und die Formel 1 (F1) (NASDAQ: FWONA, FWONK) sechs neue Echtzeit-Rennstatistiken vor, die in der Saison 2020 eingefÃÂÃÂ¼hrt werden, beginnend mit der EinfÃÂÃÂ¼hrung der ÃÂÃÂCar Performance ScoresÃÂÃÂ beim SaisonerÃÂÃÂ¶ffnungs-Grand Prix in Spielberg, ÃÂÃÂsterreich, vom 3. bis 5. Juli. Die ÃÂÃÂCar Performance ScoresÃÂÃÂ zeigen die Performance der einzelnen Autos und ermÃÂÃÂ¶glichen es den Rennfans, die Performance mit der von verschiedenen Fahrzeugen zu vergleichen. Die neuen Statistiken, die in dieser Saison vorgestellt werden, nutzen eine Reihe von AWS-Diensten, einschlieÃÂÃÂlich des maschinellen Lernens, um den Fans die MÃÂÃÂ¶glichkeit zu geben, ihre Lieblingsfahrer und -autos zu vergleichen und die Rennergebnisse besser vorherzusagen. Erfahren Sie mehr unter: https://aws.amazon.com/f1/. Mit 300 Sensoren an jedem F1-Rennwagen, die mehr als 1,1 Millionen Datenpunkte pro Sekunde erzeugen und von den Autos an die Box ÃÂÃÂ¼bertragen werden, ist die Formel 1 ein wirklich datengetriebener Sport, bei dem ein GroÃÂÃÂteil des Nervenkitzels darin besteht, spannende Details aus Performancestatistiken zu extrahieren. Die Formel 1 verlÃÂÃÂ¤sst sich auf die Breite und Tiefe der AWS-Dienste, um diese Datenflut in Echtzeit zu streamen, zu verarbeiten und zu analysieren und sie dann in einer sinnvollen Weise fÃÂÃÂ¼r die weltweiten F1-Fernsehzuschauer zu prÃÂÃÂ¤sentieren. Der neue ÃÂÃÂberblick ÃÂÃÂCar Performance ScoresÃÂÃÂ wird als On-Screen-Grafik angezeigt, die den Fans eine vollstÃÂÃÂ¤ndige AufschlÃÂÃÂ¼sselung der Gesamtperformance eines Autos anhand von vier Kernmetriken bietet: Kurvenfahren mit niedriger Geschwindigkeit, Kurvenfahren mit hoher Geschwindigkeit, Geradeausfahren und Fahrzeughandling. Die neue Grafik wird veranschaulichen, wie diese Metriken im Vergleich zwischen den einzelnen Autos aussehen. Rennfans kÃÂÃÂ¶nnen so die relative Leistung eines bestimmten Autos in diesen verschiedenen Bereichen beurteilen und sehen, wo die einzelnen Teams und Fahrer das Feld anfÃÂÃÂ¼hren oder entscheidende Zeit an ihre Rivalen verlieren. F1 und AWS kÃÂÃÂ¼ndigten bereits sechs F1-Einblicke an, darunter Austrittsgeschwindigkeit, vorhergesagte Boxenstopp-Strategie, Boxengassenfenster, Vorhersage des Kampfgeschehens, Kampfgeschehen um die Boxenstrategie und Reifenperformance, und werden von Juli bis Dezember dieser Saison die folgenden sechs zusÃÂÃÂ¤tzlichen ÃÂÃÂF1 Insights powered by AWSÃÂÃÂ-Statistiken als Bildschirmgrafiken herausbringen, die den Fans mehr Einblick in die sekundenschnellen Entscheidungen und Aktionen auf der Strecke sowie hinter der Boxengassenwand bieten, wo die Teamstrategen agieren: Auto-Performance-Scores: ErmÃÂÃÂ¶glicht es Rennfans, die Performance eines einzelnen Autos isoliert mit der Performance verschiedener Fahrzeuge direkt zu vergleichen (DebÃÂÃÂ¼t vom 3. bis 5. Juli bei FORMEL 1 ROLEX GROSSER PREIS VON ÃÂÃÂSTERREICH GRAND PRIX 2020). Ultimativer Vergleich der Fahrergeschwindigkeit: ErmÃÂÃÂ¶glicht es Rennfans, zu sehen, wie ihre Lieblingsfahrer im Vergleich zu anderen Fahrern der bis 1983 zurÃÂÃÂ¼ckreichenden Renngeschichte abschneiden, um den schnellsten Fahrer aller Zeiten zu ermitteln (DebÃÂÃÂ¼t vom 7. bis 9. August bei der EMIRATES FORMEL 1 70th ANNIVERSARY GRAND PRIX 2020). Kurven-Performance bei hohen und niedrigen Geschwindigkeiten: ErmÃÂÃÂ¶glicht es den Fans, zu sehen, wie gut die Fahrer im Vergleich zu anderen Fahrzeugen die schnellsten Kurven auf der Strecke mit mehr als 175 km/h und die langsamen Kurven (unter 125 km/h) meistern, was fÃÂÃÂ¼r die Rundenzeit entscheidend ist (Premiere vom 28. bis 30. August beim FORMEL 1 ROLEX BELGIAN GRAND PRIX). Bewertung der FahrerfÃÂÃÂ¤higkeiten: SchlÃÂÃÂ¼sselt die FÃÂÃÂ¤higkeiten der Fahrer auf und bewertet sie auf der Grundlage der wichtigsten Faktoren fÃÂÃÂ¼r die Gesamt-Performance, um den besten ÃÂÃÂGesamtfahrerÃÂÃÂ auf der Strecke zu ermitteln. Durch die Berechnung verschiedener Teilmengen der Qualifikationsrunden-Performance, der Starts, der Renngeschwindigkeit, des Reifenmanagements und des ÃÂÃÂberhol-/Verteidigungsstils wird diese Erkenntnis zu einer Gesamtwertung der Fahrer fÃÂÃÂ¼hren (DebÃÂÃÂ¼t in der zweiten SaisonhÃÂÃÂ¤lfte). Fahrzeug-/Team-Entwicklung und Gesamt-Performance in der Saison: Im weiteren Verlauf der Saison wird die Gesamtperformance eines Teams von Rennen zu Rennen dargestellt, um die Entwicklungsraten der einzelnen Teams aufzuzeigen (DebÃÂÃÂ¼t in der zweiten SaisonhÃÂÃÂ¤lfte). Vorhersagen fÃÂÃÂ¼r Qualifikation und Renngeschwindigkeit: Erfassen von Daten aus den Trainings- und Qualifikationsrunden, um vor jeder Rennsession vorauszusagen, welches Team fÃÂÃÂ¼r den Erfolg bereit ist. Diese Vorhersagen sorgen fÃÂÃÂ¼r eine erhÃÂÃÂ¶hte Spannung bei der Qualifikation am Samstag und beim Rennen am Sonntag (DebÃÂÃÂ¼t in der zweiten SaisonhÃÂÃÂ¤lfte). Um diese neuen Erkenntnisse zu gewinnen, wird die Formel 1 70 Jahre historischer Renndaten nutzen, die auf dem Amazon Simple Storage Service (Amazon S3) gespeichert sind, kombiniert mit Live-Daten, die von Sensoren an F1-Rennwagen und von der Rennstrecke ÃÂÃÂ¼ber Amazon Kinesis, einen Dienst zur Echtzeit-Datenerfassung, -verarbeitung und -analyse, in die Cloud gestreamt werden. F1-Ingenieure und -Wissenschaftler werden diese Daten nutzen, um mit Amazon SageMaker, dem Service von AWS fÃÂÃÂ¼r die Erstellung, Schulung und Bereitstellung von ML-Modellen, Modelle des maschinellen Lernens (Machine Learning, ML) zu nutzen. F1 ist in der Lage, Renn-Performance-Metriken in Echtzeit zu analysieren, indem es diese ML-Modelle auf AWS Lambda einsetzt, auf dem Code ohne die Notwendigkeit der Bereitstellung oder des Managements von Servern ausgefÃÂÃÂ¼hrt wird. Alle Erkenntnisse werden in die internationale ÃÂÃÂbertragung von F1-Rennen rund um den Globus, einschlieÃÂÃÂlich der digitalen Plattform F1.tv, integriert und helfen den Fans, die sekundenschnellen Entscheidungen und Rennstrategien von Fahrern oder Teamstrategen zu verstehen, die den Ausgang eines Rennens dramatisch beeinflussen kÃÂÃÂ¶nnen. ÃÂÃÂIn den vergangenen zwei Jahren hat die Formel 1 die Dienste von AWS fÃÂÃÂ¼r intensive und dynamische Datenanalysen in Anspruch genommen. Die F1 Insights, die wir gemeinsam bereitstellen, bringen die Fans nÃÂÃÂ¤her an die Rennstrecke als je zuvor und erschlieÃÂÃÂen bisher unbekannte Geschichten und Erkenntnisse hinter der BoxenmauerÃÂÃÂ, sagte Rob Smedley, Chefingenieur der Formel 1. ÃÂÃÂWir freuen uns darauf, diese erfolgreiche Beziehung auszuweiten, um noch mehr Einblicke zum Leben zu erwecken und den Fans die MÃÂÃÂ¶glichkeit zu geben, tiefer in die vielfÃÂÃÂ¤ltigen Wege der Zusammenarbeit zwischen Fahrern und Rennteams einzutauchen, die den Erfolg beeinflussen.ÃÂÃÂ ÃÂÃÂIm Formel-1-Rennsport vermischen sich Physik und menschliche Performance und liefern aussagekrÃÂÃÂ¤ftige, aber komplexe Daten. AWS hilft dabei, diese zu nutzen. Unsere bestehende Beziehung zur Formel 1 hat bereits Statistiken hervorgebracht, die Fans in die Renn-Fahrerlager befÃÂÃÂ¶rdert haben, und unsere Studie ÃÂÃÂ¼ber die Aerodynamik von Rennwagen hat Auswirkungen auf die Fahrzeugkonstruktionen fÃÂÃÂ¼r die Saison 2022ÃÂÃÂ, sagte Mike Clayville, Vice President, Worldwide Commercial Sales bei AWS. ÃÂÃÂDieses Jahr freuen wir uns sehr, die Aussagekraft der F1-Daten in der Cloud zu erweitern und neue Erkenntnisse zu gewinnen, die den Fans helfen, die enorme KomplexitÃÂÃÂ¤t der Formel 1 besser zu verstehen.ÃÂÃÂ Um mehr ÃÂÃÂ¼ber die ersten F1 Insight 2020, Car Performance Scores, zu erfahren, klicken Sie bitte hier. Weitere Informationen ÃÂÃÂ¼ber AWS und sein Engagement in der Formel 1 finden Sie unter: https://aws.amazon.com/f1/. Weitere Nachrichten darÃÂÃÂ¼ber, wie AWS die Formel 1 bei der Entwicklung des Rennwagens der nÃÂÃÂ¤chsten Generation unterstÃÂÃÂ¼tzt, finden Sie unter: https://aws.amazon.com/f1/news/. ÃÂÃÂber Amazon Web Services Seit 14 Jahren ist Amazon Web Services die umfassendste und am weitesten verbreitete Cloud-Plattform der Welt. AWS bietet ÃÂÃÂ¼ber 175 voll ausgestattete Dienste fÃÂÃÂ¼r Computing, Speicher, Datenbanken, Networking, Analytik, Robotertechnik, maschinelles Lernen und kÃÂÃÂ¼nstliche Intelligenz (KI), das Internet der Dinge (Internet of Things, IoT), mobile Technologien, Sicherheit, Hybrid, Virtual und Augmented Reality (VR und AR), Medien und Anwendungsentwicklung, Bereitstellung sowie Management aus 76 VerfÃÂÃÂ¼gbarkeitszonen (Availability Zones, AZs) in 24 geografischen Regionen. PlÃÂÃÂ¤ne fÃÂÃÂ¼r weitere neun VerfÃÂÃÂ¼gbarkeitszonen und drei weitere AWS-Regionen in Indonesien, Japan und Spanien wurden angekÃÂÃÂ¼ndigt. Millionen von Kunden ÃÂÃÂ darunter die am schnellsten wachsenden Start-ups, grÃÂÃÂ¶ÃÂÃÂten Unternehmen und fÃÂÃÂ¼hrenden RegierungsbehÃÂÃÂ¶rden ÃÂÃÂ vertrauen AWS, um ihre Infrastruktur mit Strom zu versorgen, agiler zu werden und Kosten zu senken. Mehr Informationen zu AWS erhalten Sie unter aws.amazon.com. ÃÂÃÂber Amazon Amazon orientiert sich an vier GrundsÃÂÃÂ¤tzen: Orientierung am Kunden statt an der Konkurrenz, Leidenschaft fÃÂÃÂ¼r Neuerungen, Einsatz fÃÂÃÂ¼r betriebliche Optimierung sowie langfristiges Denken. Kundenrezensionen, 1-Klick-EinkÃÂÃÂ¤ufe, persÃÂÃÂ¶nliche Empfehlungen, Prime, Versand durch Amazon, AWS, Kindle Direct Publishing, Kindle, Fire-Tablets, Fire TV, Amazon Echo und Alexa sind nur einige der von Amazon angebotenen Produkte und Dienstleistungen. FÃÂÃÂ¼r weitere Informationen besuchen Sie amazon.com/about und folgen Sie @AmazonNews. ÃÂÃÂber Formula 1ÃÂÃÂ® Formula 1ÃÂÃÂ®, auf Deutsch Formel 1-Rennsport begann 1950 und ist der prestigetrÃÂÃÂ¤chtigste Motorsportwettbewerb der Welt sowie die weltweit beliebteste jÃÂÃÂ¤hrliche Sportserie. Die Formel-1-Weltmeisterschaft 2020 (FIA Formula One World ChampionshipÃÂÃÂ) lÃÂÃÂ¤uft von MÃÂÃÂ¤rz bis November und umfasst 22 Rennen in 22 LÃÂÃÂ¤ndern auf fÃÂÃÂ¼nf Kontinenten. FIA Formula One World ChampionshipÃÂÃÂ Limited gehÃÂÃÂ¶rt zur Formula 1ÃÂÃÂ® und hat die exklusiven kommerziellen Rechte an der FIA Formula One World ChampionshipÃÂÃÂ inne. Formula 1ÃÂÃÂ® ist eine Tochtergesellschaft der Liberty Media Corporation (NASDAQ: LSXMA, LSXMB, LSXMK, BATRA, BATRK, FWONA, FWONK), die der Formula One Group Tracking Stock zugerechnet wird. Das F1-Logo, das F1 FORMULA 1 Logo, FORMULA 1, F1, FIA FORMULA ONE WORLD CHAMPIONSHIP, GRAND PRIX, PADDOCK CLUB und verwandte Markenzeichen sind Markenzeichen von Formula One Licensing BV, einem Unternehmen der Formula 1. Alle Rechte vorbehalten. Die Ausgangssprache, in der der Originaltext verÃÂÃÂ¶ffentlicht wird, ist die offizielle und autorisierte Version. ÃÂÃÂbersetzungen werden zur besseren VerstÃÂÃÂ¤ndigung mitgeliefert. Nur die Sprachversion, die im Original verÃÂÃÂ¶ffentlicht wurde, ist rechtsgÃÂÃÂ¼ltig. Gleichen Sie deshalb ÃÂÃÂbersetzungen mit der originalen Sprachversion der VerÃÂÃÂ¶ffentlichung ab.",https://www.businesswire.com/news/home/20200624005466/de/,businesswire.com,5,seattlebusiness wireheute stellen amazon web service inc aws ein unternehmen von amazoncom nasdaq amzn und die formel f nasdaq fwona fwonk sechs neue echtzeitrennstatistiken vor die der saison eingefhrt werden beginnend mit der einfhrung der car performance score beim saisonerffnungsgrand prix spielberg sterreich vom bi juli die car performance score zeigen die performance der einzelnen auto und ermglichen e den rennfans die performance mit der von verschiedenen fahrzeugen zu vergleichen die neuen statistiken die dieser saison vorgestellt werden nutzen eine reihe von awsdiensten einschlielich de maschinellen lernens um den fan die mglichkeit zu geben ihre lieblingsfahrer und auto zu vergleichen und die rennergebnisse besser vorherzusagen erfahren sie mehr unter mit sensoren jedem frennwagen die mehr al millionen datenpunkte pro sekunde erzeugen und von den auto die box bertragen werden ist die formel ein wirklich datengetriebener sport bei dem ein groteil de nervenkitzels darin besteht spannende detail au performancestatistiken zu extrahieren die formel verlsst sich auf die breite und tiefe der awsdienste um diese datenflut echtzeit zu streamen zu verarbeiten und zu analysieren und sie dann einer sinnvollen weise fr die weltweiten ffernsehzuschauer zu prsentieren der neue berblick car performance score wird al onscreengrafik angezeigt die den fan eine vollstndige aufschlsselung der gesamtperformance eines auto anhand von vier kernmetriken bietet kurvenfahren mit niedriger geschwindigkeit kurvenfahren mit hoher geschwindigkeit geradeausfahren und fahrzeughandling die neue grafik wird veranschaulichen wie diese metriken im vergleich zwischen den einzelnen auto aussehen rennfans knnen die relative leistung eines bestimmten auto diesen verschiedenen bereichen beurteilen und sehen wo die einzelnen team und fahrer da feld anfhren oder entscheidende zeit ihre rivalen verlieren f und aws kndigten bereits sechs feinblicke darunter austrittsgeschwindigkeit vorhergesagte boxenstoppstrategie boxengassenfenster vorhersage de kampfgeschehens kampfgeschehen um die boxenstrategie und reifenperformance und werden von juli bi dezember dieser saison die folgenden sechs zustzlichen f insight powered awsstatistiken al bildschirmgrafiken herausbringen die den fan mehr einblick die sekundenschnellen entscheidungen und aktionen auf der strecke sowie hinter der boxengassenwand bieten wo die teamstrategen agieren autoperformancescores ermglicht e rennfans die performance eines einzelnen auto isoliert mit der performance verschiedener fahrzeuge direkt zu vergleichen debt vom bi juli bei formel rolex grosser preis von sterreich grand prix ultimativer vergleich der fahrergeschwindigkeit ermglicht e rennfans zu sehen wie ihre lieblingsfahrer im vergleich zu anderen fahrern der bi zurckreichenden renngeschichte abschneiden um den schnellsten fahrer aller zeiten zu ermitteln debt vom bi august bei der emirate formel th anniversary grand prix kurvenperformance bei hohen und niedrigen geschwindigkeiten ermglicht e den fan zu sehen wie gut die fahrer im vergleich zu anderen fahrzeugen die schnellsten kurven auf der strecke mit mehr al kmh und die langsamen kurven unter kmh meistern fr die rundenzeit entscheidend ist premiere vom bi august beim formel rolex belgian grand prix bewertung der fahrerfhigkeiten schlsselt die fhigkeiten der fahrer auf und bewertet sie auf der grundlage der wichtigsten faktoren fr die gesamtperformance um den besten gesamtfahrer auf der strecke zu ermitteln durch die berechnung verschiedener teilmengen der qualifikationsrundenperformance der start der renngeschwindigkeit de reifenmanagements und de berholverteidigungsstils wird diese erkenntnis zu einer gesamtwertung der fahrer fhren debt der zweiten saisonhlfte fahrzeugteamentwicklung und gesamtperformance der saison im weiteren verlauf der saison wird die gesamtperformance eines team von rennen zu rennen dargestellt um die entwicklungsraten der einzelnen team aufzuzeigen debt der zweiten saisonhlfte vorhersagen fr qualifikation und renngeschwindigkeit erfassen von daten au den training und qualifikationsrunden um vor jeder rennsession vorauszusagen welches team fr den erfolg bereit ist diese vorhersagen sorgen fr eine erhhte spannung bei der qualifikation samstag und beim rennen sonntag debt der zweiten saisonhlfte um diese neuen erkenntnisse zu gewinnen wird die formel jahre historischer renndaten nutzen die auf dem amazon simple storage service amazon gespeichert sind kombiniert mit livedaten die von sensoren frennwagen und von der rennstrecke ber amazon kinesis einen dienst zur echtzeitdatenerfassung verarbeitung und analyse die cloud gestreamt werden fingenieure und wissenschaftler werden diese daten nutzen um mit amazon sagemaker dem service von aws fr die erstellung schulung und bereitstellung von mlmodellen modelle de maschinellen lernens machine learning ml zu nutzen f ist der lage rennperformancemetriken echtzeit zu analysieren indem e diese mlmodelle auf aws lambda einsetzt auf dem code ohne die notwendigkeit der bereitstellung oder de management von servern ausgefhrt wird alle erkenntnisse werden die internationale bertragung von frennen rund um den globus einschlielich der digitalen plattform ftv integriert und helfen den fan die sekundenschnellen entscheidungen und rennstrategien von fahrern oder teamstrategen zu verstehen die den ausgang eines rennens dramatisch beeinflussen knnen den vergangenen zwei jahren hat die formel die dienste von aws fr intensive und dynamische datenanalysen anspruch genommen die f insight die wir gemeinsam bereitstellen bringen die fan nher die rennstrecke al je zuvor und erschlieen bisher unbekannte geschichten und erkenntnisse hinter der boxenmauer sagte rob smedley chefingenieur der formel wir freuen un darauf diese erfolgreiche beziehung auszuweiten um noch mehr einblicke zum leben zu erwecken und den fan die mglichkeit zu geben tiefer die vielfltigen wege der zusammenarbeit zwischen fahrern und rennteams einzutauchen die den erfolg beeinflussen im formelrennsport vermischen sich physik und menschliche performance und liefern aussagekrftige aber komplexe daten aws hilft dabei diese zu nutzen unsere bestehende beziehung zur formel hat bereits statistiken hervorgebracht die fan die rennfahrerlager befrdert haben und unsere studie ber die aerodynamik von rennwagen hat auswirkungen auf die fahrzeugkonstruktionen fr die saison sagte mike clayville vice president worldwide commercial sale bei aws diesis jahr freuen wir un sehr die aussagekraft der fdaten der cloud zu erweitern und neue erkenntnisse zu gewinnen die den fan helfen die enorme komplexitt der formel besser zu verstehen um mehr ber die ersten f insight car performance score zu erfahren klicken sie bitte hier weitere informationen ber aws und sein engagement der formel finden sie unter weitere nachrichten darber wie aws die formel bei der entwicklung de rennwagens der nchsten generation untersttzt finden sie unter ber amazon web service seit jahren ist amazon web service die umfassendste und weitesten verbreitete cloudplattform der welt aws bietet ber voll ausgestattete dienste fr computing speicher datenbanken networking analytik robotertechnik maschinelles lernen und knstliche intelligenz ki da internet der dinge internet thing iot mobile technologien sicherheit hybrid virtual und augmented reality vr und ar medien und anwendungsentwicklung bereitstellung sowie management au verfgbarkeitszonen availability zone az geografischen regionen plne fr weitere neun verfgbarkeitszonen und drei weitere awsregionen indonesien japan und spanien wurden angekndigt millionen von kunden darunter die schnellsten wachsenden startup grten unternehmen und fhrenden regierungsbehrden vertrauen aws um ihre infrastruktur mit strom zu versorgen agiler zu werden und kosten zu senken mehr informationen zu aws erhalten sie unter awsamazoncom ber amazon amazon orientiert sich vier grundstzen orientierung kunden statt der konkurrenz leidenschaft fr neuerungen einsatz fr betriebliche optimierung sowie langfristiges denken kundenrezensionen klickeinkufe persnliche empfehlungen prime versand durch amazon aws kindle direct publishing kindle firetablets fire tv amazon echo und alexa sind nur einige der von amazon angebotenen produkte und dienstleistungen fr weitere informationen besuchen sie amazoncomabout und folgen sie amazonnews ber formula formula auf deutsch formel rennsport begann und ist der prestigetrchtigste motorsportwettbewerb der welt sowie die weltweit beliebteste jhrliche sportserie die formelweltmeisterschaft fia formula one world championship luft von mrz bi november und umfasst rennen lndern auf fnf kontinenten fia formula one world championship limited gehrt zur formula und hat die exklusiven kommerziellen rechte der fia formula one world championship inne formula ist eine tochtergesellschaft der liberty medium corporation nasdaq lsxma lsxmb lsxmk batra batrk fwona fwonk die der formula one group tracking stock zugerechnet wird da flogo da f formula logo formula f fia formula one world championship grand prix paddock club und verwandte markenzeichen sind markenzeichen von formula one licensing bv einem unternehmen der formula alle rechte vorbehalten die ausgangssprache der der originaltext verffentlicht wird ist die offizielle und autorisierte version bersetzungen werden zur besseren verstndigung mitgeliefert nur die sprachversion die im original verffentlicht wurde ist rechtsgltig gleichen sie deshalb bersetzungen mit der originalen sprachversion der verffentlichung ab,-0.9998,-0.4999,0.1498747368,-0.649774737,Negative Impact
25/06/2020,136.9775,137.81,135.61,137.73,137.73,59374000,2.13,76.34428766,1.192,0,9.3404,0.9034837908,0.2283735172,0.08,257.797,10017,11865.11035,6147.100098,4918.580078,2979.551025,34842.10156,15446.09961,123.4644806,100.606535,122.8490378,105.6970089,129.5207508,140.0283959,119.0131057,75.31223112,4.440226451,3.858136917,0.5820895345,3.530535017,130.0825246,9767004000,86.58071469,88.00359902,32.22000122,Amazon's Covid-19 response has been criticized more than Chinese rivals Alibaba and JD.com,"Amazon has had Covid-19 related deaths, protests, and law suits. Its closest equivalents in China, Alibaba and JD.com, have had none of those.",https://www.cnbc.com/2020/06/25/amazons-covid-19-response-criticized-alibaba-jd.html,cnbc.com,9,amazon covid related death protest law suit closest equivalent china alibaba jdcom none,-0.6369,-0.57321,0.1920045,-0.7652145,Negative Impact
26/06/2020,138.753,139.13,134.40,134.64,134.64,130016000,2.13,76.34428766,1.192,0,9.3404,0.9034837908,0.2283735172,0.08,257.797,9757.219727,11604.42969,6159.299805,4909.640137,2979.551025,35171.26953,15189,123.7491605,100.824005,123.3115655,105.9850336,130.1470005,140.2834981,120.0105029,65.15048432,4.227759937,3.932061521,0.2956984165,3.700428009,131.248622,9636988000,64.75988719,78.05853524,34.72999954,Whole Foods workers sent home for wearing Black Lives Matter masks,A group of Whole Foods employees in a Boston-area store walked out to protest the company's policy that prevented them from wearing Black Lives Matter paraphernalia.,https://www.cnn.com/2020/06/26/business/whole-foods-black-lives-matters-employees-trnd/index.html,cnn.com,5,group whole food employee bostonarea store walked protest company policy prevented wearing black life matter paraphernalia,-0.2023,-0.10115,0.2023203704,-0.30347037,Negative Impact
29/06/2020,134.5005,134.84,131.50,134.02,134.02,84468000,2.13,76.34428766,1.192,0,9.3404,0.9034837908,0.2283735172,0.08,257.797,9874.150391,11777.08008,6225.799805,4945.459961,2961.516113,34961.51953,15389.7002,124.0545404,101.0332125,123.7314647,106.2639785,130.6703503,140.4476196,120.893081,58.06817281,3.963300587,3.938309334,0.02499125292,3.573106493,139.8000031,9552520000,60.49201449,70.61087212,31.78000069,Amazon's video site Twitch bans Trump for 'hateful conduct',"Amazon's video site Twitch, primarily used to stream video games, temporarily banned President Donald Trump from its platform Monday for posting ""hateful content.""",https://www.cnbc.com/2020/06/29/amazons-video-site-twitch-bans-trump-for-hateful-conduct.html,cnbc.com,9,amazon video site twitch primarily used stream video game temporarily banned president donald trump platform monday posting hateful content,-0.6705,-0.60345,0.1314838889,-0.734933889,Negative Impact
30/06/2020,134.2535,138.48,133.75,137.94,137.94,75394000,2.13,76.34428766,1.192,0,9.3404,0.9034837908,0.2283735172,0.08,257.797,10058.76953,11893.78027,6169.700195,4935.990234,2984.674072,34915.80078,15515.2002,124.4197504,101.2630824,124.2887012,106.5791727,131.386375,141.0869909,121.6857592,60.61373078,4.023803135,3.955408094,0.06839504058,3.477072035,139.6340829,9627914000,87.29534374,70.8490818,30.43000031,"Amazon's Twitch, Reddit Ban Trump Related Content And Forums","Amazon IncÃÂÃÂs (NASDAQ: AMZN) Twitch, a live-streaming service, and Reddit, an online discussion platform, have banned channels and forums related to President Donald Trump, citing hate speech.",https://www.benzinga.com/news/20/06/16440808/amazons-twitch-reddit-ban-trump-related-content-and-forums,benzinga.com,5,amazon inc nasdaq amzn twitch livestreaming service reddit online discussion platform banned channel forum related president donald trump citing hate speech,-0.7184,-0.3592,0.2822767857,-0.641476786,Negative Impact
01/07/2020,137.8995,144.75,137.70,143.94,143.93,127268000,2.13,76.34428766,1.192,0,9.3404,0.9034837908,0.2283735172,0.09,259.101,10154.62988,11901.5498,6158,4926.939941,3025.980957,35414.44922,15515.2002,124.9703304,101.5307974,125.0591442,106.9508725,132.387125,142.9370104,121.8372396,78.89338127,4.503504218,4.065027319,0.4384768995,3.497965131,131.5039978,9755182000,95.83810759,81.20848861,28.62000084,5 Warren Buffett Stocks You Can Buy and Hold for the Next Decade,"The legendary investor's best picks for Berkshire Hathaway can help make you rich, too.",https://www.fool.com/investing/2020/07/01/5-warren-buffett-stocks-buy-and-hold-next-decade.aspx,fool.com,7,legendary investor best pick berkshire hathaway help make rich,0.8885,0.62195,0.107515,0.514435,Positive Impact
02/07/2020,145.6005,147.78,143.56,144.52,144.51,131868000,2.13,76.34428766,1.192,0,9.3404,0.9034837908,0.2283735172,0.09,259.101,10207.62988,11991.51953,6240.399902,5049.379883,3090.569092,35843.69922,15622.40039,125.4971404,101.7977349,125.8221189,107.3246449,133.461375,144.3688775,122.5538726,81.17931585,4.874284368,4.226878729,0.6474056391,3.377715519,131.7689178,9887050000,85.41871155,89.51738763,27.68000031,State Department warns top U.S. firms over supply chain risks linked to China's Xinjiang,"The U.S. State Department warned top American companies including Walmart Inc, Apple Inc and Amazon.com Inc over risks faced from maintaining supply chains associated with human rights abuses in China's western Xinjiang province, according to a letter seen by Reuters on Friday.",https://www.reuters.com/article/us-usa-trade-china-xinjiang-companies/state-department-warns-top-u-s-firms-over-supply-chain-risks-linked-to-chinas-xinjiang-idUSKBN2432QA,reuters.com,10,u state department warned top american company including walmart inc apple inc amazoncom inc risk faced maintaining supply chain associated human right abuse china western xinjiang province according letter seen reuters friday,-0.765,-0.765,0.08570666667,-0.850706667,Negative Impact
06/07/2020,146.7485,152.99,146.50,152.85,152.85,137612000,2.13,76.34428766,1.192,0,9.3404,0.9034837908,0.2283735172,0.09,259.101,10433.65039,12160.00977,6285.899902,5081.509766,3332.881104,36487.28125,15669.7002,126.1547304,102.1076299,126.8821144,107.7776534,134.8964752,147.9810523,121.8118981,84.95768694,5.774294513,4.536361885,1.237932627,3.711930411,132.4092811,10024662000,99.41308469,93.55663461,27.94000053,"The four biggest tech companies are each worth more than $1 trillion, a landmark last reached before Covid-19","Alphabet (Google) crossed over $1 trillion in market cap on Monday, joining Apple, Microsoft and Amazon, showing the resilience of the tech sector in the face of a global pandemic, recession, and record unemployment.",https://www.cnbc.com/2020/07/06/maga-tech-stocks-worth-more-than-1-trillion-googl-aapl-amzn-msft.html,cnbc.com,9,alphabet google crossed trillion market cap monday joining apple microsoft amazon showing resilience tech sector face global pandemic recession record unemployment,-0.6124,-0.55116,0.111918,-0.663078,Negative Impact
07/07/2020,152.9275,153.48,149.50,150.01,150.01,105150000,2.13,76.34428766,1.192,0,9.3404,0.9034837908,0.2283735172,0.09,259.101,10343.88965,11990.13965,6189.899902,5043.72998,3345.336914,36674.51953,15595.5,126.7446303,102.4022849,127.7889333,108.1978359,136.0866249,150.136321,122.0369289,77.21284732,6.186594739,4.866408456,1.320186283,3.827037266,133.6443645,9919512000,84.20143675,89.67774433,29.43000031,"Amazon.com Closes Above $3,000 for the First Time","The stock is on fire, and not only because of the company's massive retail operations.",https://www.fool.com/investing/2020/07/07/amazoncom-closes-above-3000-for-the-first-time.aspx,fool.com,7,stock fire company massive retail operation,-0.34,-0.238,0.2105818182,-0.448581818,Negative Impact
08/07/2020,151.1305,154.20,150.62,154.06,154.06,100752000,2.13,76.34428766,1.192,0,9.3404,0.9034837908,0.2283735172,0.09,259.101,10492.5,12086.38965,6156.200195,4981.129883,3403.439941,36329.01172,15629.2002,127.4497401,102.7240224,128.8189946,108.6541311,137.2872498,153.1494606,121.4250389,78.86511979,6.762156475,5.24555806,1.516598415,3.984609331,135.2310148,10020264000,99.36986782,94.32812975,28.07999992,Coronavirus Pushes Online Grocery Sales in June: 4 Stocks to Buy,An increasing number of Americans are relying on online shopping as fears of the deadly coronavirus fail to subside.,https://www.zacks.com/stock/news/999800/coronavirus-pushes-online-grocery-sales-in-june-4-stocks-to-buy,zacks.com,8,increasing number american relying online shopping fear deadly coronavirus fail subside,-0.7506,-0.60048,0.0215947619,-0.622074762,Negative Impact
09/07/2020,155.7995,159.69,153.70,159.13,159.13,127774000,2.13,76.34428766,1.192,0,9.3404,0.9034837908,0.2283735172,0.09,259.101,10547.75,11928.62988,6049.600098,4921.009766,3450.593994,36737.69141,15568.59961,128.3182901,103.0733549,130.0077203,109.1563935,138.6251999,157.0492146,120.2011852,81.06377301,7.540956944,5.704637837,1.836319107,4.328716823,137.1277634,10148038000,98.00461174,93.85863877,29.26000023,"Amazon Agrees To Pay $135,000 In Settlement For Violating U.S. Sanctions",The e-commerce giantÃÂÃÂs screening systems failed to flag blacklisted entities.,https://www.forbes.com/sites/siladityaray/2020/07/09/amazon-agrees-to-pay-135000-in-settlement-for-violating-us-sanctions/,forbes.com,8,ecommerce giant screening system failed flag blacklisted entity,-0.5106,-0.40848,0.2375355,-0.6460155,Negative Impact
10/07/2020,159.588,160.75,156.79,160.00,160.00,109720000,2.13,76.34428766,1.192,0,9.3404,0.9034837908,0.2283735172,0.09,259.101,10617.44043,12075.58008,6095.399902,4970.47998,3383.322021,36594.32813,15713.7998,129.1455801,103.4379524,131.1838882,109.6623,140.2302998,160.244205,120.2163945,80.98197186,8.134473452,6.19060496,1.943868492,4.456752232,139.8357119,10257758000,97.43554693,98.27000883,27.29000092,Amazon begins rolling out bigger UPS and FedEx-style delivery trucks,"Amazon.com is launching a new fleet of bigger, boxier trucks like those favored by rival package carriers United Parcel Service Inc and FedEx Corp, as it fights to fix widespread pandemic-fueled delivery delays that sent customers into the arms of competitors like Walmart Inc.",https://www.reuters.com/article/us-amazon-com-delivery/amazon-begins-rolling-out-bigger-ups-and-fedex-style-delivery-trucks-idUSKBN24B2EJ,reuters.com,10,amazoncom launching new fleet bigger boxier truck like favored rival package carrier united parcel service inc fedex corp fight fix widespread pandemicfueled delivery delay sent customer arm competitor like walmart inc,0.6908,0.6908,0.1225276923,0.5682723077,Positive Impact
13/07/2020,162.553,167.21,153.42,155.20,155.20,154408000,2.13,76.34428766,1.192,0,9.3404,0.9034837908,0.2283735172,0.09,259.101,10390.83984,12014.66992,6176.200195,5056.22998,3443.285889,36693.69141,15639.40039,129.7755801,103.7718699,132.1256964,110.1154114,141.6277496,161.7286278,121.5268715,71.57023449,8.123872484,6.577258464,1.546614019,5.277823312,142.7637122,10103350000,66.35584063,87.2653331,32.18999863,"Coronavirus Wave: Diverts From Retail Shops, Drums Up Online Sales","With a rapid paradigm shift in consumer shopping pattern, U.S. retail sales are expected to take a beating this year.",https://www.zacks.com/stock/news/1002960/coronavirus-wave-diverts-from-retail-shops-drums-up-online-sales,zacks.com,8,rapid paradigm shift consumer shopping pattern u retail sale expected take beating year,-0.4588,-0.36704,0.1589766667,-0.526016667,Negative Impact
14/07/2020,154.45,156.37,147.50,154.20,154.20,144638000,2.13,76.34428766,1.192,0,9.3404,0.9034837908,0.2283735172,0.09,259.101,10488.58008,12014.66992,6179.799805,5007.459961,3414.618896,36033.05859,15908.5,130.57354,104.1079099,132.9913552,110.554064,142.9060493,162.778051,123.0340477,68.28629541,7.943215059,6.850449783,1.092765276,5.663858686,146.6758371,9958712000,63.5555434,75.78231032,29.52000046,"In Rivian, Amazon May Have 'Bespoke Automobile' At Its Service","Rivian's recent $2.5 billion fundraise accelerates Amazon.com Inc (NASDAQ: AMZN) path to zero-emissions logistics domination, analysts said, while simultaneously opening up a new front in the battle to bring electric vehicles to market.",https://www.benzinga.com/markets/20/07/16617602/in-rivian-amazon-may-have-bespoke-automobile-at-its-service,benzinga.com,5,rivians recent billion fundraise accelerates amazoncom inc nasdaq amzn path zeroemissions logistics domination analyst said simultaneously opening new front battle bring electric vehicle market,-0.4215,-0.21075,0.2740014286,-0.484751429,Negative Impact
15/07/2020,154.0115,154.92,148.66,150.44,150.44,115778000,2.13,76.34428766,1.192,0,9.3404,0.9034837908,0.2283735172,0.09,259.101,10550.49023,12391.32031,6292.700195,5108.97998,3361.303955,36051.80859,16063.2998,131.26642,104.4287649,133.6757529,110.9509738,143.890049,163.1706077,124.6094903,64.93355158,7.411489536,6.962657734,0.4488318018,5.843037197,167.2144928,9842934000,53.0362262,60.98253674,27.76000023,"Lawsuits allege Microsoft, Amazon and Google violated Illinois facial recognition privacy law","In a set of new lawsuits, two Illinois residents argue that three tech giants violated state laws prohibiting the use of personal biometric data without permission. Illinois residents Steven Vance and Tim Janecyk allege that images of their faces appeared in IBMÃÂÃÂs ÃÂÃÂDiversity in FacesÃÂÃÂ database without their consent and were used to train facial [ÃÂÃÂ]",https://techcrunch.com/2020/07/15/facial-recognition-lawsuit-vance-janecyk-bipa/,techcrunch.com,5,set new lawsuit two illinois resident argue three tech giant violated state law prohibiting use personal biometric data without permission illinois resident steven vance tim janecyk allege image face appeared ibms diversity face database without consent used train facial,-0.8109,-0.40545,0.1732916,-0.5787416,Negative Impact
16/07/2020,148.553,151.60,145.91,150.00,149.99,127884000,2.13,76.34428766,1.192,0,9.3404,0.9034837908,0.2283735172,0.09,259.101,10473.83008,12350.11035,6250.700195,5085.279785,3210.099121,36471.67969,16024.5,131.9485199,104.7447624,134.3157232,111.3394715,144.7873489,163.4066463,126.1680515,63.51236321,6.874656141,6.945057415,-0.070401274,6.091894967,166.8433829,9715050000,51.78028845,56.12401935,28,"EU regulators to probe Alexa, Siri and other voice assistants",EU competition regulators are seeking information from 400 companies to establish if there are problems in the market for voice assistants such as Alexa and Siri and other internet-connected devices that could lead to antitrust cases.,https://www.reuters.com/article/us-eu-antitrust-tech/eu-regulators-to-probe-alexa-siri-and-other-voice-assistants-idUSKCN24H1VP,reuters.com,10,eu competition regulator seeking information company establish problem market voice assistant alexa siri internetconnected device could lead antitrust case,-0.4019,-0.4019,0.1850938889,-0.586993889,Negative Impact
17/07/2020,150.45,151.20,147.42,148.10,148.10,95226000,2.13,76.34428766,1.192,0,9.3404,0.9034837908,0.2283735172,0.09,259.101,10503.19043,12402.74023,6290.299805,5069.419922,3214.128906,37020.14063,16123.5,132.5592297,105.0513424,134.8562241,111.7052329,145.5573235,163.3260129,127.788634,65.22092765,6.224428796,6.800931692,-0.576502895,6.023966108,166.0061075,9619824000,46.46952579,50.42868014,25.68000031,Amazon stock had its worst week since February,"Amazon posted its fifth straight day of losses Friday, making it the worst week for the stock since February and snapping its longest weekly winning streak in history.",https://www.cnbc.com/2020/07/17/amazon-stock-had-its-worst-week-since-february.html,cnbc.com,9,amazon posted fifth straight day loss friday making worst week stock since february snapping longest weekly winning streak history,-0.1027,-0.09243,0.317778,-0.410208,Negative Impact
20/07/2020,150.01,160.07,149.70,159.84,159.84,151964000,2.13,76.34428766,1.192,0,9.3404,0.9034837908,0.2283735172,0.09,259.101,10767.08984,12392.98047,6261.5,5093.180176,3314.148926,37418.98828,16183.7002,133.3884596,105.4222448,135.8360582,112.1842057,146.861898,164.8110226,128.9127735,73.34049224,6.580861156,6.756917584,-0.176056428,6.640644618,165.2023232,9771788000,77.9682093,58.73934118,24.45999908,Whole Foods disciplines workers wearing Black Lives Matter face masks: lawsuit,"Whole Foods Market Inc was sued on Monday by employees who accused the upscale grocery retailer of disciplining and retaliating against workers who wear ""Black Lives Matter"" face masks on the job, including one who said she was fired.",https://www.reuters.com/article/us-amazon-com-whole-foods-race-lawsuit/whole-foods-disciplines-workers-wearing-black-lives-matter-face-masks-lawsuit-idUSKCN24L1UM,reuters.com,10,whole food market inc sued monday employee accused upscale grocery retailer disciplining retaliating worker wear black life matter face mask job including one said fired,-0.6908,-0.6908,0.03587066667,-0.726670667,Negative Impact
21/07/2020,161.6245,162.03,155.29,156.91,156.91,122426000,2.13,76.34428766,1.192,0,9.3404,0.9034837908,0.2283735172,0.09,259.101,10680.36035,12508.67969,6269.700195,5104.279785,3320.89502,37930.32813,16163,134.1471397,105.7757124,136.662664,112.6292833,147.9230736,165.5988467,130.2473005,67.46344111,6.551589725,6.715852013,-0.164262287,6.784430368,164.4306902,9649362000,65.10193552,63.1798902,24.84000015,Amazon Stock Will Move Higher as Free Cash Flow Grows,"A rise in e-commerce has already made Amazon a star in 2020, but free cash flow growth will boost AMZN stock even higher. 
The post Amazon Stock Will Move Higher as Free Cash Flow Grows appeared first on InvestorPlace.",https://investorplace.com/2020/07/amzn-stock-poised-further-heights-as-cash-flow-surges/,investorplace.com,6,rise ecommerce already made amazon star free cash flow growth boost amzn stock even higher post amazon stock move higher free cash flow grows appeared first investorplace,0.9231,0.55386,0.1705812,0.3832788,Positive Impact
22/07/2020,156.25,157.50,153.26,155.00,155.00,82084000,2.13,76.34428766,1.192,0,9.3404,0.9034837908,0.2283735172,0.09,259.101,10706.12988,12569.07031,6207.100098,5037.120117,3333.164063,37871.51953,16171.09961,134.8380498,106.1157774,137.3815987,113.0508377,148.7618233,166.0875928,131.4360538,61.0057979,6.300911149,6.63286384,-0.331952691,6.583501543,163.6899226,9567278000,48.35480852,63.80831778,24.31999969,Whole Foods workers sue over alleged Black Lives Matter mask ban,"More than a dozen workers sued Whole Foods after the grocery giant allegedly punished some of them for wearing ÃÂÃÂBlack Lives MatterÃÂÃÂ face masks on the job. The 14 workers in four states say staffers were sent home without pay, formally disciplined or even fired for donning the masks in solidarity with the nationwide movement.",https://nypost.com/2020/07/22/whole-foods-workers-sue-over-alleged-black-lives-matter-mask-ban/,nypost.com,5,dozen worker sued whole food grocery giant allegedly punished wearing black life matter face mask job worker four state say staffer sent home without pay formally disciplined even fired donning mask solidarity nationwide movement,-0.6129,-0.30645,0.16653,-0.47298,Negative Impact
23/07/2020,154.9135,154.91,148.50,149.33,149.33,113138000,2.13,76.34428766,1.192,0,9.3404,0.9034837908,0.2283735172,0.09,259.101,10461.41992,12510.87012,6211.399902,5033.759766,3325.110107,38140.46875,16018.7002,135.4676497,106.4292498,137.8500654,113.4117995,149.3921982,165.7644014,133.019995,54.34839436,5.580557211,6.422402514,-0.841845303,6.745822362,162.9787856,9454140000,16.0353066,43.16401688,26.07999992,Big Tech CEOs ready defenses for U.S. Congress hearing into their growing power,The chief executives of four of the largest U.S. tech companies plan to deflect criticism next week in a Congressional hearing into their use of market power to hurt rivals by saying they themselves face competition and by debunking claims they are so dominant.,https://www.reuters.com/article/us-usa-tech-congress/big-tech-ceos-ready-defenses-for-u-s-congress-hearing-into-their-growing-power-idUSKCN24O16K,reuters.com,10,chief executive four largest u tech company plan deflect criticism next week congressional hearing use market power hurt rival saying face competition debunking claim dominant,-0.743,-0.743,0.1466733333,-0.889673333,Negative Impact
24/07/2020,146.5,151.58,144.40,150.45,150.45,112648000,2.13,76.34428766,1.192,0,9.3404,0.9034837908,0.2283735172,0.09,259.101,10363.17969,12461.78027,6123.799805,4956.430176,3196.768066,38128.89844,15997.09961,136.1086395,106.7550998,138.3440038,113.780294,150.0280228,165.4534072,134.6026383,47.49934119,5.041766134,6.146275238,-1.104509104,6.652965001,162.2960942,9566788000,26.49850753,30.29620755,25.84000015,Calls to Break Up Amazon Could Hit a Fever Pitch Next Week,"Ahead of Bezos' testimony on Capitol Hill, a new report details further alleged antitrust abuses by the tech giant.",https://www.fool.com/investing/2020/07/24/calls-to-break-up-amazon-could-hit-a-fever-pitch-n.aspx,fool.com,7,ahead bezos testimony capitol hill new report detail alleged antitrust abuse tech giant,-0.6369,-0.44583,0.11022,-0.55605,Negative Impact
27/07/2020,153.1,154.90,150.79,152.76,152.76,83410000,2.13,76.34428766,1.192,0,9.3404,0.9034837908,0.2283735172,0.09,259.101,10536.26953,12553.12988,6104.899902,4939.620117,3205.227051,37934.73047,16161.2998,136.7749995,107.0884048,138.9093565,114.1681567,150.933873,164.5805283,137.2872177,52.89420447,4.746852908,5.866390772,-1.119537864,6.687036787,161.2223281,9650198000,36.64557432,26.39312948,24.73999977,Amazon (AMZN) to Report Q2 Earnings: What's in the Offing?,"Amazon's (AMZN) second-quarter results are likely to reflect robust retail strategies, prime momentum and strength in the cloud services offerings amid the coronavirus pandemic.",https://www.zacks.com/stock/news/1016672/amazon-amzn-to-report-q2-earnings-whats-in-the-offing,zacks.com,8,amazon amzn secondquarter result likely reflect robust retail strategy prime momentum strength cloud service offering amid coronavirus pandemic,0.743,0.5944,0.198438,0.395962,Positive Impact
28/07/2020,152.7135,153.85,149.79,150.02,150.02,62534000,2.13,76.34428766,1.192,0,9.3404,0.9034837908,0.2283735172,0.09,259.101,10402.08984,12491.21973,6129.299805,4928.939941,3227.959961,38492.94922,16121.2998,137.3655495,107.4084223,139.3449306,114.5248566,151.7337479,162.8459106,140.6215851,45.63643725,4.242805498,5.541673717,-1.298868219,6.678037371,160.2129881,9587664000,24.6181206,29.25406748,25.44000053,AWS Announces General Availability of Amazon Fraud Detector,"SEATTLE--(BUSINESS WIRE)--Today, Amazon Web Services Inc. (AWS), an Amazon.com company (NASDAQ: AMZN), announced the general availability of Amazon Fraud Detector, a fully managed service that makes it easy to quickly identify potentially fraudulent online activities like online payment and identity fraud. Using machine learning under the hood and based on over 20 years of fraud detection expertise from Amazon, Amazon Fraud Detector automatically identifies potentially fraudulent activity in millisecondsÃÂÃÂwith no machine learning expertise required. With just a few clicks in the Amazon Fraud Detector console, customers can select a pre-built machine learning model template, upload historical event data, and create decision logic to assign outcomes to the predictions (e.g. initiate a fraud investigation when the machine learning model predicts potentially fraudulent activity). There are no up-front payments, long-term commitments, or infrastructure to manage with Amazon Fraud Detector, and customers pay only for their actual usage of the service. To get started with Amazon Fraud Detector, visit http://aws.amazon.com/fraud-detector Today, tens of billions of dollars are lost to online fraud every year by organizations around the world. As a result, many businesses invest in large, expensive fraud management systems. These systems are often based on hand-coded rules that are time-consuming to set up, expensive to customize, and difficult to keep up-to-date as fraud patterns changeÃÂÃÂall of which leads to lower accuracy. This leads organizations to reject good customers as fraudsters, conduct more costly fraud reviews, and miss opportunities to drive down fraud rates. Amazon has made significant investments over the past 20 years to combat fraudulent activity using sophisticated machine learning techniques that minimize customer friction while staying one step ahead of bad actors, and customers have asked Amazon to share this expertise and experience to help them combat online fraud. Amazon Fraud Detector provides a fully managed service that uses machine learning for detecting potential fraud in real time (e.g. online payment and identity fraud, the creation of fake accounts, loyalty account and promotion code abuse, etc.), based on the same technology used by Amazon.comÃÂÃÂwith no machine learning experience required. With Amazon Fraud Detector, customers use their historical data of both fraudulent and legitimate transactions to build, train, and deploy machine learning models that provide real-time, low-latency fraud risk predictions. To get started, customers upload historical event data (e.g. transactions, account registrations, loyalty points redemptions, etc.) to Amazon Simple Storage Service (Amazon S3), where it is encrypted in transit and at rest and used to customize the modelÃÂÃÂs training. Customers only need to provide any two attributes associated with an event (e.g. logins, new account creation, etc.) and can optionally add other data (e.g. billing address or phone number). Based upon the type of fraud customers want to predict, Amazon Fraud Detector will pre-process the data, select an algorithm, and train a model. Amazon Fraud Detector uses machine learning models based on AmazonÃÂÃÂs 20+ years of experience with fraud to help identify patterns commonly associated with fraudulent activity. This improves the accuracy of the trained model even if the number of fraudulent examples provided by a customer to Amazon Fraud Detector is low. Amazon Fraud Detector trains and deploys a model to a fully managed, private Application Programming Interface (API) end point. Customers can send new activity (e.g. signups or new purchases) to the API and receive a fraud risk response, which includes a precise fraud risk score. Based on the report, a customerÃÂÃÂs application can determine the right course of action (e.g. accept a purchase, or pass it to a human for review). With Amazon Fraud Detector, customers can detect fraud more quickly, easily, and accurately with machine learning while also preventing fraud from happening in the first place. ÃÂÃÂCustomers of all sizes and across all industries have told us they spend a lot of time and effort trying to decrease the amount of fraud occurring on their websites and applications,ÃÂÃÂ said Swami Sivasubramanian, Vice President, Amazon Machine Learning, Amazon Web Services Inc. ÃÂÃÂBy leveraging 20 years of experience detecting fraud coupled with powerful machine learning technology, weÃÂÃÂre excited to bring customers Amazon Fraud Detector so they can automatically detect potential fraud, save time and money, and improve customer experiencesÃÂÃÂwith no machine learning experience required.ÃÂÃÂ Developers with machine learning experience who want to extend what Amazon Fraud Detector delivers can customize Amazon Fraud Detector using a combination of machine learning models built with Amazon Fraud Detector and those built with Amazon SageMaker (a fully managed service for building, training, and deploying machine learning models quickly). Amazon Fraud Detector is available today in US East (N. Virginia), US East (Ohio), US West (Oregon), EU (Ireland), Asia Pacific (Singapore), and Asia Pacific (Sydney), with availability in additional regions in the coming months. GoDaddy is the worldÃÂÃÂs largest services platform for entrepreneurs around the globe and is on a mission to empower their worldwide community of 19+ million customers by giving them all the help and tools they need to grow online. ÃÂÃÂGoDaddy is committed to preventing fraudulent accounts, and weÃÂÃÂre continually bolstering our capabilities to automatically detect such accounts during sign-up,ÃÂÃÂ said John Kercheval, Senior Director, Identity Services Group at GoDaddy. ÃÂÃÂWe recently began using Amazon Fraud Detector, and weÃÂÃÂre pleased that it offers low cost of implementation and a self-service approach to building a machine learning model that is customized to our business. The model can be easily deployed and used in our new account process without impacting the signup experience for legitimate customers. The model we built with Amazon Fraud Detector is able to detect likely fraudulent sign-ups immediately, so weÃÂÃÂre very pleased with the results and look forward to accomplishing more.ÃÂÃÂ Truevo makes simple, intuitive and user-friendly payment products that allow their clients to receive payments effortlessly, so they can focus on growing their businesses. ÃÂÃÂAmazon Fraud Detector has enabled us to drastically improve operations, increase our flexibility to respond to bad actors, and have greater control of systems and processes. Initially, we were exploring an in-house and third-party solution. When Amazon Fraud Detector was announced, we immediately changed course. We have been an AWS customer for many years and have great trust in AmazonÃÂÃÂs products,ÃÂÃÂ said Charles Grech, COO at Truevo. ÃÂÃÂWith Amazon Fraud Detector, we are no longer bound by the conventional limitations of on-premises or SaaS offerings. Instead, we have the flexibility to adapt a machine learning-powered service to meet our needs and the ability to use AWSÃÂÃÂs rules-only option while easily scaling to full machine learning capabilities when needed. This saved Truevo 3-6 months in development! In fact, we deployed our first prototype model within 30 minutes. Overall, we are operating with greater confidence in our ability to detect fraud in real-time. We are better equipped to deploy rule detections when we notice odd activity that we may not fully understand, but need to stop. We are able to respond and adapt to ever-changing regulatory and scheme requirements allowing us to stay on top of our game.ÃÂÃÂ ActiveCampaign provides category defining Customer Experience Automation software to 100k small and growing businesses around the globe. ÃÂÃÂIn Q1/Q2 2020 we experienced a spike in accounts being used for phishing attacks. As a result, we needed to supplement our existing homegrown solution with stronger transaction data and signals to identify bad actors sooner. A scalable solution based on predictive machine learning was important to us as a growing business ourselves,ÃÂÃÂ said Alex Burch, Senior Email Operations Engineer at ActiveCampaign. ÃÂÃÂAmazon Fraud Detector made it easy to build a model using our own data that accurately identifies account signups that result in phishing attacks. More importantly, we were able to get these results with a very low false positive rate, which means no additional work for our operations staff. Amazon Fraud Detector has a competitive pricing model, and we can easily integrate the model into our existing workflow.ÃÂÃÂ About Amazon Web Services For 14 years, Amazon Web Services has been the worldÃÂÃÂs most comprehensive and broadly adopted cloud platform. AWS offers over 175 fully featured services for compute, storage, databases, networking, analytics, robotics, machine learning and artificial intelligence (AI), Internet of Things (IoT), mobile, security, hybrid, virtual and augmented reality (VR and AR), media, and application development, deployment, and management from 77 Availability Zones (AZs) within 24 geographic regions, with announced plans for nine more Availability Zones and three more AWS Regions in Indonesia, Japan, and Spain. Millions of customersÃÂÃÂincluding the fastest-growing startups, largest enterprises, and leading government agenciesÃÂÃÂtrust AWS to power their infrastructure, become more agile, and lower costs. To learn more about AWS, visit aws.amazon.com. About Amazon Amazon is guided by four principles: customer obsession rather than competitor focus, passion for invention, commitment to operational excellence, and long-term thinking. Customer reviews, 1-Click shopping, personalized recommendations, Prime, Fulfillment by Amazon, AWS, Kindle Direct Publishing, Kindle, Fire tablets, Fire TV, Amazon Echo, and Alexa are some of the products and services pioneered by Amazon. For more information, visit amazon.com/about and follow @AmazonNews.",https://www.businesswire.com/news/home/20200728005790/en/AWS-Announces-General-Availability-of-Amazon-Fraud-Detector,businesswire.com,5,seattlebusiness wiretoday amazon web service inc aws amazoncom company nasdaq amzn announced general availability amazon fraud detector fully managed service make easy quickly identify potentially fraudulent online activity like online payment identity fraud using machine learning hood based year fraud detection expertise amazon amazon fraud detector automatically identifies potentially fraudulent activity millisecondswith machine learning expertise required click amazon fraud detector console customer select prebuilt machine learning model template upload historical event data create decision logic assign outcome prediction eg initiate fraud investigation machine learning model predicts potentially fraudulent activity upfront payment longterm commitment infrastructure manage amazon fraud detector customer pay actual usage service get started amazon fraud detector visit today ten billion dollar lost online fraud every year organization around world result many business invest large expensive fraud management system system often based handcoded rule timeconsuming set expensive customize difficult keep uptodate fraud pattern changeall lead lower accuracy lead organization reject good customer fraudsters conduct costly fraud review miss opportunity drive fraud rate amazon made significant investment past year combat fraudulent activity using sophisticated machine learning technique minimize customer friction staying one step ahead bad actor customer asked amazon share expertise experience help combat online fraud amazon fraud detector provides fully managed service us machine learning detecting potential fraud real time eg online payment identity fraud creation fake account loyalty account promotion code abuse etc based technology used amazoncomwith machine learning experience required amazon fraud detector customer use historical data fraudulent legitimate transaction build train deploy machine learning model provide realtime lowlatency fraud risk prediction get started customer upload historical event data eg transaction account registration loyalty point redemption etc amazon simple storage service amazon encrypted transit rest used customize model training customer need provide two attribute associated event eg logins new account creation etc optionally add data eg billing address phone number based upon type fraud customer want predict amazon fraud detector preprocess data select algorithm train model amazon fraud detector us machine learning model based amazon year experience fraud help identify pattern commonly associated fraudulent activity improves accuracy trained model even number fraudulent example provided customer amazon fraud detector low amazon fraud detector train deploys model fully managed private application programming interface api end point customer send new activity eg signups new purchase api receive fraud risk response includes precise fraud risk score based report customer application determine right course action eg accept purchase pas human review amazon fraud detector customer detect fraud quickly easily accurately machine learning also preventing fraud happening first place customer size across industry told u spend lot time effort trying decrease amount fraud occurring website application said swami sivasubramanian vice president amazon machine learning amazon web service inc leveraging year experience detecting fraud coupled powerful machine learning technology excited bring customer amazon fraud detector automatically detect potential fraud save time money improve customer experienceswith machine learning experience required developer machine learning experience want extend amazon fraud detector delivers customize amazon fraud detector using combination machine learning model built amazon fraud detector built amazon sagemaker fully managed service building training deploying machine learning model quickly amazon fraud detector available today u east n virginia u east ohio u west oregon eu ireland asia pacific singapore asia pacific sydney availability additional region coming month godaddy world largest service platform entrepreneur around globe mission empower worldwide community million customer giving help tool need grow online godaddy committed preventing fraudulent account continually bolstering capability automatically detect account signup said john kercheval senior director identity service group godaddy recently began using amazon fraud detector pleased offer low cost implementation selfservice approach building machine learning model customized business model easily deployed used new account process without impacting signup experience legitimate customer model built amazon fraud detector able detect likely fraudulent signups immediately pleased result look forward accomplishing truevo make simple intuitive userfriendly payment product allow client receive payment effortlessly focus growing business amazon fraud detector enabled u drastically improve operation increase flexibility respond bad actor greater control system process initially exploring inhouse thirdparty solution amazon fraud detector announced immediately changed course aws customer many year great trust amazon product said charles grech coo truevo amazon fraud detector longer bound conventional limitation onpremises saas offering instead flexibility adapt machine learningpowered service meet need ability use awss rulesonly option easily scaling full machine learning capability needed saved truevo month development fact deployed first prototype model within minute overall operating greater confidence ability detect fraud realtime better equipped deploy rule detection notice odd activity may fully understand need stop able respond adapt everchanging regulatory scheme requirement allowing u stay top game activecampaign provides category defining customer experience automation software k small growing business around globe qq experienced spike account used phishing attack result needed supplement existing homegrown solution stronger transaction data signal identify bad actor sooner scalable solution based predictive machine learning important u growing business said alex burch senior email operation engineer activecampaign amazon fraud detector made easy build model using data accurately identifies account signups result phishing attack importantly able get result low false positive rate mean additional work operation staff amazon fraud detector competitive pricing model easily integrate model existing workflow amazon web service year amazon web service world comprehensive broadly adopted cloud platform aws offer fully featured service compute storage database networking analytics robotics machine learning artificial intelligence ai internet thing iot mobile security hybrid virtual augmented reality vr ar medium application development deployment management availability zone az within geographic region announced plan nine availability zone three aws region indonesia japan spain million customersincluding fastestgrowing startup largest enterprise leading government agenciestrust aws power infrastructure become agile lower cost learn aws visit awsamazoncom amazon amazon guided four principle customer obsession rather competitor focus passion invention commitment operational excellence longterm thinking customer review click shopping personalized recommendation prime fulfillment amazon aws kindle direct publishing kindle fire tablet fire tv amazon echo alexa product service pioneered amazon information visit amazoncomabout follow amazonnews,-0.9982,-0.4991,0.1738333333,-0.672933333,Negative Impact
29/07/2020,151.5495,151.96,149.84,151.68,151.68,59482000,2.13,76.34428766,1.192,0,9.3404,0.9034837908,0.2283735172,0.09,259.101,10542.94043,12669.62012,6131.5,4958.740234,3294.552002,38071.12891,16294.7002,137.9728194,107.7338248,139.8285215,114.8945247,152.4205231,161.4451769,143.3958693,41.30409323,3.931967443,5.219732462,-1.28776502,6.401286534,159.2642084,9647146000,31.89421143,31.05263545,24.10000038,Big Tech painted as the railroad barons of the digital age in antitrust hearing,For the most part ÃÂÃÂ if you could tune out the political grandstanding that had nothing to do with antirust ÃÂÃÂ the Congressional hearing on Big Tech gave many pointed examples of how four of the biggest tech companies in the U.S. abuse their dominant power and thwart competition.,https://www.marketwatch.com/story/big-tech-painted-as-the-railroad-barons-of-the-digital-age-in-antitrust-hearing-2020-07-29,marketwatch.com,8,part could tune political grandstanding nothing antirust congressional hearing big tech gave many pointed example four biggest tech company u abuse dominant power thwart competition,-0.6369,-0.50952,0.1448673333,-0.654387333,Negative Impact
30/07/2020,150.7,154.60,150.25,152.59,152.59,122566000,2.13,76.34428766,1.192,0,9.3404,0.9034837908,0.2283735172,0.09,259.101,10587.80957,12533.28027,5990,4852.939941,3286.822021,37736.07031,16299.2998,138.5753693,108.0626872,140.3291282,115.2696438,152.8534729,160.9468467,144.7600991,41.37110779,3.716815151,4.919149,-1.202333849,6.428787231,158.3723556,9769712000,35.91575813,30.80936339,24.76000023,"Jim Cramer reacts to Amazon, Apple, Facebook and Alphabet earnings","""These big tech stocks have been roaring because they either benefit directly from the pandemic or they've figured out how to thrive in spite of it,"" the ""Mad Money"" host said.",https://www.cnbc.com/2020/07/30/jim-cramer-reacts-to-amazon-apple-facebook-and-alphabet-earnings.html,cnbc.com,9,big tech stock roaring either benefit directly pandemic theyve figured thrive spite mad money host said,-0.5574,-0.50166,0.2076654762,-0.709325476,Negative Impact
31/07/2020,162.2,162.34,157.55,158.23,158.23,161710000,2.13,76.34428766,1.192,0,9.3404,0.9034837908,0.2283735172,0.09,259.101,10745.26953,12465.0498,5897.799805,4783.689941,3310.00708,37606.89063,16169.2002,139.2421091,108.4120122,141.0312798,115.6971497,153.5394226,160.9541611,146.1246841,53.46710785,3.955806153,4.726480431,-0.770674277,6.139645168,144.3999939,9931422000,77.10825646,48.30607534,24.45999908,Amazon CEO Jeff Bezos is $7.6 billion richer after earnings report,"While all Amazon.com Inc. AMZN, +4.23% investors are happy with the e-commerce giant's second-quarter earnings report, as the stock surged 4.5% in morning trading, the happiest of all may be Chief Executive Jeff Bezos.",https://www.marketwatch.com/story/amazon-ceo-jeff-bezos-is-76-billion-richer-after-earnings-report-2020-07-31,marketwatch.com,8,amazoncom inc amzn investor happy ecommerce giant secondquarter earnings report stock surged morning trading happiest may chief executive jeff bezos,0.836,0.6688,0.1960075,0.4727925,Positive Impact
03/08/2020,159.0255,159.20,155.20,155.59,155.59,101494000,2.13,76.34428766,1.192,0,9.3404,0.9034837908,0.2283735172,0.1,259.918,10902.7998,12536.80957,6032.899902,4875.930176,3367.966064,36939.60156,16169.2002,139.9072591,108.7456272,141.6023864,116.0941383,153.6765472,161.1390412,146.2140533,51.53601389,3.887411331,4.558666611,-0.67125528,5.791859218,144.7588141,9829928000,62.39617548,58.47339669,24.28000069,Global Payments Joins Forces with AWS to Deliver the Future of Payments,"SEATTLE & ATLANTA--(BUSINESS WIRE)--Today, Global Payments Inc. (NYSE: GPN) and Amazon Web Services (AWS), an Amazon.com company (NASDAQ: AMZN), announced a new, multi-year collaboration agreement to provide a cloud-based issuer processing platform to financial institutions around the world. As part of this agreement, Global Payments and AWS will strategically collaborate to transform Global PaymentsÃÂÃÂ core issuing platform to deliver secure, innovative solutions for the payment industry at scale. Global Payments will work with AWS to build on AWSÃÂÃÂs customer relationships, making innovative technologies available to institutions of all sizes worldwide and expand the customer base for Global PaymentsÃÂÃÂ issuer processing services. Global PaymentsÃÂÃÂ cloud-based issuer processing platform built on AWS will allow financial institutions of all sizes to more seamlessly operate the entire lifecycle of card issuance and management. The company is also leveraging the proven scalability of AWSÃÂÃÂs global infrastructure to support the rapid adoption of Global PaymentsÃÂÃÂ issuer processing platform around the world, which today handles approximately 27 billion transactions annually. Global Payments will rely on AWS as its preferred cloud provider for issuer processing and will use a range of AWS services, including storage, compute, database, security, analytics and machine learning to fulfill compliance requirements, enable new cloud-based services, and enhance customer experiences for its clients and their cardholders. In addition, Amazon and Global Payments will work together to explore additional opportunities for collaboration on innovative payments products and services across all of Global Payments. ÃÂÃÂWe are excited to enter into this collaboration with AWS, which enables us to offer our solutions to institutions regardless of size, location or processing preference,ÃÂÃÂ said Jeff Sloan, Chief Executive Officer, Global Payments. ÃÂÃÂThe new platformÃÂÃÂs cloud-based architecture will give clients the ability to use the services they need with greater speed-to-market, flexibility and best-in-class experiences for our customers and their cardholders. By strategically partnering with AWS, we can capitalize on the fintech and open banking movement, further expand our role in technology innovation, leapfrog existing distribution models and solidify our position as a leading provider of technology solutions for financial institutions, new market entrants, and retailers across the globe.ÃÂÃÂ ÃÂÃÂGlobal Payments is a leader in the payments technology industry, and working together, we will provide solutions to organizationsÃÂÃÂfrom traditional financial institutions to emerging payment playersÃÂÃÂto simplify commerce, so they can focus on innovation and growth,ÃÂÃÂ said Andy Jassy, CEO of AWS. ÃÂÃÂWe look forward to working with Global Payments to bring payment issuer solutions to new geographic regions and more customers throughout the world. By leveraging the proven scalability and reliability of the worldÃÂÃÂs leading cloud, Global Payments is providing the tools for businesses to manage the card issuance lifecycle and transform the way that the payments industry operates.ÃÂÃÂ About Global Payments Global Payments Inc. (NYSE: GPN) is a leading pure play payments technology company delivering innovative software and services to our customers globally. Our technologies, services and employee expertise enable us to provide a broad range of solutions that allow our customers to operate their businesses more efficiently across a variety of channels around the world. Headquartered in Georgia with nearly 24,000 employees worldwide, Global Payments is a member of the S&P 500 with worldwide reach spanning over 100 countries throughout North America, Europe, Asia Pacific and Latin America. For more information, visit www.globalpaymentsinc.com and follow Global Payments on Twitter (@globalpayinc), LinkedIn and Facebook. About Amazon Web Services For 14 years, Amazon Web Services has been the worldÃÂÃÂs most comprehensive and broadly adopted cloud platform. AWS offers over 175 fully featured services for compute, storage, databases, networking, analytics, robotics, machine learning and artificial intelligence (AI), Internet of Things (IoT), mobile, security, hybrid, virtual and augmented reality (VR and AR), media, and application development, deployment, and management from 77 Availability Zones (AZs) within 24 geographic regions, with announced plans for nine more Availability Zones and three more AWS Regions in Indonesia, Japan, and Spain. Millions of customersÃÂÃÂincluding the fastest-growing startups, largest enterprises, and leading government agenciesÃÂÃÂtrust AWS to power their infrastructure, become more agile, and lower costs. To learn more about AWS, visit aws.amazon.com. About Amazon Amazon is guided by four principles: customer obsession rather than competitor focus, passion for invention, commitment to operational excellence, and long-term thinking. Customer reviews, 1-Click shopping, personalized recommendations, Prime, Fulfillment by Amazon, AWS, Kindle Direct Publishing, Kindle, Fire tablets, Fire TV, Amazon Echo, and Alexa are some of the products and services pioneered by Amazon. For more information, visit www.amazon.com/about and follow @AmazonNews.",https://www.businesswire.com/news/home/20200803005187/en/Global-Payments-Joins-Forces-with-AWS-to-Deliver-the-Future-of-Payments,businesswire.com,5,seattle atlantabusiness wiretoday global payment inc nyse gpn amazon web service aws amazoncom company nasdaq amzn announced new multiyear collaboration agreement provide cloudbased issuer processing platform financial institution around world part agreement global payment aws strategically collaborate transform global payment core issuing platform deliver secure innovative solution payment industry scale global payment work aws build awss customer relationship making innovative technology available institution size worldwide expand customer base global payment issuer processing service global payment cloudbased issuer processing platform built aws allow financial institution size seamlessly operate entire lifecycle card issuance management company also leveraging proven scalability awss global infrastructure support rapid adoption global payment issuer processing platform around world today handle approximately billion transaction annually global payment rely aws preferred cloud provider issuer processing use range aws service including storage compute database security analytics machine learning fulfill compliance requirement enable new cloudbased service enhance customer experience client cardholder addition amazon global payment work together explore additional opportunity collaboration innovative payment product service across global payment excited enter collaboration aws enables u offer solution institution regardless size location processing preference said jeff sloan chief executive officer global payment new platform cloudbased architecture give client ability use service need greater speedtomarket flexibility bestinclass experience customer cardholder strategically partnering aws capitalize fintech open banking movement expand role technology innovation leapfrog existing distribution model solidify position leading provider technology solution financial institution new market entrant retailer across globe global payment leader payment technology industry working together provide solution organizationsfrom traditional financial institution emerging payment playersto simplify commerce focus innovation growth said andy jassy ceo aws look forward working global payment bring payment issuer solution new geographic region customer throughout world leveraging proven scalability reliability world leading cloud global payment providing tool business manage card issuance lifecycle transform way payment industry operates global payment global payment inc nyse gpn leading pure play payment technology company delivering innovative software service customer globally technology service employee expertise enable u provide broad range solution allow customer operate business efficiently across variety channel around world headquartered georgia nearly employee worldwide global payment member sp worldwide reach spanning country throughout north america europe asia pacific latin america information visit follow global payment twitter globalpayinc linkedin facebook amazon web service year amazon web service world comprehensive broadly adopted cloud platform aws offer fully featured service compute storage database networking analytics robotics machine learning artificial intelligence ai internet thing iot mobile security hybrid virtual augmented reality vr ar medium application development deployment management availability zone az within geographic region announced plan nine availability zone three aws region indonesia japan spain million customersincluding fastestgrowing startup largest enterprise leading government agenciestrust aws power infrastructure become agile lower cost learn aws visit awsamazoncom amazon amazon guided four principle customer obsession rather competitor focus passion invention commitment operational excellence longterm thinking customer review click shopping personalized recommendation prime fulfillment amazon aws kindle direct publishing kindle fire tablet fire tv amazon echo alexa product service pioneered amazon information visit follow amazonnews,0.9978,0.4989,0.19351,0.30539,Positive Impact
04/08/2020,155.0605,158.36,155.06,156.94,156.94,93886000,2.13,76.34428766,1.192,0,9.3404,0.9034837908,0.2283735172,0.1,259.918,10941.16992,12612.11035,6036,4889.52002,3371.689941,37687.91016,16368,140.609209,109.0834647,142.2039202,116.5005796,154.0233223,161.4118451,146.6347995,57.55862888,3.896977662,4.426328821,-0.529351159,5.58064488,145.1104579,9923814000,69.90411488,69.80284894,23.76000023,"Politics Of The Big Tech Hearing: Facebook, Apple, Amazon And Google","Through a long series of unforced errors borne of arrogance, our large big tech companiesÃÂÃÂmarvels of creativity and innovationÃÂÃÂhave needlessly put themselves in serious political jeopardy.",https://www.forbes.com/sites/steveforbes/2020/08/04/politics-of-the-big-tech-hearing-facebook-apple-amazon-and-google/,forbes.com,8,long series unforced error borne arrogance large big tech companiesmarvels creativity innovationhave needlessly put serious political jeopardy,-0.7845,-0.6276,0.1391154545,-0.766715455,Negative Impact
05/08/2020,157.1885,160.68,156.37,160.25,160.25,78330000,2.13,76.34428766,1.192,0,9.3404,0.9034837908,0.2283735172,0.1,259.918,10998.40039,12731.5498,6104.700195,4933.339844,3377.560059,37663.32813,16501.59961,141.3923788,109.4453446,142.9116682,116.9359121,154.3331223,162.2294687,146.4367759,61.18594256,4.124108037,4.365884664,-0.241776627,5.482501439,145.4550688,10002144000,88.35345328,73.55124788,22.98999977,Amazon Insights For Boards,A perspective I recommend bringing to your board rooms is the best insights and learnings from truly world class thinkers and companies. The company and leader I believe we can learn from is Jeff Bezos and Amazon.,https://www.forbes.com/sites/betsyatkins/2020/08/05/amazon-insights-for-boards/,forbes.com,8,perspective recommend bringing board room best insight learning truly world class thinker company company leader believe learn jeff bezos amazon,0.8834,0.70672,0.2319464286,0.4747735714,Positive Impact
06/08/2020,159.718,162.37,158.27,161.25,161.25,78812000,2.13,76.34428766,1.192,0,9.3404,0.9034837908,0.2283735172,0.1,259.918,11108.07031,12729.16992,6026.899902,4885.129883,3386.459961,38025.44922,16579.09961,142.2069888,109.8051796,143.6308185,117.3768483,154.4390472,162.656714,146.2213805,64.62985274,4.334713596,4.35965045,-0.024936855,5.505680629,145.7927875,10080956000,93.74910859,84.00222558,22.64999962,"Market Extra: AmazonÃÂÃÂs stock flips the technical script to success from failure with first close above $3,200","Despite the huge rally in Amazon.com Inc.ÃÂÃÂs stock this year during the COVID-19 pandemic, and despite increasing regulatory concerns, there was one thing the stock has failed to do ÃÂÃÂ close above $3,200.",https://www.marketwatch.com/story/amazons-stock-flips-the-technical-script-to-success-from-failure-with-first-close-above-3200-2020-08-06,marketwatch.com,8,despite huge rally amazoncom inc stock year covid pandemic despite increasing regulatory concern one thing stock failed close,-0.6442,-0.51536,0.2204745455,-0.735834545,Negative Impact
07/08/2020,161.2005,162.04,157.03,158.37,158.37,78722000,2.13,76.34428766,1.192,0,9.3404,0.9034837908,0.2283735172,0.1,259.918,11010.98047,12765.83984,6032.200195,4889.52002,3354.034912,38040.57031,16544.5,142.9733488,110.1556121,144.2089433,117.7847703,154.3576973,162.3733027,146.3420919,47.9643103,4.220815319,4.331883424,-0.111068105,5.008359637,146.4560162,10002234000,77.74222523,86.61492903,22.20999908,3 Stocks to Get You Started Investing in 2020,"Sometimes, great stock picks hide in plain sight.",https://www.fool.com/investing/2020/08/07/3-stocks-to-get-you-started-investing-in-2020.aspx,fool.com,7,sometimes great stock pick hide plain sight,0.5267,0.36869,0.456665,-0.087975,Negative Impact
10/08/2020,158.5155,158.63,155.08,157.41,157.41,63346000,2.13,76.34428766,1.192,0,9.3404,0.9034837908,0.2283735172,0.1,259.918,10968.36035,12844.01953,6050.600098,4909.509766,3379.251953,38182.07813,16605.5,143.6791389,110.5021097,144.7265536,118.1790313,154.4680977,162.5926324,146.3435629,50.72321433,4.006498554,4.26680645,-0.260307897,4.780251639,147.0927157,9938888000,72.37323331,81.28818904,22.12999916,"Banks and tech giants including JPMorgan and Amazon pledge to hire 100,000 minority New Yorkers","The coronavirus pandemic has helped exacerbate inequality in U.S. cities, resulting in more job losses and worse health outcomes for people in low-income neighborhoods.",https://www.cnbc.com/2020/08/10/banks-and-tech-companies-including-jpmorgan-google-and-amazon-form-new-york-jobs-council.html,cnbc.com,9,coronavirus pandemic helped exacerbate inequality u city resulting job loss worse health outcome people lowincome neighborhood,-0.6597,-0.59373,0.09354266667,-0.687272667,Negative Impact
11/08/2020,155.66,157.96,153.65,154.03,154.03,74362000,2.13,76.34428766,1.192,0,9.3404,0.9034837908,0.2283735172,0.1,259.918,10782.82031,12849.42969,6154.299805,5027.990234,3340.290039,38407.01172,16497,144.2887688,110.8270821,145.0915316,118.5357921,154.4597725,162.5858051,146.3337399,48.64788121,3.523736636,4.118192487,-0.594455851,4.78553772,147.7039473,9864526000,53.59831634,67.90459163,24.03000069,Grocery stores might be the next big thing to move into malls,"When asked specifically about opening grocery stores at Simon Property malls, CEO David Simon said: ""Yes, I am hopeful that we can certainly do more business with that category.""",https://www.cnbc.com/2020/08/11/grocery-stores-might-be-the-next-big-thing-to-move-into-malls.html,cnbc.com,9,asked specifically opening grocery store simon property mall ceo david simon said yes hopeful certainly business category,0.8126,0.73134,0.2127905,0.5185495,Positive Impact
12/08/2020,155.4,158.72,155.07,158.11,158.11,70442000,2.13,76.34428766,1.192,0,9.3404,0.9034837908,0.2283735172,0.1,259.918,11012.24023,12974.83008,6280.100098,5073.310059,3319.266113,38369.62891,16575.30078,144.9785988,111.1773096,145.6021382,118.9295852,154.8431976,162.8946365,146.7917588,62.92426979,3.430698766,3.980693743,-0.549994977,4.656288147,148.2907296,9934968000,76.29007939,67.42054302,22.28000069,"Amazon launching small-business virtual event, Amazon Accelerate, in September","Amazon.com Inc. AMZN, -2.14% said Wednesday that it will host its first Amazon Accelerate virtual event, a free conference focused on current small-business partners taking place September 1 through September 3.",https://www.marketwatch.com/story/amazon-launching-small-business-virtual-event-amazon-accelerate-in-september-2020-08-12,marketwatch.com,8,amazoncom inc amzn said wednesday host first amazon accelerate virtual event free conference focused current smallbusiness partner taking place september september,0.765,0.612,0.14696625,0.46503375,Positive Impact
13/08/2020,159.1495,160.88,157.75,158.05,158.05,62980000,2.13,76.34428766,1.192,0,9.3404,0.9034837908,0.2283735172,0.1,259.918,11042.5,12919.15039,6185.600098,5042.379883,3320.726074,38310.48828,16530.09961,145.6612187,111.5232946,146.0903286,119.318853,155.2459976,163.079285,147.4127102,61.54884895,3.313843098,3.847323614,-0.533480516,4.366788592,148.8540406,9871988000,65.65487073,65.18108882,22.12999916,California court rules Amazon is liable for injuries from defective products,"Amazon.com can be held liable like other traditional retailers for injuries from defective products sold via its sprawling e-commerce marketplace, a California state appeals court ruled on Thursday.",https://www.reuters.com/article/us-amazon-com-liability/california-court-rules-amazon-is-liable-for-injuries-from-defective-products-idUSKCN259327,reuters.com,10,amazoncom held liable like traditional retailer injury defective product sold via sprawling ecommerce marketplace california state appeal court ruled thursday,-0.4939,-0.4939,0.1453292308,-0.639229231,Negative Impact
14/08/2020,158.909,158.91,156.00,157.40,157.40,55034000,2.13,76.34428766,1.192,0,9.3404,0.9034837908,0.2283735172,0.1,259.918,11019.2998,12902.5,6090,4962.930176,3360.099121,37877.33984,16514.59961,146.3486388,111.8696222,146.5338844,119.6977798,155.7111229,162.8295538,148.592692,57.42183306,3.132673554,3.704393602,-0.571720048,4.256610325,149.3948191,9816954000,60.4902498,67.47839998,22.04999924,Landmark product liability ruling puts AmazonÃÂÃÂs third-party marketplace in a new legal pinch,An appeals court in California ruled Thursday that federal law does not shield Amazon from liability for defective products offered by third-party sellers through its online marketplace ÃÂÃÂ the latest blow to the one of the tech giantÃÂÃÂs most controversial legal positions.,https://www.geekwire.com/2020/landmark-product-liability-ruling-puts-amazons-third-party-marketplace-new-legal-pinch/,geekwire.com,5,appeal court california ruled thursday federal law shield amazon liability defective product offered thirdparty seller online marketplace latest blow one tech giant controversial legal position,-0.5106,-0.2553,0.1332292857,-0.388529286,Negative Impact
17/08/2020,158.656,159.75,157.71,159.12,159.12,53824000,2.13,76.34428766,1.192,0,9.3404,0.9034837908,0.2283735172,0.1,259.918,11129.73047,12936.11035,6127.399902,4971.939941,3438.801025,38050.78125,16656.09961,147.0480487,112.2202272,147.0274771,120.0900457,155.6750481,162.7121825,148.6379136,65.05390886,3.092199525,3.581954787,-0.489755261,4.13382394,149.9139665,9870778000,74.04862361,66.73124805,21.35000038,Rackspace shares surge on report that Amazon is in talks to invest in company,"Reuters reported Monday that Amazon is interested in acquiring a minority stake in Rackspace, which helps companies shift their data to Amazon Web Services.",https://www.cnbc.com/2020/08/17/rackspace-shares-surge-on-report-that-amazon-is-in-talks-to-invest-in-company.html,cnbc.com,9,reuters reported monday amazon interested acquiring minority stake rackspace help company shift data amazon web service,0.7783,0.70047,0.1189615789,0.5815084211,Positive Impact
18/08/2020,160.6,166.00,160.29,165.62,165.62,106920000,2.13,76.34428766,1.192,0,9.3404,0.9034837908,0.2283735172,0.1,259.918,11210.83984,12910.33008,6076.600098,4938.060059,3451.089111,38528.32031,16626.09961,147.8364786,112.6041846,147.756772,120.5431248,156.1105476,164.4315807,147.7895145,69.8791371,3.544087795,3.574381388,-0.030293593,4.473824637,150.4123481,9977698000,97.61585054,77.38490798,21.51000023,"Amazon To Tardy Sellers: If You CanÃÂÃÂt Meet Prime Demands, ItÃÂÃÂs Time To Start Working Weekends",The e-commerce giant issued a warning to sellers who are failing to meet their one or two-day delivery promise.,https://www.forbes.com/sites/laurendebter/2020/08/18/amazon-seller-fulfilled-prime-changes/,forbes.com,8,ecommerce giant issued warning seller failing meet one twoday delivery promise,-0.5267,-0.42136,0.1790885185,-0.600448519,Negative Impact
19/08/2020,165.1505,165.80,162.80,163.02,163.02,83702000,2.13,76.34428766,1.192,0,9.3404,0.9034837908,0.2283735172,0.1,259.918,11146.45996,12859.87988,6112,4977.22998,3408.128906,38614.78906,16577.40039,148.4960986,112.9714447,148.3554869,120.9658201,156.5119728,165.3641832,147.6597624,64.18469755,3.650296001,3.589564311,0.06073168983,4.377038138,151.3476072,9893996000,75.90286272,82.52244562,22.54000092,"USPS delays threaten a key backbone of online sales for Amazon, eBay and more",Delivery delays and operational changes threaten to upend one of the key backbones of the e-commerce market.,https://www.cnbc.com/2020/08/19/how-usps-delays-impact-amazon-etsy-and-ebay.html,cnbc.com,9,delivery delay operational change threaten upend one key backbone ecommerce market,-0.5994,-0.53946,0.09961866667,-0.639078667,Negative Impact
20/08/2020,162.6,165.63,161.90,164.87,164.87,66650000,2.13,76.34428766,1.192,0,9.3404,0.9034837908,0.2283735172,0.1,259.918,11264.9502,12812.86035,6013.299805,4911.240234,3363.898926,38220.39063,16606.80078,149.1460187,113.3446222,149.003056,121.4026627,157.2890228,166.2139316,148.364114,60.06158221,3.839048159,3.63946108,0.1995870786,3.94732339,152.2267508,9960646000,90.83805923,88.11892416,22.71999931,"Former Zoox employees sue, alleging rival offer was better than Amazon's",The lawsuit alleges that the Amazon deal created disproportionate rewards for executives and investors holding preferred shares at the expense of common stockholders.,https://www.cnbc.com/2020/08/20/former-zoox-employees-sue-alleging-rival-offer-was-better-than-amazons.html,cnbc.com,9,lawsuit alleges amazon deal created disproportionate reward executive investor holding preferred share expense common stockholder,0.7717,0.69453,0.273233,0.421297,Positive Impact
21/08/2020,164.75,165.72,163.77,164.24,164.24,71518000,2.13,76.34428766,1.192,0,9.3404,0.9034837908,0.2283735172,0.1,259.918,11311.7998,12809.07031,6001.899902,4896.330078,3380.683105,38434.71875,16517.90039,149.8727785,113.7153746,149.6004261,121.828865,157.9785477,166.8076159,149.1494794,63.95477141,3.892724643,3.690113793,0.20261085,3.800930568,153.0531457,9889128000,85.71654497,84.15248897,22.54000092,Is Amazon Actually Losing Market Share?,Strong online sales growth from some big competitors disguises the overall market growth.,https://www.fool.com/investing/2020/08/21/is-amazon-actually-losing-market-share/,fool.com,7,strong online sale growth big competitor disguise overall market growth,0.7579,0.53053,0.1757629412,0.3547670588,Positive Impact
24/08/2020,165.5075,169.02,162.88,165.37,165.37,93326000,2.13,76.34428766,1.192,0,9.3404,0.9034837908,0.2283735172,0.1,259.918,11379.71973,12972.87988,6104.700195,5007.890137,3385.637939,38799.07813,16626.59961,150.6352185,114.0932971,150.2189584,122.2621399,158.6091728,167.667699,149.5506467,63.70863904,3.98111888,3.74831481,0.2328040696,4.003537859,153.829957,9982454000,76.29179754,84.28213391,22.37000084,"Amazon's Legal, Regulatory Hurdles Are Getting Higher","The pace of lawsuits it's fighting appears to be picking up steam, and they're getting serious.",https://www.fool.com/investing/2020/08/24/why-the-legal-walls-are-closing-in-on-amazon/,fool.com,7,pace lawsuit fighting appears picking steam theyre getting serious,-0.5719,-0.40033,0.08072545455,-0.481055455,Negative Impact
25/08/2020,164.7495,167.87,163.35,167.32,167.32,79856000,2.13,76.34428766,1.192,0,9.3404,0.9034837908,0.2283735172,0.1,259.918,11466.46973,13001.99023,6037,5008.27002,3373.577881,38843.87891,16617.5,151.4090283,114.4828696,150.8897637,122.7105216,159.4745728,168.3824594,150.5666861,62.03135853,4.160679348,3.830787718,0.3298916302,4.018215724,155.0448409,10062310000,88.99185424,83.66673225,22.03000069,Amazon Taking on Farfetch With New Luxury Brand Platform,It also will give it more room to run in the lower- and mid-tier market.,https://www.fool.com/investing/2020/08/25/amazon-taking-on-farfetch-with-new-luxury-brand-pl/,fool.com,7,also give room run lower midtier market,-0.296,-0.2072,0.2069185714,-0.414118571,Negative Impact
26/08/2020,167.5555,172.59,167.23,172.09,172.09,130174000,2.13,76.34428766,1.192,0,9.3404,0.9034837908,0.2283735172,0.1,259.918,11665.05957,13042.54004,6045.600098,5048.430176,3329.739014,39073.92188,16790,152.2356082,114.8968621,151.7212435,123.2018845,160.4953728,170.2769457,150.7137999,66.34702982,4.634299182,3.991490011,0.6428091714,4.107965742,156.1625342,10192484000,97.38867545,87.55744241,23.27000046,Is This What's Behind the Unstoppable FAANG Stock Rally?,Hint: It's not billionaire money managers.,https://www.fool.com/investing/2020/08/26/is-this-whats-behind-the-unstoppable-faang-stock-r/,fool.com,7,hint billionaire money manager,0,0,0.3356277778,-0.335627778,Negative Impact
27/08/2020,172.5025,172.65,168.90,170.00,170.00,85296000,2.13,76.34428766,1.192,0,9.3404,0.9034837908,0.2283735172,0.1,259.918,11625.33984,13068.80957,6000,5015.970215,3350.110107,39113.46875,16731.5,152.9946283,115.3039496,152.4380575,123.6675374,161.3656731,171.2835862,151.4477599,67.9545295,4.785633347,4.150318678,0.6353146688,4.018179757,157.8049813,10107188000,86.0526637,90.81106446,24.46999931,3 High-Flying Stocks Billionaires Dumped in Q2,"Although these brand-name stocks have been unstoppable in 2020, money managers headed for the exit in the second quarter.",https://www.fool.com/investing/2020/08/27/3-high-flying-stocks-billionaires-dumped-in-q2/,fool.com,7,although brandname stock unstoppable money manager headed exit second quarter,-0.2023,-0.14161,0.2509506667,-0.392560667,Negative Impact
28/08/2020,171.15,171.67,169.33,170.09,170.09,57940000,2.13,76.34428766,1.192,0,9.3404,0.9034837908,0.2283735172,0.1,259.918,11695.62988,13170.95996,5963.600098,5002.939941,3403.806885,39467.30859,16705.80078,153.7424481,115.7098996,153.1302904,124.1294524,161.9584732,172.4867501,151.4301964,70.12758113,4.856842063,4.291623355,0.565218708,3.932037354,159.5863828,10165128000,86.52632864,89.9892226,22.95999908,"U.S. big tech dominates stock market after monster rally, leaving investors on edge","U.S. technology giants are increasingly dominating the stock market in the midst of the coronavirus pandemic, even as they draw accusations of unfair business practices, and some investors fear the pump is primed for a tech-fueled sell-off.",https://www.reuters.com/article/us-usa-markets-faangs-analysis/u-s-big-tech-dominates-stock-market-after-monster-rally-leaving-investors-on-edge-idUSKBN25O0FV,reuters.com,10,u technology giant increasingly dominating stock market midst coronavirus pandemic even draw accusation unfair business practice investor fear pump primed techfueled selloff,-0.8591,-0.8591,0.1168971429,-0.975997143,Negative Impact
31/08/2020,170.4495,174.75,170.25,172.55,172.55,83718000,2.13,76.34428766,1.192,0,9.3404,0.9034837908,0.2283735172,0.1,259.918,11775.45996,13045.59961,5963.600098,4947.220215,3395.677979,38628.28906,16514.40039,154.5183981,116.1343621,153.8917694,124.6112291,162.8061485,173.8922121,151.720085,80.26482316,5.053364135,4.443971511,0.6093926244,3.956965855,161.1540162,10248846000,88.81042861,87.12980698,26.40999985,Amazon wins FAA approval for Prime Now drone delivery fleet,"The FAA approval will give Amazon broad privileges to ""safely and efficiently deliver packages to customers.""",https://www.cnbc.com/2020/08/31/amazon-prime-now-drone-delivery-fleet-gets-faa-approval.html,cnbc.com,9,faa approval give amazon broad privilege safely efficiently deliver package customer,0.9042,0.81378,0.3279316667,0.4858483333,Positive Impact
01/09/2020,174.479,175.69,173.35,174.96,174.96,68644000,2.13,76.34428766,1.192,0,9.3404,0.9034837908,0.2283735172,0.09,260.28,11939.66992,13113.74023,5862.100098,4938.100098,3410.606934,38900.80078,16645,155.3036981,116.570492,154.7178174,125.112172,163.7068733,175.6785709,151.7351757,79.12473405,5.341836555,4.62354452,0.7182920355,3.846929278,163.0574539,10317490000,96.25509343,90.53061689,26.12000084,Retailers Join Fight To Get Amazon And Other Marketplaces To Identify Third Party Sellers,"Gap, JC Penney, Birkenstock, and LeviÃÂÃÂs have joined a coalition of retail groups pushing for legislation to require Amazon and other online marketplaces to do a better job of monitoring third party sellers.",https://www.forbes.com/sites/joanverdon/2020/09/01/retailers-join-fight-to-get-amazon-and-other-marketplaces-to-identify-third-party-sellers/,forbes.com,8,gap jc penney birkenstock levi joined coalition retail group pushing legislation require amazon online marketplace better job monitoring third party seller,0.743,0.5944,0.2860570833,0.3083429167,Positive Impact
02/09/2020,177.35,177.61,174.33,176.57,176.57,78630000,2.13,76.34428766,1.192,0,9.3404,0.9034837908,0.2283735172,0.09,260.28,12056.44043,13276.74023,5941,5031.740234,3404.802002,39086.03125,16698,156.0707379,117.018482,155.5748636,125.624215,164.5229233,177.6702116,151.375635,80.390527,5.635923716,4.826020359,0.8099033566,3.857785906,165.0792207,10396120000,95.18793107,93.4178177,26.56999969,Amazon Deletes Two 'Union Buster' Job Listings After Widespread Criticism,"Amazon.com, Inc (NASDAQ: AMZN) deleted job listings related to tracking threats from labor organization after coming under criticism, Fortune reported Tuesday.",https://www.benzinga.com/government/20/09/17345583/amazon-deletes-two-union-buster-job-listings-after-widespread-criticism,benzinga.com,5,amazoncom inc nasdaq amzn deleted job listing related tracking threat labor organization coming criticism fortune reported tuesday,-0.743,-0.3715,0.2569977273,-0.628497727,Negative Impact
03/09/2020,174.25,174.42,165.15,168.40,168.40,163222000,2.13,76.34428766,1.192,0,9.3404,0.9034837908,0.2283735172,0.09,260.28,11458.09961,12966.13965,5850.899902,5009.52002,3384.980957,38990.94141,16448.90039,156.7043378,117.4223494,156.0778098,126.0498447,164.880423,178.0418233,151.7190226,64.47426547,5.150169462,4.89085018,0.2593192826,4.465678624,177.6125031,10232898000,53.71413282,81.71905244,33.59999847,"Amazon to create further 7,000 jobs in UK in 2020","Amazon will create a further 7,000 permanent jobs across the United Kingdom in 2020, taking total new jobs this year to 10,000, it said on Thursday.",https://www.reuters.com/article/us-amazon-jobs-britain/amazon-to-create-further-7000-jobs-in-uk-in-2020-idUSKBN25U174,reuters.com,10,amazon create permanent job across united kingdom taking total new job year said thursday,0.6808,0.6808,0.2277242857,0.4530757143,Positive Impact
04/09/2020,165.9,169.08,155.56,164.73,164.73,175636000,2.13,76.34428766,1.192,0,9.3404,0.9034837908,0.2283735172,0.09,260.28,11313.12988,12966.13965,5799.100098,4965.069824,3355.366943,38357.17969,16218,157.2443777,117.8078069,156.4171507,126.4347318,165.1983231,178.0001425,152.3965036,57.02287644,4.418218328,4.796323809,-0.378105481,5.26360648,177.6125031,10057262000,41.59638925,63.49948438,30.75,S&P 500 Falls as Amazon Stock Leads Megacap Market Crash,It was a bad day for megacap stocks.,https://www.fool.com/investing/2020/09/04/sp-500-falls-as-amazon-stock-leads-megacap-market/,fool.com,7,bad day megacap stock,-0.5423,-0.37961,0.1497482609,-0.529358261,Negative Impact
09/09/2020,160.1495,165.16,159.25,163.43,163.43,103774000,2.13,76.34428766,1.192,0,9.3404,0.9034837908,0.2283735172,0.09,260.28,11141.55957,12885.7998,6012.799805,5042.97998,3254.62793,38193.92188,16383.59961,158.2895779,118.5423595,156.732682,127.1088015,165.6723732,177.3805517,153.9641947,50.46174165,2.71281946,4.126920301,-1.41410084,5.693856376,175.8833127,10039152000,35.70000457,28.69059627,28.80999947,AmazonÃÂÃÂs Beaumont fulfillment center is now open for business,"SEATTLE--(BUSINESS WIRE)--Amazon.com, Inc. (NASDAQ: AMZN) announced today that its new fulfillment center in Beaumont, California is officially open for business.",https://www.businesswire.com/news/home/20200909005362/en/Amazon%E2%80%99s-Beaumont-fulfillment-center-open-business/,businesswire.com,5,seattlebusiness wireamazoncom inc nasdaq amzn announced today new fulfillment center beaumont california officially open business,0,0,0.3362,-0.3362,Negative Impact
10/09/2020,165.361,167.49,158.53,158.76,158.76,106614000,2.13,76.34428766,1.192,0,9.3404,0.9034837908,0.2283735172,0.09,260.28,10919.58984,12706.69043,6003.299805,5023.930176,3234.822998,38840.32031,16185.2998,158.7058679,118.8997069,156.812008,127.423694,165.7045479,177.3284808,154.0806149,43.47570052,1.914009209,3.684338082,-1.770328873,6.067856925,175.0702403,9932538000,14.50394407,19.65978121,29.70999908,Leading Wellbeing Brand Exhale Teams up With Amazon for the Launch of Amazon Halo,"CHICAGO--(BUSINESS WIRE)--Hyatt today announced a new collaboration between HyattÃÂÃÂs Exhale brand and Amazon Halo, a health and wellness membership.",https://www.businesswire.com/news/home/20200910005942/en/Leading-Wellbeing-Brand-Exhale-Teams-Amazon-Launch/,businesswire.com,5,chicagobusiness wirehyatt today announced new collaboration hyatts exhale brand amazon halo health wellness membership,0.5574,0.2787,0.2787,0,Negative Impact
14/09/2020,158.647,159.37,154.80,155.15,155.15,90592000,2.13,76.34428766,1.192,0,9.3404,0.9034837908,0.2283735172,0.09,260.28,11056.65039,12932.69043,6026.299805,5051.879883,3278.813965,38756.62891,16360.09961,159.156058,119.5618094,156.7090567,127.9792129,165.4799232,177.813682,153.1461645,39.49943131,0.2754012471,2.57809033,-2.302689083,6.292785645,173.0842497,9740066000,4.055324887,8.481394767,25.85000038,TIDI Products Announces Partnership with Amazon Amid COVID-19 Pandemic,"NEENAH, Wis., Sept. 14, 2020 /PRNewswire/ -- TIDI Products, a premier designer, developer, and manufacturer of medical devices, has partnered with Amazon Business to provide personal protective equipment, including eyewear, face shields, and other necessary products to healthcare.",https://www.prnewswire.com/news-releases/tidi-products-announces-partnership-with-amazon-amid-covid-19-pandemic-301130055.html,prnewswire.com,5,neenah wi sept prnewswire tidi product premier designer developer manufacturer medical device partnered amazon business provide personal protective equipment including eyewear face shield necessary product healthcare,0.1779,0.08895,0.3761125,-0.2871625,Negative Impact
15/09/2020,156.808,158.75,155.45,157.81,157.81,80430000,2.13,76.34428766,1.192,0,9.3404,0.9034837908,0.2283735172,0.09,260.28,11190.32031,12967.17969,6105.5,5067.930176,3295.679932,39044.35156,16431.30078,159.255148,119.8962144,156.7520938,128.2760019,165.4142235,177.9036328,152.9248142,40.36484311,-0.108056915,2.040860881,-2.148917796,6.227251325,171.951135,9820496000,15.40777111,8.782670447,25.59000015,Bed Scrunchie Inventors Fight to Protect Their Intellectual Property Against Chinese Sellers on Amazon,"NEW YORK, Sept. 15, 2020 /PRNewswire/ -- Inventors of the Bed Scrunchie (https://bedscrunchie.com/) Jack Nekhala and Michael Nusinkis take on Amazon in the fight to protect their intellectual property from fraudulent Chinese sellers.",https://www.prnewswire.com/news-releases/bed-scrunchie-inventors-fight-to-protect-their-intellectual-property-against-chinese-sellers-on-amazon-301130905.html,prnewswire.com,5,new york sept prnewswire inventor bed scrunchie jack nekhala michael nusinkis take amazon fight protect intellectual property fraudulent chinese seller,0.2023,0.10115,0.38706,-0.28591,Negative Impact
16/09/2020,158.9995,159.36,153.71,153.91,153.90,90244000,2.13,76.34428766,1.192,0,9.3404,0.9034837908,0.2283735172,0.09,260.28,11050.46973,12997.86035,6078.5,5074.419922,3283.924072,39302.85156,16295.7002,159.3331281,120.2155394,156.640443,128.5310168,164.8282486,178.334435,151.3220622,31.25984618,-0.718486811,1.488991343,-2.207478154,6.248393467,170.8860072,9730252000,0.8261640532,6.763086683,26.04000092,"Amazon Music Launches Podcasts for Customers Across the U.S., U.K., Germany and Japan","SEATTLE--(BUSINESS WIRE)--Amazon Music announced today the launch of podcasts in the U.S., U.K., Germany, and Japan, across all tiers of service at no additional cost.",https://www.businesswire.com/news/home/20200916005550/en/Amazon-Music-Launches-Podcasts-for-Customers-Across-the-U.S.-U.K.-Germany-and-Japan/,businesswire.com,5,seattlebusiness wireamazon music announced today launch podcasts u uk germany japan across tier service additional cost,0,0,0.31757,-0.31757,Negative Impact
17/09/2020,150.4625,151.47,148.63,150.44,150.44,128982000,2.13,76.34428766,1.192,0,9.3404,0.9034837908,0.2283735172,0.09,260.28,10910.28027,12948.4502,6049.899902,5039.5,3270.435059,38979.85156,16246.7002,159.260748,120.5223219,156.3971509,128.7489817,164.1988731,179.1544294,149.2433169,30.39787252,-1.465245894,0.8981438955,-2.363389789,6.357500349,169.511727,9601270000,6.241126239,7.491687134,26.45999908,Amazon Announces First Recipients of Investments from $2 Billion Climate Pledge Fund,"SEATTLE--(BUSINESS WIRE)--Amazon (NASDAQ:AMZN) today announced the first recipients of investments from The Climate Pledge Fund: CarbonCure Technologies, Pachama, Redwood Materials, Rivian, and Turntide Technologies. The Climate Pledge Fund is a dedicated $2 billion venture investment program backing sustainable technologies and services that will help Amazon and other companies to meet The Climate PledgeÃÂÃÂa commitment to be net-zero carbon by 2040. ÃÂÃÂThe Climate Pledge Fund invests in visionary companies whose products and services can empower a low carbon economy,ÃÂÃÂ said Jeff Bezos, Amazon founder and CEO. ÃÂÃÂToday, I am excited to announce that we are investing in a group of companies that are channeling their entrepreneurial energy into helping Amazon and other companies reach net zero by 2040 and keep the planet safer for future generations.ÃÂÃÂ The Climate Pledge Fund is investing in companies in multiple industries, including transportation and logistics, energy generation, storage and utilization, manufacturing and materials, circular economy, and food and agriculture. Over time, Amazon will also look for opportunities to involve other Climate Pledge signatories in this venture investment program and help them find solutions to help them reach net zero carbon by 2040. ÃÂÃÂThe Climate Pledge Fund is another important example of how the collaborative effort of The Climate Pledge can accelerate the transition to a net zero world. These investments will scale new technologies, helping these organizations speed up the pace at which operational emissions can be reduced,ÃÂÃÂ said Christiana Figueres, the UNÃÂÃÂs former climate change chief and founding partner of Global Optimism. ÃÂÃÂThis is how a whole-economy approach to tackling the climate crisis looks. Together these companies demonstrate that there are endless possibilities in the clean, healthy recovery we must create together.ÃÂÃÂ The first five companies that the Climate Pledge Fund is investing in are: CarbonCure Technologies: Has commercialized a portfolio of carbon removal technologies that consume carbon dioxide (CO2) in concrete during production, permanently sequestering CO2 and enabling the reduction of cement content in mixes without impacting concrete performance. Amazon is working to lower the embodied carbon footprint of its buildings by using CarbonCure concrete in many of its new buildings, including HQ2 in Virginia. Pachama: Pachama is a climate technology company that is democratizing access to nature-based carbon markets. Pachama's technology verifies the impact of carbon capture in the world's forests, allowing organizations and individuals to compensate their emissions with confidence by supporting reforestation and forest conservation projects. Pachama will help Amazon monitor and evaluate nature-based solutions, including investments made by the Right Now Climate Fund. Redwood Materials: Developing and commercializing a full process and suite of technologies for recycling end-of-life Lithium-ion batteries and e-waste into high value metals and chemicals. With AmazonÃÂÃÂs firm commitment to electric delivery and electrification infrastructure, Redwood Materials will help Amazon properly recycle Electric Vehicle (EV) batteries and reuse their components. Redwood Materials can also help recycle the lithium batteries and e-waste from other parts of AmazonÃÂÃÂs businesses. Rivian: As part of The Climate Pledge announcement in 2019, Amazon revealed it had purchased 100,000 EVs from Rivian, with plans to have 10,000 of the new electric vehicles on the road as early as 2022 and all 100,000 vehicles on the road by 2030. The Climate Pledge Fund participated in RivianÃÂÃÂs latest investment round in July, and with proceeds from that investment, Rivian is further developing and integrating its connected electric platform with AmazonÃÂÃÂs last mile delivery network. Turntide Technologies: TurntideÃÂÃÂs motors reduce energy use by 64% on average by optimizing efficiency and control without using expensive materials or rare earth minerals. Amazon is piloting TurntideÃÂÃÂs motors in a number of its buildings and the results so far have demonstrated significantly reduced electricity usage. ÃÂÃÂThis investment is a great endorsement of CarbonCure as the go-to Carbon Dioxide Removal (CDR) solution for the growing tech construction space and the overall shift towards low embodied carbon construction materials,ÃÂÃÂ said Robert Niven, CarbonCure Technologies founder and CEO. ÃÂÃÂThis investment in CDR signals a broader change for public and private infrastructure projects as industries and governments turn their focus toward the reduction of embodied carbon.ÃÂÃÂ ÃÂÃÂWe are incredibly excited to be one of the first recipients of The Climate Pledge Fund as we join forces to protect and restore Planet Earth and achieve a net zero carbon economy,ÃÂÃÂ said Diego Saez-Gil, Pachama founder and CEO. ÃÂÃÂWe started this company two years ago with the mission of unlocking the full potential that forests and natural ecosystems have to remove carbon dioxide from the atmosphere, a key activity to solve climate change. As the climate crisis becomes a more urgent reality every day, we are thrilled to be able to accelerate our work with the support of Amazon's Climate Pledge Fund."" ÃÂÃÂTo fight climate change, we need to solve the impact products have on the environment. WeÃÂÃÂre honored to be part of the AmazonÃÂÃÂs Climate Pledge Fund and to build the closed-loop supply chain that will recycle batteries, electronics and other end of life products for Amazon,ÃÂÃÂ said JB Straubel, Redwood Materials Co-founder and CEO. ÃÂÃÂAmazonÃÂÃÂs commitment to addressing climate change is perfectly aligned with Rivian's mission. We are proud to be part of The Climate Pledge Fund,ÃÂÃÂ said RJ Scaringe, Rivian founder and CEO. ÃÂÃÂElectric motors consume half the worldÃÂÃÂs electricity, making them one of the largest contributors to climate change,ÃÂÃÂ said Ryan Morris, Turntide Technologies Chairman and CEO. ÃÂÃÂToday, 98% of motors are based on an 1888 design by Nikola Tesla but have been difficult to improve without resorting to expensive materials, including rare earth minerals. Turntide's mission is to replace the worldÃÂÃÂs electric motors with optimal efficiency motor systems, an essential step to help companies decrease their carbon footprint and reach their goal of net zero carbon. We share Amazon's information technology DNA and are excited to have them as partners in tackling climate change."" To learn more about the Climate Pledge Fund, please visit: https://sustainability.aboutamazon.com/about/climate-pledge-fund. About Amazon Amazon is guided by four principles: customer obsession rather than competitor focus, passion for invention, commitment to operational excellence, and long-term thinking. Customer reviews, 1-Click shopping, personalized recommendations, Prime Fulfillment by Amazon, AWS, Kindle Direct Publishing, Kindle, Fire tablets, Fire TV, Amazon Echo, and Alexa are some of the products and services pioneered by Amazon. For more information, visit www.amazon.com/about and follow @AmazonNews.",https://www.businesswire.com/news/home/20200917005481/en/Amazon-Announces-First-Recipients-of-Investments-from-2-Billion-Climate-Pledge-Fund,businesswire.com,5,seattlebusiness wireamazon nasdaqamzn today announced first recipient investment climate pledge fund carboncure technology pachama redwood material rivian turntide technology climate pledge fund dedicated billion venture investment program backing sustainable technology service help amazon company meet climate pledgea commitment netzero carbon climate pledge fund invests visionary company whose product service empower low carbon economy said jeff bezos amazon founder ceo today excited announce investing group company channeling entrepreneurial energy helping amazon company reach net zero keep planet safer future generation climate pledge fund investing company multiple industry including transportation logistics energy generation storage utilization manufacturing material circular economy food agriculture time amazon also look opportunity involve climate pledge signatory venture investment program help find solution help reach net zero carbon climate pledge fund another important example collaborative effort climate pledge accelerate transition net zero world investment scale new technology helping organization speed pace operational emission reduced said christiana figueres un former climate change chief founding partner global optimism wholeeconomy approach tackling climate crisis look together company demonstrate endless possibility clean healthy recovery must create together first five company climate pledge fund investing carboncure technology commercialized portfolio carbon removal technology consume carbon dioxide co concrete production permanently sequestering co enabling reduction cement content mix without impacting concrete performance amazon working lower embodied carbon footprint building using carboncure concrete many new building including hq virginia pachama pachama climate technology company democratizing access naturebased carbon market pachamas technology verifies impact carbon capture world forest allowing organization individual compensate emission confidence supporting reforestation forest conservation project pachama help amazon monitor evaluate naturebased solution including investment made right climate fund redwood material developing commercializing full process suite technology recycling endoflife lithiumion battery ewaste high value metal chemical amazon firm commitment electric delivery electrification infrastructure redwood material help amazon properly recycle electric vehicle ev battery reuse component redwood material also help recycle lithium battery ewaste part amazon business rivian part climate pledge announcement amazon revealed purchased ev rivian plan new electric vehicle road early vehicle road climate pledge fund participated rivians latest investment round july proceeds investment rivian developing integrating connected electric platform amazon last mile delivery network turntide technology turntides motor reduce energy use average optimizing efficiency control without using expensive material rare earth mineral amazon piloting turntides motor number building result far demonstrated significantly reduced electricity usage investment great endorsement carboncure goto carbon dioxide removal cdr solution growing tech construction space overall shift towards low embodied carbon construction material said robert niven carboncure technology founder ceo investment cdr signal broader change public private infrastructure project industry government turn focus toward reduction embodied carbon incredibly excited one first recipient climate pledge fund join force protect restore planet earth achieve net zero carbon economy said diego saezgil pachama founder ceo started company two year ago mission unlocking full potential forest natural ecosystem remove carbon dioxide atmosphere key activity solve climate change climate crisis becomes urgent reality every day thrilled able accelerate work support amazon climate pledge fund fight climate change need solve impact product environment honored part amazon climate pledge fund build closedloop supply chain recycle battery electronics end life product amazon said jb straubel redwood material cofounder ceo amazon commitment addressing climate change perfectly aligned rivians mission proud part climate pledge fund said rj scaringe rivian founder ceo electric motor consume half world electricity making one largest contributor climate change said ryan morris turntide technology chairman ceo today motor based design nikola tesla difficult improve without resorting expensive material including rare earth mineral turntides mission replace world electric motor optimal efficiency motor system essential step help company decrease carbon footprint reach goal net zero carbon share amazon information technology dna excited partner tackling climate change learn climate pledge fund please visit amazon amazon guided four principle customer obsession rather competitor focus passion invention commitment operational excellence longterm thinking customer review click shopping personalized recommendation prime fulfillment amazon aws kindle direct publishing kindle fire tablet fire tv amazon echo alexa product service pioneered amazon information visit follow amazonnews,0.9991,0.49955,0.31482,0.18473,Positive Impact
22/09/2020,151.692,156.70,150.01,156.45,156.45,138976000,2.13,76.34428766,1.192,0,9.3404,0.9034837908,0.2283735172,0.09,260.28,10963.63965,12602.54004,5829.5,4772.839844,3274.302002,37734.07813,16142.90039,158.8184879,121.4656318,155.7705106,129.3997638,162.085923,180.2298841,143.9419619,33.57619714,-2.552951859,-0.788756512,-1.764195347,7.04964338,161.7955429,9684752000,37.87006343,19.54576714,26.86000061,Amazon expands virtual health care for employees throughout Washington state,Amazon Care is just one of the projects that the company is working on in the health-care sector.,https://www.cnbc.com/2020/09/22/amazon-care-employee-virtual-clinic-expands-across-washington-state.html,cnbc.com,9,amazon care one project company working healthcare sector,0.5994,0.53946,0.29275125,0.24670875,Positive Impact
23/09/2020,156.0215,156.35,149.62,149.99,149.99,113054000,2.13,76.34428766,1.192,0,9.3404,0.9034837908,0.2283735172,0.09,260.28,10632.99023,12359.16016,5899.299805,4802.259766,3279.710938,37668.42188,15817.09961,158.7343478,121.7776968,155.5439414,129.6046716,161.2193481,179.9557074,142.4829889,28.27779557,-2.834402544,-1.197885718,-1.636516826,7.303392683,159.2411674,9571698000,20.87103689,23.95809936,28.57999992,Amazon Launches ÃÂÃÂClimate Pledge FriendlyÃÂÃÂ to Make It Easier for Customers to Discover and Shop for Sustainable Products,"SEATTLE--(BUSINESS WIRE)--Amazon (NASDAQ: AMZN) today announced Climate Pledge Friendly, a new program to help make it easy for customers to discover and shop for more sustainable products. Customers will now see the Climate Pledge Friendly label when searching for more than 25,000 products to signify that the products have one or more of 19 different sustainability certifications that help preserve the natural world, such as reducing the carbon footprint of shipments to customers. Climate Pledge Friendly selection includes grocery, household, fashion, beauty, and personal electronics products, as well as items from a range of other categoriesÃÂÃÂfrom brands including Seventh Generation, BurtÃÂÃÂs Bees Baby, and HP Inc. Climate Pledge Friendly products are clearly labeled in shopping results, have additional sustainability information on the product page, and are featured in a dedicated section of our store. Amazon has partnered with trusted third-party certifications, and customers will be able to discover sustainable products that meet sustainability standards that help preserve the natural world. For example, Amazon is partnering with the Cradle to Cradle Products Innovation Institute, a global non-profit dedicated to transforming the safety, health, and sustainability of products. Cradle to Cradle Certified products are safe, sustainable products made to support a circular economy. As part of the Climate Pledge Friendly initiative, Amazon is also announcing Compact by Design, a new externally-validated certification that identifies products which, while they may not always look very different, have a more efficient design. With the removal of excess air and water, products require less packaging and become more efficient to ship. At scale, these small differences in product size and weight lead to significant carbon emission reductions. Seventh Generation offers a Compact by Design-certified super-concentrated laundry detergent that uses 60% less plastic and 50% less water than the standard 100-ounce laundry bottle, enabling significant energy and material savings. If every household in the U.S. were to buy one bottle of Easy Dose ultra-concentrated laundry detergent instead of Seventh Generation's conventional 100-ounce laundry detergent, this would save 220,000 tons of CO2e every year, equivalent to not driving 540 million miles. Mrs. Meyer's multi-surface concentrate is another Climate Pledge Friendly product that has earned the Compact by Design certification. It is a concentrated formula designed to eliminate excess water, with one 32-ounce bottle able to make more than 16 gallons of cleaning solution. Using concentrated cleaning products reduces repeat purchases and enables customers to contribute to carbon emission savings. If all households in the U.S. purchased concentrated cleaners like Mrs. MeyerÃÂÃÂs multi-surface concentrate instead of non-concentrated cleaners, it would result in savings of 200,000 metric tons of customer CO2eÃÂÃÂequivalent to the emissions of 500 million miles driven per year. ÃÂÃÂClimate Pledge Friendly is a simple way for customers to discover more sustainable products that help preserve the natural world,ÃÂÃÂ said Jeff Bezos, Amazon founder and CEO. ÃÂÃÂWith 18 external certification programs and our own Compact by Design certification, weÃÂÃÂre incentivizing selling partners to create sustainable products that help protect the planet for future generations.ÃÂÃÂ ÃÂÃÂCradle to Cradle certification provides a framework for product optimization based on the principles of designing with safe and healthy materials, using clean renewable energy and water, celebrating diversity, and eliminating the concept of waste,ÃÂÃÂ said William McDonough, co-founder of the Cradle to Cradle Products Innovation Institute. ÃÂÃÂWe love that Amazon is making it simple for customers to find sustainable products. AmazonÃÂÃÂs new program will expand our reach and enable us to empower more brands to deliver safer and more sustainable products for the circular economy.ÃÂÃÂ ÃÂÃÂIn line with our mission to make sustainable living commonplace, we are delighted to partner with Amazon on its Climate Pledge Friendly initiative,ÃÂÃÂ said Fabian Garcia, President of Unilever North America, makers of Seventh Generation, Love Beauty Planet, and Dove, among other brands available through the program. ÃÂÃÂAmazonÃÂÃÂs initiative will drive scale and impact for more sustainable consumption by helping customers easily discover products that are Climate Pledge Friendly and encourage the manufacturers to make their products more sustainable. Unilever is committed to delivering products that provide the best experience for consumers while reducing the impact that our products and our operations have on the environment.ÃÂÃÂ The Climate Pledge Friendly initiative supports AmazonÃÂÃÂs commitment to reach the Paris Agreement ten years early and be net zero carbon by 2040. The company has already committed to reaching 100% renewable energy by 2025, ordered over 100,000 fully-electric delivery vehicles, and plans to invest $100 million in reforestation projects around the world. Amazon also launched the Climate Pledge Fund, a $2 billion fund to back visionary companies whose products and services will facilitate the transition to a low carbon economy. Building on these actions, Amazon will now make it easier for customers to access product choices that align with our commitment to a more sustainable future. For detailed information on the program qualification criteria and to start shopping for these products visit www.amazon.com/ClimatePledgeFriendly or look for the Climate Pledge Friendly badge on qualifying products. About Amazon Amazon is guided by four principles: customer obsession rather than competitor focus, passion for invention, commitment to operational excellence, and long-term thinking. Customer reviews, 1-Click shopping, personalized recommendations, Prime Fulfillment by Amazon, AWS, Kindle Direct Publishing, Kindle, Fire tablets, Fire TV, Amazon Echo, and Alexa are some of the products and services pioneered by Amazon. For more information, visit www.amazon.com/about and follow @AmazonNews.",https://www.businesswire.com/news/home/20200923005297/en/Amazon-Launches-%E2%80%98Climate-Pledge-Friendly%E2%80%99-to-Make-It-Easier-for-Customers-to-Discover-and-Shop-for-Sustainable-Products,businesswire.com,5,seattlebusiness wireamazon nasdaq amzn today announced climate pledge friendly new program help make easy customer discover shop sustainable product customer see climate pledge friendly label searching product signify product one different sustainability certification help preserve natural world reducing carbon footprint shipment customer climate pledge friendly selection includes grocery household fashion beauty personal electronics product well item range categoriesfrom brand including seventh generation burt bee baby hp inc climate pledge friendly product clearly labeled shopping result additional sustainability information product page featured dedicated section store amazon partnered trusted thirdparty certification customer able discover sustainable product meet sustainability standard help preserve natural world example amazon partnering cradle cradle product innovation institute global nonprofit dedicated transforming safety health sustainability product cradle cradle certified product safe sustainable product made support circular economy part climate pledge friendly initiative amazon also announcing compact design new externallyvalidated certification identifies product may always look different efficient design removal excess air water product require less packaging become efficient ship scale small difference product size weight lead significant carbon emission reduction seventh generation offer compact designcertified superconcentrated laundry detergent us less plastic less water standard ounce laundry bottle enabling significant energy material saving every household u buy one bottle easy dose ultraconcentrated laundry detergent instead seventh generation conventional ounce laundry detergent would save ton coe every year equivalent driving million mile mr meyers multisurface concentrate another climate pledge friendly product earned compact design certification concentrated formula designed eliminate excess water one ounce bottle able make gallon cleaning solution using concentrated cleaning product reduces repeat purchase enables customer contribute carbon emission saving household u purchased concentrated cleaner like mr meyers multisurface concentrate instead nonconcentrated cleaner would result saving metric ton customer coeequivalent emission million mile driven per year climate pledge friendly simple way customer discover sustainable product help preserve natural world said jeff bezos amazon founder ceo external certification program compact design certification incentivizing selling partner create sustainable product help protect planet future generation cradle cradle certification provides framework product optimization based principle designing safe healthy material using clean renewable energy water celebrating diversity eliminating concept waste said william mcdonough cofounder cradle cradle product innovation institute love amazon making simple customer find sustainable product amazon new program expand reach enable u empower brand deliver safer sustainable product circular economy line mission make sustainable living commonplace delighted partner amazon climate pledge friendly initiative said fabian garcia president unilever north america maker seventh generation love beauty planet dove among brand available program amazon initiative drive scale impact sustainable consumption helping customer easily discover product climate pledge friendly encourage manufacturer make product sustainable unilever committed delivering product provide best experience consumer reducing impact product operation environment climate pledge friendly initiative support amazon commitment reach paris agreement ten year early net zero carbon company already committed reaching renewable energy ordered fullyelectric delivery vehicle plan invest million reforestation project around world amazon also launched climate pledge fund billion fund back visionary company whose product service facilitate transition low carbon economy building action amazon make easier customer access product choice align commitment sustainable future detailed information program qualification criterion start shopping product visit look climate pledge friendly badge qualifying product amazon amazon guided four principle customer obsession rather competitor focus passion invention commitment operational excellence longterm thinking customer review click shopping personalized recommendation prime fulfillment amazon aws kindle direct publishing kindle fire tablet fire tv amazon echo alexa product service pioneered amazon information visit follow amazonnews,0.9996,0.4998,0.486175,0.013625,Positive Impact
24/09/2020,148.8895,153.47,148.25,150.99,150.99,110588000,2.13,76.34428766,1.192,0,9.3404,0.9034837908,0.2283735172,0.09,260.28,10672.26953,12365.54004,5822.799805,4762.620117,3223.176025,36553.60156,15912.2998,158.7452679,122.0952668,155.3653359,129.817456,160.1641983,178.6980963,141.6303003,33.88051326,-2.943118121,-1.546932199,-1.396185922,6.85999952,157.0444044,9682286000,29.14593802,29.29567945,28.51000023,"Best Buy, McKinstry, Real Betis, Schneider Electric en Siemens ondertekenen The Climate Pledge","SEATTLE--(BUSINESS WIRE)--Vandaag hebben Amazon (NASDAQ: AMZN) en Global Optimism aangekondigd dat Best Buy, McKinstry, Real Betis, Schneider Electric en Siemens zich hebben aangesloten bij de Climate Pledge, een toezegging netto koolstofuitstoot tegen 2040 te producerenÃÂÃÂ een decennium eerder van de doelstelling van het Akkoord van Parijs voor 2050. Deze bekendmaking is officieel geldend in de originele brontaal. Vertalingen zijn slechts als leeshulp bedoeld en moeten worden vergeleken met de tekst in de brontaal, die als enige rechtsgeldig is.",https://www.businesswire.com/news/home/20200924005716/nl/,businesswire.com,5,seattlebusiness wirevandaag hebben amazon nasdaq amzn en global optimism aangekondigd dat best buy mckinstry real betis schneider electric en siemens zich hebben aangesloten bij de climate pledge een toezegging netto koolstofuitstoot tegen te produceren een decennium eerder van de doelstelling van het akkoord van parijs voor deze bekendmaking officieel geldend de originele brontaal vertalingen zijn slechts al leeshulp bedoeld en moeten worden vergeleken met de tekst de brontaal die al enige rechtsgeldig,0.6705,0.33525,0.4526192308,-0.117369231,Negative Impact
25/09/2020,152.743,155.08,149.95,154.76,154.76,92304000,2.13,76.34428766,1.192,0,9.3404,0.9034837908,0.2283735172,0.09,260.28,10913.55957,12485.37988,5842.700195,4729.660156,3219.417969,37388.66016,16065.40039,158.840498,122.4342468,155.34146,130.0656057,159.4020233,177.4809877,141.323059,40.78184575,-2.694253047,-1.776396368,-0.917856678,6.260607038,156.3500061,9774590000,46.80196046,32.27297846,26.37999916,"Best Buy, McKinstry, Real Betis, Schneider Electric und Siemens unterzeichnen das Klimaversprechen","SEATTLE--(BUSINESS WIRE)--Heute gaben Amazon (NASDAQ: AMZN) und Global Optimism bekannt, dass Best Buy, McKinstry, Real Betis, Schneider Electric und Siemens dem Klimaversprechenbeigetreten sind, einer Verpflichtung, bis 2040 netto null Kohlenstoff zu erreichen, ein Jahrzehnt vor dem Ziel des ÃÂÃÂbereinkommens von Paris von 2050. Diese neuen Unterzeichner des Klimaversprechens stimmen zu: Treibhausgasemissionen regelmÃÂÃÂ¤ÃÂÃÂig zu messen und darÃÂÃÂ¼ber zu berichten; Dekarbonisierungsstrategien im Einklang mit dem Pariser Abkommen durch echte geschÃÂÃÂ¤ftliche VerÃÂÃÂ¤nderungen und Innovationen umzusetzen, einschlieÃÂÃÂlich Effizienzsteigerungen, erneuerbarer Energien, Materialreduzierungen und anderer Strategien zur Beseitigung von Kohlenstoffemissionen; alle verbleibenden Emissionen durch zusÃÂÃÂ¤tzliche, quantifizierbare, reale, dauerhafte und sozial nÃÂÃÂ¼tzliche AusgleichsmaÃÂÃÂnahmen zu neutralisieren, um bis 2040 einen jÃÂÃÂ¤hrlichen Netto-KohlenstoffausstoÃÂÃÂ von Null zu erreichen. ÃÂÃÂVon WirbelstÃÂÃÂ¼rmen bis zu WaldbrÃÂÃÂ¤nden, der Klimawandel fÃÂÃÂ¼hrt zu sehr realen, negativen Auswirkungen auf unser tÃÂÃÂ¤gliches Leben, und zwar noch frÃÂÃÂ¼her als von Wissenschaftlern erwartet. Jedes Unternehmen hat bei der BekÃÂÃÂ¤mpfung des Klimawandels eine Rolle zu spielen. Wir begrÃÂÃÂ¼ÃÂÃÂen daher diese neuen Unterzeichner des Klimaversprechens, die sich verstÃÂÃÂ¤rkt dazu verpflichten, bis 2040 einen Netto-KohlenstoffausstoÃÂÃÂ von Null zu erreichenÃÂÃÂ, sagte Jeff Bezos, GrÃÂÃÂ¼nder und CEO von Amazon. ÃÂÃÂSie zeigen eine wichtige FÃÂÃÂ¼hrungsrolle bei der Beschleunigung des ÃÂÃÂbergangs zu einer kohlenstoffarmen Wirtschaft, um den Planeten fÃÂÃÂ¼r kÃÂÃÂ¼nftige Generationen zu schÃÂÃÂ¼tzen.ÃÂÃÂ Um einen Netto-Kohlenstoff-FuÃÂÃÂabdruck von Null zu erreichen, wird Best Buy weiterhin seine Emissionen messen, verwalten und dekarbonisieren, die Energieeffizienz seiner Betriebe erhÃÂÃÂ¶hen und in Kohlenstoffausgleichsprojekte investieren. Seit 2009 hat das Unternehmen seine Kohlendioxidemissionen durch Investitionen in LED-Beleuchtung, Steuerungssysteme und Hybridfahrzeuge um 56 % reduziert. Das Unternehmen hat auch Investitionen in die Solarerzeugung im Versorgungsbereich getÃÂÃÂ¤tigt, wie etwa in das ÃÂÃÂBest BuyÃÂÃÂ-Solarfeld, das jedes Jahr 260 ÃÂÃÂBest BuyÃÂÃÂ-LÃÂÃÂ¤den mit Strom versorgt. Durch sein zuvor festgelegtes, auf wissenschaftlichen Erkenntnissen basierendes Ziel will das Unternehmen die Emissionen in seinem Betrieb um 75 % senken und Kunden helfen, die Produktemissionen um 20 % zu reduzieren, wodurch das Unternehmen bis 2030 5 Milliarden USD an Versorgungskosten einsparen will. Und mit Blick auf die Zukunft und die ErfÃÂÃÂ¼llung der Anforderungen des Klimaversprechens von 2040 kÃÂÃÂ¶nnen die Schwerpunktbereiche von Best Buy mÃÂÃÂ¶glicherweise die Flotten-Elektrifizierung, Energieeffizienz, Investitionen in erneuerbare Energien und die Entwicklung von Klimaschutzprojekten umfassen. ÃÂÃÂWir sind ein zielstrebiges, werteorientiertes Unternehmen mit einer langen Geschichte der Umweltarbeit, zu der auch die sinnvolle Reduzierung unseres Kohlenstoff-FuÃÂÃÂabdrucks und die UnterstÃÂÃÂ¼tzung unserer Kunden gehÃÂÃÂ¶rtÃÂÃÂ, sagte Corie Barry, CEO von Best Buy. ÃÂÃÂWir sind stolz darauf, den nÃÂÃÂ¤chsten Schritt zu tun, indem wir uns zur Einhaltung des Klimaversprechens verpflichten. Einfach ausgedrÃÂÃÂ¼ckt, unsere Kunden und Mitarbeiter erwarten dieses MaÃÂÃÂ an Engagement von uns, und der Planet verlangt es.ÃÂÃÂ McKinstry, ein US-amerikanisches Ingenieur-, Bau- und Energiedienstleistungsunternehmen, hat einen dreigliedrigen Plan. McKinstry wird seine Netto-Treibhausgasemissionen bis 2025 um 50 % reduzieren und bis 2030 einen Netto-KohlenstoffausstoÃÂÃÂ von Null erreichen. McKinstry wird seine Wirkung und seinen Einfluss nutzen, um Gemeindeorganisationen zu unterstÃÂÃÂ¼tzen, die fÃÂÃÂ¼hrende AnsÃÂÃÂ¤tze zur Erhaltung des Planeten verfolgen. McKinstry wird auch mit GebÃÂÃÂ¤udeeigentÃÂÃÂ¼mern und -betreibern zusammenarbeiten, um mehr GebÃÂÃÂ¤ude zu errichten, die einen kohlenstofffreien, energieteilenden, hocheffizienten Betrieb und eine optimale Interaktion zwischen GebÃÂÃÂ¤ude und Netz anstreben. Dies fÃÂÃÂ¼hrt zu einem Nutzerverhalten, das dazu beitrÃÂÃÂ¤gt, GebÃÂÃÂ¤ude von blinden Energieverbrauchern in wertvolle Anlagen zu verwandeln, die dem Netz dienen. ÃÂÃÂGebÃÂÃÂ¤ude sind fÃÂÃÂ¼r 40 % des Energieverbrauchs in den USA und fÃÂÃÂ¼r 36 % des Energieverbrauchs weltweit verantwortlichÃÂÃÂ, sagte Dean Allen, CEO von McKinstry. ÃÂÃÂAufkommende, komplexe GebÃÂÃÂ¤udetechnologien erschlieÃÂÃÂen das Potenzial, die Kohlenstoffemissionen radikal zu reduzieren und GebÃÂÃÂ¤ude mit erstaunlicher Effizienz zu betreiben. Um diese Technologien einzusetzen und den globalen GebÃÂÃÂ¤udebestand zu dekarbonisieren und die Energieeffizienz drastisch zu verbessern, ist eine branchenÃÂÃÂ¼bergreifende Zusammenarbeit erforderlich. In Zusammenarbeit mit anderen Unternehmen des Klimaversprechens glaube ich, dass wir dieses Ziel erreichen und echte, dauerhafte VerÃÂÃÂ¤nderungen vorantreiben kÃÂÃÂ¶nnen.ÃÂÃÂ Real Betis, ein Profi-FuÃÂÃÂballverein mit Sitz in Sevilla, Spanien, hat seinen Kohlenstoff-FuÃÂÃÂabdruck gemessen und setzt PlÃÂÃÂ¤ne zur Reduzierung seiner Emissionen um, wÃÂÃÂ¤hrend er gleichzeitig Kohlenstoffausgleiche aus zertifizierten Klimaschutzprojekten erwirbt. In dem Bestreben, seine Kohlendioxidemissionen zu reduzieren, richtet der Klub ein ÃÂÃÂintelligentes BeleuchtungssystemÃÂÃÂ in seinem 60.000 Zuschauer fassenden Stadion Estadio Benito VillamarÃÂÃÂ­n ein und versucht, seine AbhÃÂÃÂ¤ngigkeit von Einweg-Kunststoff zu verringern. Ein weiteres Ziel ist es, seinen Fans als Vorbild zu dienen: FÃÂÃÂ¼r die kommende Saison entwickelt Real Betis eine Liste nachhaltiger Initiativen, die den Fans helfen sollen, ihre Kohlendioxidemissionen zu reduzieren. ÃÂÃÂBei Real Betis setzen wir uns fÃÂÃÂ¼r die BekÃÂÃÂ¤mpfung des Klimawandels einÃÂÃÂ, sagte RamÃÂÃÂ³n AlarcÃÂÃÂ³n, General Business Director bei Real Betis. ÃÂÃÂWir tragen auch dazu bei, das Bewusstsein fÃÂÃÂ¼r die BewÃÂÃÂ¤ltigung der Klimakrise zu schÃÂÃÂ¤rfen, indem wir mit unseren Spielern und Fans zusammenarbeiten. Wir sind uns bewusst, dass der Klimawandel eine Bedrohung fÃÂÃÂ¼r die Lebensgrundlagen und das Wohlergehen aller Menschen auf dem Planeten darstellt, und wir sind entschlossen, unseren Teil dazu beizutragen. Wir freuen uns sehr, der erste FuÃÂÃÂballklub der Welt zu sein, der sich diesem Programm anschlieÃÂÃÂt, und wir kÃÂÃÂ¶nnen es kaum erwarten, mit den Unternehmen des Klimaversprechens zusammenzuarbeiten, um unsere Anstrengungen zu verstÃÂÃÂ¤rken.ÃÂÃÂ Der Kampf gegen den Klimawandel steht seit langem im Mittelpunkt des Strategie- und Innovationsleitplans von Schneider Electric, weit vor der BefÃÂÃÂ¼rwortung des Kohlenstoffversprechens auf der COP 21. FÃÂÃÂ¼r die Klimawoche 2020 beschleunigt Schneider Electric seine eigenen Verpflichtungen zur KlimaneutralitÃÂÃÂ¤t und bekrÃÂÃÂ¤ftigt, dass das Unternehmen bis 2025 kohlenstoffneutral arbeiten und bis 2030 Netto- Emissionen (ohne Ausgleich) von Null haben wird. DarÃÂÃÂ¼ber hinaus verspricht das Unternehmen, dass alle seine Produkte bis 2040 klimaneutral sein werden, mit vollstÃÂÃÂ¤ndiger End-to-End-NeutralitÃÂÃÂ¤t, und dass es bis 2050 ÃÂÃÂ¼ber eine Netto-Lieferkette von Null verfÃÂÃÂ¼gen wird. Schneiders Firmenversprechen gehÃÂÃÂ¶rte zu den ersten +1,5-Grad-Celsius-LeitplÃÂÃÂ¤nen, die von der Science Based Targets Initiative (SBTi) genehmigt wurden. ÃÂÃÂNachhaltigkeit steht im Mittelpunkt all unserer AktivitÃÂÃÂ¤ten bei Schneider, und digitale Innovation ist entscheidend, um die Herausforderung des Klimawandels zu bewÃÂÃÂ¤ltigenÃÂÃÂ, sagte Jean-Pascal Tricoire, Vorsitzender und CEO von Schneider Electric. ÃÂÃÂWir werden schneller auf dem Weg zu einer nachhaltigen und integrativen Welt vorankommen, wenn wir gemeinsam voranschreiten. Aus diesem Grund haben wir uns dem Klimaversprechen angeschlossen, um KlimaneutralitÃÂÃÂ¤t zu erreichen.ÃÂÃÂ Das Ziel von Siemens ist klar: Alle Produktionsanlagen und GebÃÂÃÂ¤ude weltweit sollen bis 2030 einen Netto-Kohlenstoff-FuÃÂÃÂabdruck von Null erreichen. Um dieses Ziel zu erreichen, konzentriert sich Siemens auf vier Hebel: grÃÂÃÂ¼ne Energiebeschaffung, Verbesserung der Energieeffizienz, dezentrale Energiesysteme (z. B. Photovoltaik auf FabrikdÃÂÃÂ¤chern) und die Elektrifizierung seiner Autoflotte. DarÃÂÃÂ¼ber hinaus hat Siemens ein neues VergÃÂÃÂ¼tungssystem fÃÂÃÂ¼r den Vorstand initiiert, das auch an Nachhaltigkeitsziele wie etwa CO2-Emissionsreduktionsziele gekoppelt ist. ÃÂÃÂDer Klimawandel ist eine der grÃÂÃÂ¶ÃÂÃÂten Herausforderungen der Menschheit in unserer Zeit. Unternehmen mÃÂÃÂ¼ssen den Weg zu einer beschleunigten Dekarbonisierung anfÃÂÃÂ¼hren. Im September 2015 hat sich Siemens als erstes globales Industrieunternehmen dazu verpflichtet, bis 2030 KlimaneutralitÃÂÃÂ¤t fÃÂÃÂ¼r unsere weltweiten AktivitÃÂÃÂ¤ten zu erreichen. Heute unterstreichen wir erneut unser Engagement fÃÂÃÂ¼r dieses Ziel und freuen uns darauf, gemeinsam mit anderen Unternehmen des Klimaversprechens die globalen Anstrengungen zu beschleunigenÃÂÃÂ, sagte Joe Kaeser, Vorstandsvorsitzender der Siemens AG. ÃÂÃÂDas Pariser Abkommen legte einen fÃÂÃÂ¼r alle LÃÂÃÂ¤nder und alle Menschen einheitlichen Fahrplan zur BewÃÂÃÂ¤ltigung der Klimakrise in Form von MaÃÂÃÂnahmen fest. Der IPCC hat uns darÃÂÃÂ¼ber informiert, dass wir den Planeten nicht ÃÂÃÂ¼ber 1,5 Grad Celsius hinaus erwÃÂÃÂ¤rmen kÃÂÃÂ¶nnen und dass es umso besser ist, je schneller wir Netto-Emissionen von Null erreichenÃÂÃÂ, sagte Christiana Figueres, die ehemalige UN-Chefin fÃÂÃÂ¼r Klimawandel und GrÃÂÃÂ¼ndungspartnerin von Global Optimism. ÃÂÃÂMit dem Beitritt zum Klimaversprechen geben die Unterzeichner nicht nur eine ErklÃÂÃÂ¤rung ab, in der sie sich fÃÂÃÂ¼r die Zukunft verpflichten, sondern sie legen den Grundstein fÃÂÃÂ¼r bedeutende Aktionen und Investitionen, die ArbeitsplÃÂÃÂ¤tze schaffen, Innovationen anregen, die natÃÂÃÂ¼rliche Umwelt regenerieren und den Verbrauchern helfen, ab sofort besser einzukaufen. So sieht FÃÂÃÂ¼hrung bei der Neuausrichtung der Weltwirtschaft aus.ÃÂÃÂ Letztes Jahr grÃÂÃÂ¼ndeten Amazon und Global Optimism gemeinsam The Climate Pledge, eine Verpflichtung, das Pariser Abkommen 10 ahre frÃÂÃÂ¼her zu erreichen und bis 2040 netto kohlenstofffrei zu sein. Elf Organisationen haben nun das Klimaversprechen unterzeichnet, darunter: Amazon, Best Buy, Infosys, McKinstry, Mercedes-Benz, Oak die View Group, Real Betis, Reckitt Benckiser (RB), Schneider Electric, Siemens und Verizon. Dies ist ein wichtiges Signal, dass die Nachfrage nach Produkten und Dienstleistungen, die zur Reduzierung von Kohlenstoffemissionen beitragen, rasch steigen wird. FÃÂÃÂ¼r weitere Informationen besuchen Sie www.theclimatepledge.com. ÃÂÃÂber Amazon Amazon orientiert sich an vier GrundsÃÂÃÂ¤tzen: Orientierung am Kunden statt an der Konkurrenz, Leidenschaft fÃÂÃÂ¼r Neuerungen, Einsatz fÃÂÃÂ¼r betriebliche Optimierung sowie langfristiges Denken. Kundenrezensionen, 1-Klick-EinkÃÂÃÂ¤ufe, persÃÂÃÂ¶nliche Empfehlungen, Prime, Versand durch Amazon, AWS, Kindle Direct Publishing, Kindle, Fire-Tablets, Fire TV, Amazon Echo und Alexa sind nur einige der von Amazon angebotenen Produkte und Dienstleistungen. Weitere Informationen finden Sie unter www.amazon.com/about. ÃÂÃÂber Global Optimism Global Optimism existiert, um transformatorische, branchenweite VerÃÂÃÂ¤nderungen herbeizufÃÂÃÂ¼hren. Das Erreichen einer emissionsfreien Zukunft ist keine weit in der Ferne liegende Herausforderung. Es ist eine, die wir jetzt in Angriff nehmen mÃÂÃÂ¼ssen. Jede wissenschaftliche Bewertung zeigt, dass wir unsere Emissionen zwischen 2020 und 2030 halbieren mÃÂÃÂ¼ssen, um das Ziel von Netto-Emissionen von Null bis 2050 zu erreichen und die globale ErwÃÂÃÂ¤rmung unter 1,5 Grad Celsius zu halten. Die BewÃÂÃÂ¤ltigung der Klimakrise ist nur mÃÂÃÂ¶glich, wenn alle ÃÂÃÂ¼berall ihren Beitrag leisten. Wir arbeiten mit gleichgesinnten Kollektiven aus allen Branchen zusammen, die bereit sind, in die erforderlichen Entscheidungen zu investieren, um sich auf diese herausfordernde und lebensbejahende Reise zu begeben. Weitere Informationen finden Sie unter https://globaloptimism.com/. Die Ausgangssprache, in der der Originaltext verÃÂÃÂ¶ffentlicht wird, ist die offizielle und autorisierte Version. ÃÂÃÂbersetzungen werden zur besseren VerstÃÂÃÂ¤ndigung mitgeliefert. Nur die Sprachversion, die im Original verÃÂÃÂ¶ffentlicht wurde, ist rechtsgÃÂÃÂ¼ltig. Gleichen Sie deshalb ÃÂÃÂbersetzungen mit der originalen Sprachversion der VerÃÂÃÂ¶ffentlichung ab.",https://www.businesswire.com/news/home/20200925005544/de/,businesswire.com,5,seattlebusiness wireheute gaben amazon nasdaq amzn und global optimism bekannt das best buy mckinstry real betis schneider electric und siemens dem klimaversprechenbeigetreten sind einer verpflichtung bi netto null kohlenstoff zu erreichen ein jahrzehnt vor dem ziel de bereinkommens von paris von diese neuen unterzeichner de klimaversprechens stimmen zu treibhausgasemissionen regelmig zu messen und darber zu berichten dekarbonisierungsstrategien im einklang mit dem pariser abkommen durch echte geschftliche vernderungen und innovationen umzusetzen einschlielich effizienzsteigerungen erneuerbarer energien materialreduzierungen und anderer strategien zur beseitigung von kohlenstoffemissionen alle verbleibenden emissionen durch zustzliche quantifizierbare reale dauerhafte und sozial ntzliche ausgleichsmanahmen zu neutralisieren um bi einen jhrlichen nettokohlenstoffaussto von null zu erreichen von wirbelstrmen bi zu waldbrnden der klimawandel fhrt zu sehr realen negativen auswirkungen auf unser tgliches leben und zwar noch frher al von wissenschaftlern erwartet jedes unternehmen hat bei der bekmpfung de klimawandels eine rolle zu spielen wir begren daher diese neuen unterzeichner de klimaversprechens die sich verstrkt dazu verpflichten bi einen nettokohlenstoffaussto von null zu erreichen sagte jeff bezos grnder und ceo von amazon sie zeigen eine wichtige fhrungsrolle bei der beschleunigung de bergangs zu einer kohlenstoffarmen wirtschaft um den planeten fr knftige generationen zu schtzen um einen nettokohlenstofffuabdruck von null zu erreichen wird best buy weiterhin seine emissionen messen verwalten und dekarbonisieren die energieeffizienz seiner betriebe erhhen und kohlenstoffausgleichsprojekte investieren seit hat da unternehmen seine kohlendioxidemissionen durch investitionen ledbeleuchtung steuerungssysteme und hybridfahrzeuge um reduziert da unternehmen hat auch investitionen die solarerzeugung im versorgungsbereich gettigt wie etwa da best buysolarfeld da jedes jahr best buylden mit strom versorgt durch sein zuvor festgelegtes auf wissenschaftlichen erkenntnissen basierendes ziel da unternehmen die emissionen seinem betrieb um senken und kunden helfen die produktemissionen um zu reduzieren wodurch da unternehmen bi milliarden usd versorgungskosten einsparen und mit blick auf die zukunft und die erfllung der anforderungen de klimaversprechens von knnen die schwerpunktbereiche von best buy mglicherweise die flottenelektrifizierung energieeffizienz investitionen erneuerbare energien und die entwicklung von klimaschutzprojekten umfassen wir sind ein zielstrebiges werteorientiertes unternehmen mit einer langen geschichte der umweltarbeit zu der auch die sinnvolle reduzierung unseres kohlenstofffuabdrucks und die untersttzung unserer kunden gehrt sagte corie barry ceo von best buy wir sind stolz darauf den nchsten schritt zu tun indem wir un zur einhaltung de klimaversprechens verpflichten einfach ausgedrckt unsere kunden und mitarbeiter erwarten diesis engagement von un und der planet verlangt e mckinstry ein usamerikanisches ingenieur bau und energiedienstleistungsunternehmen hat einen dreigliedrigen plan mckinstry wird seine nettotreibhausgasemissionen bi um reduzieren und bi einen nettokohlenstoffaussto von null erreichen mckinstry wird seine wirkung und seinen einfluss nutzen um gemeindeorganisationen zu untersttzen die fhrende anstze zur erhaltung de planeten verfolgen mckinstry wird auch mit gebudeeigentmern und betreibern zusammenarbeiten um mehr gebude zu errichten die einen kohlenstofffreien energieteilenden hocheffizienten betrieb und eine optimale interaktion zwischen gebude und netz anstreben dy fhrt zu einem nutzerverhalten da dazu beitrgt gebude von blinden energieverbrauchern wertvolle anlage zu verwandeln die dem netz dienen gebude sind fr de energieverbrauchs den usa und fr de energieverbrauchs weltweit verantwortlich sagte dean allen ceo von mckinstry aufkommende komplexe gebudetechnologien erschlieen da potenzial die kohlenstoffemissionen radikal zu reduzieren und gebude mit erstaunlicher effizienz zu betreiben um diese technologien einzusetzen und den globalen gebudebestand zu dekarbonisieren und die energieeffizienz drastisch zu verbessern ist eine branchenbergreifende zusammenarbeit erforderlich zusammenarbeit mit anderen unternehmen de klimaversprechens glaube ich das wir diesis ziel erreichen und echte dauerhafte vernderungen vorantreiben knnen real betis ein profifuballverein mit sitz sevilla spanien hat seinen kohlenstofffuabdruck gemessen und setzt plne zur reduzierung seiner emissionen um whrend er gleichzeitig kohlenstoffausgleiche au zertifizierten klimaschutzprojekten erwirbt dem bestreben seine kohlendioxidemissionen zu reduzieren richtet der klub ein intelligentes beleuchtungssystem seinem zuschauer fassenden stadion estadio benito villamarn ein und versucht seine abhngigkeit von einwegkunststoff zu verringern ein weiteres ziel ist e seinen fan al vorbild zu dienen fr die kommende saison entwickelt real betis eine liste nachhaltiger initiativen die den fan helfen sollen ihre kohlendioxidemissionen zu reduzieren bei real betis setzen wir un fr die bekmpfung de klimawandels ein sagte ramn alarcn general business director bei real betis wir tragen auch dazu bei da bewusstsein fr die bewltigung der klimakrise zu schrfen indem wir mit unseren spielern und fan zusammenarbeiten wir sind un bewusst das der klimawandel eine bedrohung fr die lebensgrundlagen und da wohlergehen aller menschen auf dem planeten darstellt und wir sind entschlossen unseren teil dazu beizutragen wir freuen un sehr der erste fuballklub der welt zu sein der sich diesem programm anschliet und wir knnen e kaum erwarten mit den unternehmen de klimaversprechens zusammenzuarbeiten um unsere anstrengungen zu verstrken der kampf gegen den klimawandel steht seit langem im mittelpunkt de strategie und innovationsleitplans von schneider electric weit vor der befrwortung de kohlenstoffversprechens auf der cop fr die klimawoche beschleunigt schneider electric seine eigenen verpflichtungen zur klimaneutralitt und bekrftigt das da unternehmen bi kohlenstoffneutral arbeiten und bi netto emissionen ohne ausgleich von null haben wird darber hinaus verspricht da unternehmen das alle seine produkte bi klimaneutral sein werden mit vollstndiger endtoendneutralitt und das e bi ber eine nettolieferkette von null verfgen wird schneiders firmenversprechen gehrte zu den ersten gradcelsiusleitplnen die von der science based target initiative sbti genehmigt wurden nachhaltigkeit steht im mittelpunkt unserer aktivitten bei schneider und digitale innovation ist entscheidend um die herausforderung de klimawandels zu bewltigen sagte jeanpascal tricoire vorsitzender und ceo von schneider electric wir werden schneller auf dem weg zu einer nachhaltigen und integrativen welt vorankommen wenn wir gemeinsam voranschreiten au diesem grund haben wir un dem klimaversprechen angeschlossen um klimaneutralitt zu erreichen da ziel von siemens ist klar alle produktionsanlagen und gebude weltweit sollen bi einen nettokohlenstofffuabdruck von null erreichen um diesis ziel zu erreichen konzentriert sich siemens auf vier hebel grne energiebeschaffung verbesserung der energieeffizienz dezentrale energiesysteme z b photovoltaik auf fabrikdchern und die elektrifizierung seiner autoflotte darber hinaus hat siemens ein neues vergtungssystem fr den vorstand initiiert da auch nachhaltigkeitsziele wie etwa coemissionsreduktionsziele gekoppelt ist der klimawandel ist eine der grten herausforderungen der menschheit unserer zeit unternehmen mssen den weg zu einer beschleunigten dekarbonisierung anfhren im september hat sich siemens al erstes globales industrieunternehmen dazu verpflichtet bi klimaneutralitt fr unsere weltweiten aktivitten zu erreichen heute unterstreichen wir erneut unser engagement fr diesis ziel und freuen un darauf gemeinsam mit anderen unternehmen de klimaversprechens die globalen anstrengungen zu beschleunigen sagte joe kaeser vorstandsvorsitzender der siemens ag da pariser abkommen legte einen fr alle lnder und alle menschen einheitlichen fahrplan zur bewltigung der klimakrise form von manahmen fest der ipcc hat un darber informiert das wir den planeten nicht ber grad celsius hinaus erwrmen knnen und das e umso besser ist je schneller wir nettoemissionen von null erreichen sagte christiana figueres die ehemalige unchefin fr klimawandel und grndungspartnerin von global optimism mit dem beitritt zum klimaversprechen geben die unterzeichner nicht nur eine erklrung ab der sie sich fr die zukunft verpflichten sondern sie legen den grundstein fr bedeutende aktionen und investitionen die arbeitspltze schaffen innovationen anregen die natrliche umwelt regenerieren und den verbrauchern helfen ab sofort besser einzukaufen sieht fhrung bei der neuausrichtung der weltwirtschaft au letztes jahr grndeten amazon und global optimism gemeinsam climate pledge eine verpflichtung da pariser abkommen ahre frher zu erreichen und bi netto kohlenstofffrei zu sein elf organisationen haben nun da klimaversprechen unterzeichnet darunter amazon best buy infosys mckinstry mercedesbenz oak die view group real betis reckitt benckiser rb schneider electric siemens und verizon dy ist ein wichtiges signal das die nachfrage nach produkten und dienstleistungen die zur reduzierung von kohlenstoffemissionen beitragen rasch steigen wird fr weitere informationen besuchen sie ber amazon amazon orientiert sich vier grundstzen orientierung kunden statt der konkurrenz leidenschaft fr neuerungen einsatz fr betriebliche optimierung sowie langfristiges denken kundenrezensionen klickeinkufe persnliche empfehlungen prime versand durch amazon aws kindle direct publishing kindle firetablets fire tv amazon echo und alexa sind nur einige der von amazon angebotenen produkte und dienstleistungen weitere informationen finden sie unter ber global optimism global optimism existiert um transformatorische branchenweite vernderungen herbeizufhren da erreichen einer emissionsfreien zukunft ist keine weit der ferne liegende herausforderung e ist eine die wir jetzt angriff nehmen mssen jede wissenschaftliche bewertung zeigt das wir unsere emissionen zwischen und halbieren mssen um da ziel von nettoemissionen von null bi zu erreichen und die globale erwrmung unter grad celsius zu halten die bewltigung der klimakrise ist nur mglich wenn alle berall ihren beitrag leisten wir arbeiten mit gleichgesinnten kollektiven au allen branchen zusammen die bereit sind die erforderlichen entscheidungen zu investieren um sich auf diese herausfordernde und lebensbejahende reise zu begeben weitere informationen finden sie unter die ausgangssprache der der originaltext verffentlicht wird ist die offizielle und autorisierte version bersetzungen werden zur besseren verstndigung mitgeliefert nur die sprachversion die im original verffentlicht wurde ist rechtsgltig gleichen sie deshalb bersetzungen mit der originalen sprachversion der verffentlichung ab,-0.9987,-0.49935,0.20763,-0.70698,Negative Impact
28/09/2020,157.4425,158.75,155.86,158.70,158.70,84484000,2.13,76.34428766,1.192,0,9.3404,0.9034837908,0.2283735172,0.09,260.28,11117.53027,12677.54004,5927.899902,4843.27002,3217.534912,37981.62891,16242.7998,159.0525781,122.7905793,155.4732655,130.3505499,158.8326485,176.197497,141.4677999,51.19120946,-2.153788991,-1.851874893,-0.301914098,5.958071027,143.5500031,9859074000,63.28173043,46.4098763,26.19000053,Mark Your Calendars! Prime Day Is Here in Time for the Holidays on October 13 & 14,"SEATTLE--(BUSINESS WIRE)--(NASDAQ: AMZN) ÃÂÃÂAmazonÃÂÃÂs annual Prime Day event is back in time for the holidays on October 13-14. The two-day shopping event delivers Prime members incredible savings and deep discounts on over one million deals across every category. Prime Day kicks off at midnight PT on Tuesday, October 13 and runs through Wednesday, October 14, for Prime members in the U.S., U.K, U.A.E, Spain, Singapore, Netherlands, Mexico, Luxembourg, Japan, Italy, Germany, France, China, Canada,",https://www.businesswire.com/news/home/20200927005049/en/Mark-Your-Calendars%21-Prime-Day-Is-Here-in-Time-for-the-Holidays-on-October-13-14/,businesswire.com,5,seattlebusiness wirenasdaq amzn amazon annual prime day event back time holiday october twoday shopping event delivers prime member incredible saving deep discount one million deal across every category prime day kick midnight pt tuesday october run wednesday october prime member u uk uae spain singapore netherlands mexico luxembourg japan italy germany france china canada,0.5267,0.26335,0.2544333333,0.008916666667,Positive Impact
30/09/2020,157.057,160.64,156.70,157.44,157.44,97922000,2.13,76.34428766,1.192,0,9.3404,0.9034837908,0.2283735172,0.09,260.28,11167.50977,12701.88965,5866.100098,4803.439941,3218.052002,38067.92969,16121.40039,159.011058,123.4836643,155.6169723,130.8849957,157.1914734,171.220286,143.1626608,48.42401998,-1.526200387,-1.781984194,0.2557838063,5.250677926,144.476401,9887080000,80.18992199,66.88741032,26.37000084,Amazon Surpasses $215 Million in Donations to Charities Through AmazonSmile,SEATTLE--(BUSINESS WIRE)--Amazon Surpasses $215 Million in Donations to Charities Through AmazonSmile.,https://www.businesswire.com/news/home/20200930005458/en/Amazon-Surpasses-215-Million-in-Donations-to-Charities-Through-AmazonSmile/,businesswire.com,5,seattlebusiness wireamazon surpasses million donation charity amazonsmile,0.4215,0.21075,0.4172833333,-0.206533333,Negative Impact
01/10/2020,160.4,161.20,158.60,161.06,161.06,99438000,2.13,76.34428766,1.192,0,9.3404,0.9034837908,0.2283735172,0.09,260.388,11326.50977,12726.83984,5879.5,4824.040039,3218.052002,38697.05078,16184.5,159.1324081,123.8466768,155.8305422,131.1852744,156.4159988,167.2949846,145.5370131,56.17460796,-0.987643237,-1.623116002,0.6354727655,5.043213981,145.4464568,9986518000,99.22383311,78.86811122,26.70000076,"Amazon Expands Support to Address Immediate Needs ÃÂÃÂ Including Shelter, Food and Basic Necessities ÃÂÃÂ for Students In Need Across 133 Schools in Puget Sound Region Amid COVID-19","SEATTLE--(BUSINESS WIRE)--Amazon (NASDAQ: AMZN), Bellevue LifeSpring and The Alliance for Education today announced Amazon is making a more than $2.5 million donation to support the immediate needs of thousands of students from underserved communities within the Puget Sound region amid the COVID-19 pandemic. With this donation, Amazon is expanding its innovative Right Now Needs Fund, designed to meet the basic needs of schoolchildren and their families and eliminate barriers to learning, such as challenges with food, shelter, clothing, school supplies, and more. Amazon will donate more than $1.4 million to Bellevue LifeSpring to launch a new Right Now Needs Fund in Bellevue to support students in need at all 29 Bellevue School District schools through 2022. The Right Now Needs Fund in Bellevue can be distributed to students immediately. AmazonÃÂÃÂs $1.3 million donation to The Alliance for Education will expand the existing Right Now Needs Fund in Seattle across 104 schools. The Fund was established by Amazon in late 2018 with an initial $2 million investment and has already provided Seattle Public Schools students with over 17,000 instances of support since inception for basic needs including everything from new eyeglasses to an asthma inhaler. To date, every Seattle Public School has used the Right Now Needs Fund in Seattle to help their students. Since the beginning of the COVID-19 pandemic in mid-March, the Right Now Needs Fund in Seattle has quickly distributed more than $500,000 to students, a 27% increase from the same time last year, with the vast majority of those donations going towards food insecurity and housing assistance. ÃÂÃÂThe start of this school year is difficult for many families in need across the Puget Sound, and we want to provide more students from underserved communities with what they need to be successful while learning from home, whether thatÃÂÃÂs new technology, healthy meals, or a lifeline to call in a pinch,ÃÂÃÂ said David Zapolsky, Amazon General Counsel and Senior Vice President and Alliance for Education board member. ÃÂÃÂAt Amazon, we value speed, flexibility, and scale when we build and operate. Our Right Now Needs Funds help schools exercise these same values to support students in the community, and weÃÂÃÂre excited to extend this support to Bellevue with our support of Bellevue LifeSpring.ÃÂÃÂ Family Engagement Specialists within each of the districts and schools work with families on identifying needs and put in requests for financial assistance through their respective nonprofit partner. In addition, any school community member can put in a request if they notice a specific student need. Amazon recently donated $1 million to the City of BellevueÃÂÃÂs Health and Human Services Fund to support local families in need disproportionately affected by COVID-19. Amazon also recently donated more than 7,000 headsets and hundreds of additional technical devices ÃÂÃÂ including MiFi hotspots - to support students learning from home across the Puget Sound region. At the beginning of the pandemic, Amazon, Bellevue LifeSpring and the Bellevue School District created and implemented pilot programs to provide immediate food and hygiene products to families living in poverty in Bellevue. Amazon also donated more than $200,000 in emergency cash funds and product vouchers to support students in Bellevue and Seattle and donated nearly 9,000 laptops to Seattle Public School students. ÃÂÃÂOur partnership with Amazon will provide every child living in poverty in Bellevue with basic needs and reduce barriers to accessing critically needed support,ÃÂÃÂ said Jennifer Fischer Executive Director, Bellevue LifeSpring. ÃÂÃÂTogether, with our community, we can ensure efficient services to improve educational outcomes for all students. AmazonÃÂÃÂs investment reflects a true partnership where we innovate together to achieve our goals of preventing hunger and homelessness for children in our Bellevue community. We will also work together to close the achievement gap for low-income students, so they graduate at the same rate as their peers.ÃÂÃÂ ÃÂÃÂThank you Amazon for supporting our students in need with this unique investment ÃÂÃÂ we are excited to be your neighbors,ÃÂÃÂ said Dr. Ivan Duran, Superintendent, Bellevue School District. ÃÂÃÂI know that the start of this school year has been tough for so many families, and I am confident that this new Right Now Needs Fund in Bellevue will quickly and effectively provide targeted relief for our hard working students.ÃÂÃÂ ÃÂÃÂAt a time when COVID-19 is making life so much more difficult for thousands of Seattle children and families, the Right Now Needs Fund is designed to directly address the most basic of needs of Seattle Public School students, to ensure our students can focus on learning,ÃÂÃÂ said Petaki Cobell, Director of the Right Now Needs Fund in Seattle at the Alliance for Education. ÃÂÃÂThe Alliance for EducationÃÂÃÂs vision of a deeply invested community that supports student learning and an equitable education is realized through the help of partners like Amazon. Through this contribution, we can continue to address our studentsÃÂÃÂ basic needs, like clothing, adequate food, shelter, and necessary school supplies, and ensure they can focus on learning even in these challenging times.ÃÂÃÂ ÃÂÃÂIÃÂÃÂm glad that Amazon is expanding its Right Now Needs Fund to benefit some of our most vulnerable Seattle public school students,ÃÂÃÂ said Jenny A. Durkan, Mayor of Seattle. ÃÂÃÂI appreciate the flexibility of this fund to ensure that studentsÃÂÃÂ needs ÃÂÃÂ both big and small ÃÂÃÂ can be met during this unprecedented time. I am proud of how our Seattle students and families have adapted to the challenges of the past few months, and know that with this extra support, theyÃÂÃÂll continue to do their best amidst immense challenges.ÃÂÃÂ ÃÂÃÂFor many of our students and families this pandemic has just added even more challenge and difficulty to so many tasks that many of us take for granted,ÃÂÃÂ said Seattle Public Schools Superintendent Denise Juneau. ÃÂÃÂThe Right Now Needs Fund is such a crucial and wonderful help to so many. We are deeply grateful for AmazonÃÂÃÂs leadership and partnership.ÃÂÃÂ In response to COVID-19, Amazon has also donated more than 13,000 laptops to students in need, distributed more than $5 million worth of Amazon devices to help healthcare workers and nonprofits, delivered more than 9 million meals across 25 U.S. cities, launched free, virtual computer science resources and expanded its Amazon Future Engineer program to more than 550,000 students, donated more than $20 million to help accelerate COVID-19 research, donated $10 million in critically needed PPE supplies, and more. To learn more about what Amazon is doing in response to COVID-19 for communities, employees, partners, and customers, check out the Amazon Blog: Day One. About Amazon Amazon is guided by four principles: customer obsession rather than competitor focus, passion for invention, commitment to operational excellence, and long-term thinking. Customer reviews, 1-Click shopping, personalized recommendations, Prime, Fulfillment by Amazon, AWS, Kindle Direct Publishing, Kindle, Fire tablets, Fire TV, Amazon Echo, and Alexa are some of the products and services pioneered by Amazon. For more information, visit amazon.com/about and follow @AmazonNews. About Amazon in the Community Amazon is committed to helping more children and young adults, especially those from underrepresented and underserved communities, have the resources and skills they need to build their best future. Amazon focuses on building long-term, innovative, and high impact programs that leverage AmazonÃÂÃÂs unique assets and culture. Initiatives include Amazon Future Engineer, designed to inspire and excite hundreds of thousands of children and young adults from underserved and underrepresented communities each year to pursue computer science, as well as programs that support immediate needs, including addressing family homelessness through donations and housing a homeless shelter in its Seattle headquarters, as well as global relief efforts for people in need following natural disasters. About Bellevue LifeSpring Bellevue LifeSpring has worked closely with the community since its inception in 1911. It is supported by thousands of local residents, community partners and corporate sponsors in its mission to foster stability and self-sufficiency for BellevueÃÂÃÂs children and their families through programs that provide food, clothing, education and emergency assistance. In addition to their goal of closing the graduation gap by 2025, Bellevue LifeSpring is also working to ensure no student in Bellevue experiences hunger or homelessness due to COVID-19. You can learn more about Bellevue LifeSpring at www.bellevuelifespring.org. About The Alliance for Education The Alliance for Education works in close partnership with Seattle Public Schools and other community partners to convene stakeholders, create programs and raise funds designed to advance educational justice and racial equity in SeattleÃÂÃÂs public school system. To learn more about the Alliance for Education, visit www.alliance4ed.org.",https://www.businesswire.com/news/home/20201001005354/en/Amazon-Expands-Support-to-Address-Immediate-Needs-%E2%80%93-Including-Shelter-Food-and-Basic-Necessities-%E2%80%93-for-Students-In-Need-Across-133-Schools-in-Puget-Sound-Region-Amid-COVID-19,businesswire.com,5,seattlebusiness wireamazon nasdaq amzn bellevue lifespring alliance education today announced amazon making million donation support immediate need thousand student underserved community within puget sound region amid covid pandemic donation amazon expanding innovative right need fund designed meet basic need schoolchildren family eliminate barrier learning challenge food shelter clothing school supply amazon donate million bellevue lifespring launch new right need fund bellevue support student need bellevue school district school right need fund bellevue distributed student immediately amazon million donation alliance education expand existing right need fund seattle across school fund established amazon late initial million investment already provided seattle public school student instance support since inception basic need including everything new eyeglass asthma inhaler date every seattle public school used right need fund seattle help student since beginning covid pandemic midmarch right need fund seattle quickly distributed student increase time last year vast majority donation going towards food insecurity housing assistance start school year difficult many family need across puget sound want provide student underserved community need successful learning home whether thats new technology healthy meal lifeline call pinch said david zapolsky amazon general counsel senior vice president alliance education board member amazon value speed flexibility scale build operate right need fund help school exercise value support student community excited extend support bellevue support bellevue lifespring family engagement specialist within district school work family identifying need put request financial assistance respective nonprofit partner addition school community member put request notice specific student need amazon recently donated million city bellevues health human service fund support local family need disproportionately affected covid amazon also recently donated headset hundred additional technical device including mifi hotspot support student learning home across puget sound region beginning pandemic amazon bellevue lifespring bellevue school district created implemented pilot program provide immediate food hygiene product family living poverty bellevue amazon also donated emergency cash fund product voucher support student bellevue seattle donated nearly laptop seattle public school student partnership amazon provide every child living poverty bellevue basic need reduce barrier accessing critically needed support said jennifer fischer executive director bellevue lifespring together community ensure efficient service improve educational outcome student amazon investment reflects true partnership innovate together achieve goal preventing hunger homelessness child bellevue community also work together close achievement gap lowincome student graduate rate peer thank amazon supporting student need unique investment excited neighbor said dr ivan duran superintendent bellevue school district know start school year tough many family confident new right need fund bellevue quickly effectively provide targeted relief hard working student time covid making life much difficult thousand seattle child family right need fund designed directly address basic need seattle public school student ensure student focus learning said petaki cobell director right need fund seattle alliance education alliance education vision deeply invested community support student learning equitable education realized help partner like amazon contribution continue address student basic need like clothing adequate food shelter necessary school supply ensure focus learning even challenging time im glad amazon expanding right need fund benefit vulnerable seattle public school student said jenny durkan mayor seattle appreciate flexibility fund ensure student need big small met unprecedented time proud seattle student family adapted challenge past month know extra support theyll continue best amidst immense challenge many student family pandemic added even challenge difficulty many task many u take granted said seattle public school superintendent denise juneau right need fund crucial wonderful help many deeply grateful amazon leadership partnership response covid amazon also donated laptop student need distributed million worth amazon device help healthcare worker nonprofit delivered million meal across u city launched free virtual computer science resource expanded amazon future engineer program student donated million help accelerate covid research donated million critically needed ppe supply learn amazon response covid community employee partner customer check amazon blog day one amazon amazon guided four principle customer obsession rather competitor focus passion invention commitment operational excellence longterm thinking customer review click shopping personalized recommendation prime fulfillment amazon aws kindle direct publishing kindle fire tablet fire tv amazon echo alexa product service pioneered amazon information visit amazoncomabout follow amazonnews amazon community amazon committed helping child young adult especially underrepresented underserved community resource skill need build best future amazon focus building longterm innovative high impact program leverage amazon unique asset culture initiative include amazon future engineer designed inspire excite hundred thousand child young adult underserved underrepresented community year pursue computer science well program support immediate need including addressing family homelessness donation housing homeless shelter seattle headquarters well global relief effort people need following natural disaster bellevue lifespring bellevue lifespring worked closely community since inception supported thousand local resident community partner corporate sponsor mission foster stability selfsufficiency bellevues child family program provide food clothing education emergency assistance addition goal closing graduation gap bellevue lifespring also working ensure student bellevue experience hunger homelessness due covid learn bellevue lifespring alliance education alliance education work close partnership seattle public school community partner convene stakeholder create program raise fund designed advance educational justice racial equity seattle public school system learn alliance education visit,0.9996,0.4998,0.4998,0,Negative Impact
02/10/2020,157.6815,159.79,156.15,156.25,156.25,112262000,2.13,76.34428766,1.192,0,9.3404,0.9034837908,0.2283735172,0.09,260.388,11075.01953,12749.79004,5902.100098,4824.879883,3218.052002,38697.05078,16199.2998,159.2708582,124.1802618,155.8469915,131.4346746,155.8084991,165.1127582,146.5042401,51.17985557,-0.93838486,-1.486169774,0.5477849137,5.067750113,146.70674,9874256000,71.95468181,83.78947897,27.62999916,Amazon Music Partners with Universal Music Group and Warner Music Group to Exclusively Remaster and Deliver Thousands of Songs and Albums at the Highest Quality Streaming Audio Available,"SEATTLE--(BUSINESS WIRE)--(NASDAQ: AMZN) Amazon Music today announced a partnership with Universal Music Group and Warner Music Group to remaster thousands of songs and albums to Ultra High Definition, upgrading the digital streaming audio quality of these songs to the highest available. For the first time, fans will be able to stream music from artists across a broad range of genres and eras, with all of the depth, vibrancy, and emotion from their original recordings, launching exclusively on",https://www.businesswire.com/news/home/20201002005135/en/Amazon-Music-Partners-with-Universal-Music-Group-and-Warner-Music-Group-to-Exclusively-Remaster-and-Deliver-Thousands-of-Songs-and-Albums-at-the-Highest-Quality-Streaming-Audio-Available/,businesswire.com,5,seattlebusiness wirenasdaq amzn amazon music today announced partnership universal music group warner music group remaster thousand song album ultra high definition upgrading digital streaming audio quality song highest available first time fan able stream music artist across broad range genre era depth vibrancy emotion original recording launching exclusively,0.6486,0.3243,0.4119,-0.0876,Negative Impact
05/10/2020,157.292,160.13,157.04,159.96,159.96,75506000,2.13,76.34428766,1.192,0,9.3404,0.9034837908,0.2283735172,0.09,260.388,11332.49023,12949.65039,5942.899902,4871.870117,3218.052002,38973.69922,16410.19922,159.4611484,124.5340543,156.0082862,131.7185088,155.5699493,164.1255224,147.0143762,52.2558511,-0.593143319,-1.307564483,0.714421164,5.0873206,147.8662006,9949762000,92.97455715,88.05102403,27.95999908,"More Games, More Talent, and More Control for FansÃÂÃÂAmazon Delivers the Future of Football with TNF on Prime Video","SEATTLE--(BUSINESS WIRE)--(NASDAQ: AMZN) ÃÂÃÂ Today, Amazon announced a slate of new features and original programming for Thursday Night Football (TNF) Presented by Bud Light Platinum on Prime Video and Twitch, which kicks off on Oct. 8 as Tom Brady and the new-look Tampa Bay Buccaneers travel to the Windy City to take on the Chicago Bears. ÃÂÃÂWe are always looking for ways to delight customers and enhance the value of a Prime membership, and are thrilled to bring Thursday Night Football back to Prime Video and Twitch for a fourth season,ÃÂÃÂ said Marie Donoghue, VP of Global Sports Video at Amazon. ÃÂÃÂWe know these are unusual times, and have developed a wall-to-wall lineup of exclusive features and original content from across Amazon that prioritizes real-time data and insights, provides expert analysis, and gives fanatic and casual football fans alike access to more games, more talent, and more options than ever before.ÃÂÃÂ Announcer Options Put Fans in Control Prime Video is once again producing multiple announcer options for TNF alongside the default FOX broadcast featuring Joe Buck and Troy Aikman. Hannah Storm and Andrea Kremer return for their third season on Prime Video, and new this year Prime members can tune-in to a ÃÂÃÂScoutÃÂÃÂs Feed,ÃÂÃÂ which features podcasters and former NFL scouts Bucky Brooks and Daniel Jeremiah alongside sports podcast, radio, and TV host Joy Taylor. These feeds are exclusive to Amazon and give football fans around the world the ability to customize their viewing experience from wherever they are watching. Prime members in the US and Mexico will once again have access to the FOX Deportes Spanish-language broadcast. To switch between announcers, Prime members can simply open the settings on their device, select the broadcast of their choice, and enjoy the game. A New Day for ÃÂÃÂNFL NextÃÂÃÂ On the heels of a successful first season, ÃÂÃÂNFL NextÃÂÃÂ returns this year to Prime Video with two-time Super Bowl Champion Chris Long, NFL NetworkÃÂÃÂs Kay Adams, and Next Gen Stats Analyst James Koh. New this year, former NFL receiver and Academy Award winner Andrew Hawkins joins the show as a co-host, rounding out refreshing group of talent that provides a unique perspective on the NFL. This season ÃÂÃÂNFL NextÃÂÃÂ is shifting from a live pre-game show on Thursdays to a live and on-demand release on Tuesday evenings at 8p.m. ET, giving die-hard fans more time to discover, watch, and share their favorite moments each week. ÃÂÃÂNFL NextÃÂÃÂ will include compelling moments and stories from the prior weekendÃÂÃÂs games presented through the lens of Next Gen Stats; it will amplify the social media pulse of the league; it will provide a fantasy football-themed look ahead to the upcoming weekÃÂÃÂs action; and it will give fans an in-depth preview of the upcoming weeksÃÂÃÂ TNF matchup utilizing the NFL Films ÃÂÃÂmicÃÂÃÂd upÃÂÃÂ vault. ÃÂÃÂNFL NextÃÂÃÂ returns Oct. 6 at 8p.m. ET on Prime Video. Andrew Hawkins will also join Cari Champion for a new weekly TNF livestream that will air exclusively on Twitch every Thursday, with either Chris Long or Von Miller joining each week throughout the season. Beginning Oct. 8, the ÃÂÃÂNFL Next LiveÃÂÃÂ stream will give fans a one-of-a-kind NFL broadcast that marries AmazonÃÂÃÂs suite of sports offerings including Next Gen Stats, Twitch, and Prime Video with a traditional NFL broadcast. X-Ray Lets Fans Catch All the Action on Prime Video X-Ray for TNF gives Prime members real-time access to live stats and key insights, allowing fans to watch and understand the game without taking their eyes off the screen or missing a play. With Next Gen Stats, fans watching TNF on Prime Video have access to data previously only available to coaches and announcers. New this season to X-Ray is an interactive in-game on-demand replay experience, which allows fans to re-watch top plays from throughout the game in real-time, giving them deeper analysis and insights derived from in-game team and player performance data. This new feature gives fans more information about the key players involved in that play, the Next Gen Stats specific to that play including time to throw, running speeds, and completion probability, as well as trivia, which provides interesting facts or relevant milestones for that play. In-game on-demand replays with X-Ray will be available on all Fire TV, Android, and iOS devices, and will launch on web browsers later this season. X-Ray is available for football fans streaming TNF on web, Android, iOS, and Fire TV. To access X-Ray during the game, fans watching on Prime Video can simply flip their mobile device or click up on their Fire TV remote. New Original Content on Twitch Also new this season, in collaboration with NFL Films, Prime Video is producing a lineup of original content available exclusively on Twitch, which will air throughout the week leading up to the game each Thursday. On Mondays at 2p.m. ET, Kyle Long and Andrew Hawkins will host ÃÂÃÂThe NFL Comment Box,ÃÂÃÂ an Ask Me Anything show giving fans the chance to engage with Long and Hawkins in an authentic and informative way. On Wednesdays at 6p.m. ET, on the heels of Tuesday nightÃÂÃÂs ÃÂÃÂNFL NextÃÂÃÂ broadcast on Prime Video, fans can join Kyle Long and Chad Johnson on ÃÂÃÂThe NFL Machine,ÃÂÃÂ a show that gives fans access to the NFL Films archive and allows hosts to walk through footage in the most live and interactive manner possible. To round out a week of programming on Twitch, on Thursdays fans will be able to watch a live simulcast of the ÃÂÃÂScoutÃÂÃÂs Feed,ÃÂÃÂ as well as an ÃÂÃÂNFL Next LiveÃÂÃÂ broadcast starring Andrew Hawkins and Cari Champion, who will be joined weekly by either Chris Long or Von Miller, which will give fans a unique game day viewing experience unlike any other broadcast. TNF will once again be available on the Prime Video Twitch channel as well as via a handful of co-streamers. TNF on Twitch allows viewers to interact with the content through additional features including live chat, custom extensions with stats or polls, custom emotes, and more. The TNF extension on Twitch allows streamers to make live predictions with correct answers earning points and placing top scorers on a leaderboard. ÃÂÃÂThe NFL Comment Box,ÃÂÃÂ ÃÂÃÂThe NFL Machine,ÃÂÃÂ and ÃÂÃÂNFL Next LiveÃÂÃÂ will be available via the Twitch Sports channel at twitch.tv/twitchsports, and the ÃÂÃÂScoutÃÂÃÂs FeedÃÂÃÂ will be available via the Move the Sticks channel at twitch.tv/movethesticks. TNF on FOX, NFL Network, and Prime Video kicks off Thursday, Oct. 8 at 8:20p.m. ET with the Chicago Bears hosting the Tampa Bay Buccaneers. TNF will also be available to stream on Twitch in addition to NFL, FOX and FOX Deportes digital properties across devices, on mobile via Club properties (for their respective games), and via Yahoo Sports. NFL Network availability subject to change. To stay up to date with the latest sports on Prime Video, follow @SportsOnPrime on Twitter and Instagram. About Prime Video Prime Video offers customers a vast collection of movies, series, and sportsÃÂÃÂ all available to watch on hundreds of compatible devices. Included with Prime Video: Watch movies, series and sports, including Thursday Night Football, award-winning Amazon Originals, and other exclusives. Enjoy hits like The Boys, Tom ClancyÃÂÃÂs Jack Ryan, Chemical Hearts, Utopia, Troop Zero, and Late Night with Mindy Kaling, plus Emmy Award winners Fleabag and The Marvelous Mrs. Maisel, and Academy Award-nominated The Big Sick. Prime members also get access to licensed and self-published content. Prime Video Channels: Prime members can add channels like CBS All Access, BET+, EPIX, Noggin, NBA League Pass, MLB.tv, STARZ and SHOWTIMEÃÂÃÂno extra apps to download, and no cable required. Only pay for the ones you want, and cancel anytime. View the full list of channels available at amazon.com/channels. Rent or Buy: Enjoy new-release movies to rent or buy, entire seasons of current TV shows available to buy, and special deals just for Prime members. Instant access: Watch at home or on the go with your choice of hundreds of compatible devices. Stream from the web or using the Prime Video app on your smartphone, tablet, set-top box, game console, or select smart TV. For a complete list of compatible devices, visit amazon.com/howtostream. Enhanced experiences: Make the most of every viewing with 4K Ultra HD- and High Dynamic Range (HDR)-compatible content. Go behind the scenes of your favorite movies and TV shows with exclusive X-Ray access, powered by IMDb. Save it for later with select mobile downloads for offline viewing. Prime Video is just one of many shopping and entertainment benefits included with a Prime membership, along with fast, free shipping on millions of Prime-eligible items at Amazon.com, unlimited photo storage, exclusive deals and discounts, and access to ad-free music and Kindle ebooks. To sign up or start a 30-day free trial of Amazon Prime, visit: amazon.com/prime. About Amazon Amazon is guided by four principles: customer obsession rather than competitor focus, passion for invention, commitment to operational excellence, and long-term thinking. Customer reviews, 1-Click shopping, personalized recommendations, Prime, Fulfillment by Amazon, AWS, Kindle Direct Publishing, Kindle, Fire tablets, Fire TV, Amazon Echo, and Alexa are some of the products and services pioneered by Amazon. For more information, visit amazon.com/about and follow @AmazonNews.",https://www.businesswire.com/news/home/20201005005162/en/More-Games-More-Talent-and-More-Control-for-Fans%E2%80%94Amazon-Delivers-the-Future-of-Football-with-TNF-on-Prime-Video,businesswire.com,5,seattlebusiness wirenasdaq amzn today amazon announced slate new feature original programming thursday night football tnf presented bud light platinum prime video twitch kick oct tom brady newlook tampa bay buccaneer travel windy city take chicago bear always looking way delight customer enhance value prime membership thrilled bring thursday night football back prime video twitch fourth season said marie donoghue vp global sport video amazon know unusual time developed walltowall lineup exclusive feature original content across amazon prioritizes realtime data insight provides expert analysis give fanatic casual football fan alike access game talent option ever announcer option put fan control prime video producing multiple announcer option tnf alongside default fox broadcast featuring joe buck troy aikman hannah storm andrea kremer return third season prime video new year prime member tunein scout feed feature podcasters former nfl scout bucky brook daniel jeremiah alongside sport podcast radio tv host joy taylor feed exclusive amazon give football fan around world ability customize viewing experience wherever watching prime member u mexico access fox deportes spanishlanguage broadcast switch announcer prime member simply open setting device select broadcast choice enjoy game new day nfl next heel successful first season nfl next return year prime video twotime super bowl champion chris long nfl network kay adam next gen stats analyst james koh new year former nfl receiver academy award winner andrew hawkins join show cohost rounding refreshing group talent provides unique perspective nfl season nfl next shifting live pregame show thursday live ondemand release tuesday evening pm et giving diehard fan time discover watch share favorite moment week nfl next include compelling moment story prior weekend game presented lens next gen stats amplify social medium pulse league provide fantasy footballthemed look ahead upcoming week action give fan indepth preview upcoming week tnf matchup utilizing nfl film micd vault nfl next return oct pm et prime video andrew hawkins also join cari champion new weekly tnf livestream air exclusively twitch every thursday either chris long von miller joining week throughout season beginning oct nfl next live stream give fan oneofakind nfl broadcast marries amazon suite sport offering including next gen stats twitch prime video traditional nfl broadcast xray let fan catch action prime video xray tnf give prime member realtime access live stats key insight allowing fan watch understand game without taking eye screen missing play next gen stats fan watching tnf prime video access data previously available coach announcer new season xray interactive ingame ondemand replay experience allows fan rewatch top play throughout game realtime giving deeper analysis insight derived ingame team player performance data new feature give fan information key player involved play next gen stats specific play including time throw running speed completion probability well trivia provides interesting fact relevant milestone play ingame ondemand replay xray available fire tv android io device launch web browser later season xray available football fan streaming tnf web android io fire tv access xray game fan watching prime video simply flip mobile device click fire tv remote new original content twitch also new season collaboration nfl film prime video producing lineup original content available exclusively twitch air throughout week leading game thursday monday pm et kyle long andrew hawkins host nfl comment box ask anything show giving fan chance engage long hawkins authentic informative way wednesday pm et heel tuesday night nfl next broadcast prime video fan join kyle long chad johnson nfl machine show give fan access nfl film archive allows host walk footage live interactive manner possible round week programming twitch thursday fan able watch live simulcast scout feed well nfl next live broadcast starring andrew hawkins cari champion joined weekly either chris long von miller give fan unique game day viewing experience unlike broadcast tnf available prime video twitch channel well via handful costreamers tnf twitch allows viewer interact content additional feature including live chat custom extension stats poll custom emotes tnf extension twitch allows streamer make live prediction correct answer earning point placing top scorer leaderboard nfl comment box nfl machine nfl next live available via twitch sport channel twitchtvtwitchsports scout feed available via move stick channel twitchtvmovethesticks tnf fox nfl network prime video kick thursday oct pm et chicago bear hosting tampa bay buccaneer tnf also available stream twitch addition nfl fox fox deportes digital property across device mobile via club property respective game via yahoo sport nfl network availability subject change stay date latest sport prime video follow sportsonprime twitter instagram prime video prime video offer customer vast collection movie series sport available watch hundred compatible device included prime video watch movie series sport including thursday night football awardwinning amazon original exclusive enjoy hit like boy tom clancys jack ryan chemical heart utopia troop zero late night mindy kaling plus emmy award winner fleabag marvelous mr maisel academy awardnominated big sick prime member also get access licensed selfpublished content prime video channel prime member add channel like cbs access bet epix noggin nba league pas mlbtv starz showtimeno extra apps download cable required pay one want cancel anytime view full list channel available amazoncomchannels rent buy enjoy newrelease movie rent buy entire season current tv show available buy special deal prime member instant access watch home go choice hundred compatible device stream web using prime video app smartphone tablet settop box game console select smart tv complete list compatible device visit amazoncomhowtostream enhanced experience make every viewing k ultra hd high dynamic range hdrcompatible content go behind scene favorite movie tv show exclusive xray access powered imdb save later select mobile downloads offline viewing prime video one many shopping entertainment benefit included prime membership along fast free shipping million primeeligible item amazoncom unlimited photo storage exclusive deal discount access adfree music kindle ebooks sign start day free trial amazon prime visit amazoncomprime amazon amazon guided four principle customer obsession rather competitor focus passion invention commitment operational excellence longterm thinking customer review click shopping personalized recommendation prime fulfillment amazon aws kindle direct publishing kindle fire tablet fire tv amazon echo alexa product service pioneered amazon information visit amazoncomabout follow amazonnews,0.9996,0.4998,-0.05705,0.55685,Positive Impact
06/10/2020,158.25,159.10,154.50,155.00,155.00,101738000,2.13,76.34428766,1.192,0,9.3404,0.9034837908,0.2283735172,0.09,260.388,11154.59961,12837.87988,5949.899902,4895.459961,3218.052002,39574.57031,16236.09961,159.5058984,124.8609743,155.9686672,131.9501455,155.4452492,163.9554477,146.9350507,51.12006287,-0.711724971,-1.18839658,0.4766716091,5.073428563,148.9329043,9848024000,64.86120117,76.59681338,29.47999954,3 Reasons Why I Own Amazon (NASDAQ:AMZN),Amazon has crushed the market in the long term due to the company's rock-solid competitive strength in a high growth market.,https://seekingalpha.com/article/4377772-3-reasons-why-i-own-amazon,seekingalpha.com,6,amazon crushed market long term due company rocksolid competitive strength high growth market,0.6597,0.39582,0.44761,-0.05179,Negative Impact
07/10/2020,156.75,160.00,156.62,159.78,159.78,86188000,2.13,76.34428766,1.192,0,9.3404,0.9034837908,0.2283735172,0.09,260.388,11364.59961,13042.33008,5946.299805,4882,3218.052002,39878.94922,16428.30078,159.7012585,125.2132719,156.1183077,132.2271043,155.2629494,163.1890792,147.3368195,59.32748662,-0.414691017,-1.033655468,0.618964451,5.053750174,149.9142717,9934212000,91.98018518,83.27198116,28.05999947,Amazon Launches Innovative ÃÂÃÂRight Now Needs FundÃÂÃÂ to Help Remove Barriers to Learning for Thousands of Students In Need Across 59 Northern Virginia Schools Amid COVID-19,"ARLINGTON, Va.--(BUSINESS WIRE)--Amazon (NASDAQ: AMZN) and Communities In Schools NOVA today announced Amazon is making a $1 million donation to support the immediate needs of thousands of students from underserved communities in Northern Virginia amid the COVID-19 pandemic. Communities In Schools NOVA will distribute AmazonÃÂÃÂs donation through its innovative ÃÂÃÂRight Now Needs FundÃÂÃÂÃÂÃÂa flexible fund designed to meet the basic needs of schoolchildren and help eliminate barriers to learning. The Right Now Needs Fund in Northern Virginia will provide students with immediate access to urgently needed items including food, clothing, and school supplies across all 41 Arlington Public Schools and programs and all 18 Alexandria City Public Schools. Site Coordinators and school social workers within each of the school districts and schools will work with families to identify individual student needs and request assistance from the Fund. Communities In Schools NOVA, leveraging existing relationships with both school districts, will distribute Amazon Education Assistance Product Vouchers ÃÂÃÂ a prepaid payment designed specifically for education-related needs. Students and their families can redeem the vouchers for a wide variety of carefully curated items that students need to be successful at school, including food, school supplies for at-home learning, warm clothing, hygiene items, and more. By using the prepaid vouchers, students and families can redeem much-needed items in a dignified and convenient way. ÃÂÃÂThe start of this school year has been difficult for many families across our new home of Northern Virginia, and we are determined to provide support to the students who need it most,ÃÂÃÂ said Jay Carney, Amazon Senior Vice President, Global Corporate Affairs. ÃÂÃÂAt Amazon, we are always looking for innovative solutions to tough challenges, and we are confident that the flexibility and speed built into our new Right Now Needs Fund will help ensure that more students from underserved communities can focus on their studies, and not fall behind as the COVID-19 pandemic continues.ÃÂÃÂ In 2018, Amazon launched its first Right Now Needs Fund in its hometown of Seattle. To date, the initial investment has already provided Seattle Public Schools students with over 17,000 instances of support for basic needs. Moreover, since the beginning of the COVID-19 pandemic in mid-March, the Right Now Needs Fund in Seattle distributed 27% more funds from the same time last year. Since March, Amazon expanded its Right Now Needs Fund in Seattle and launched a new Right Now Needs Fund in Bellevue, Washington to support an additional 133 schools in the Greater Seattle area. Amazon recently donated nearly 800 Mi-Fi devices and $75,000 to secure thousands of headsets for students across Northern Virginia starting the school year from home. In addition, since the start of the COVID-19 pandemic in AmazonÃÂÃÂs HQ2 region, Amazon donated $1 million to kick-start emergency response efforts, provided thousands of devices to groups supporting students in need, donated cash and in-kind products to local nonprofits and food banks, paid local restaurants to prepare and deliver 10,000 lunches and dinners for first responders, frontline healthcare workers, and vulnerable neighbors, and funded delivery services to provide more than 50,000 mealsÃÂÃÂ60,000 pounds of foodÃÂÃÂdirectly to the doorsteps of local seniors and those disproportionately impacted by COVID-19. Amazon also donated $3.9 million to nonprofit CodeVA to help make virtual computer science curriculum and training available Virginia teachers and students so that they donÃÂÃÂt fall behind in learning this increasingly important skillset. There are currently more than 50 schools and counting in the state of Virginia part of the Amazon Future Engineer program. ""Communities In Schools NOVA appreciates the trust Amazon has placed in our ability to collaborate with schools and community partners on implementing the Right Now Needs Fund,ÃÂÃÂ said Patrick Brennan, Executive Director, Communities In Schools NOVA. ÃÂÃÂEvery student, regardless of circumstance, deserves a seamless system of support so they can stay in school and achieve in life."" ÃÂÃÂMany families are facing hardship in the pandemic, and these vouchers are a wonderful way to provide direct support to students so that they can purchase food, clothing, school supplies, and other essentials,ÃÂÃÂ said Arlington Public Schools Superintendent Dr. Francisco DurÃÂÃÂ¡n. ÃÂÃÂI would also like to thank Amazon for providing 500 MiFiÃÂÃÂs to help us bridge the digital divide some of our students are facing during this pandemic. We appreciate the commitment and support of Amazon and Communities In Schools for coming together to help our students and their families. It truly takes a village to support our equity efforts, and this is another step that will allow our students in need to focus on learning while at home.ÃÂÃÂ ""In keeping with our goal of expanding the ÃÂÃÂplusÃÂÃÂ in our Virtual PLUS+ model, we are grateful to Amazon for their generous donation to one of our Virtual PLUS+ partners, Communities In Schools (CIS). CIS will work closely with Alexandria City Public Schools to identify families that need additional supports to be academically successful, and this will help our students in greatest need stay connected to their school and community during this pandemic while providing targeted relief, resources and supplies for our families,"" said Alexandria City Public Schools Superintendent Dr. Gregory C. Hutchings, Jr. In response to COVID-19, Amazon has supported communities, employees, partners and customers across the country. Since March, Amazon has donated more than 13,000 laptops to students in need, distributed more than $5 million worth of Amazon devices to help healthcare workers and nonprofits, delivered more than 9 million meals across 25 U.S. cities, launched free, virtual computer science resources and expanded its Amazon Future Engineer program to more than 550,000 students, donated more than $20 million to help accelerate COVID-19 research, donated $10 million in critically needed PPE supplies, and more. To learn more about what Amazon is doing in response to COVID-19, check out the Amazon Blog: Day One. About Amazon Amazon is guided by four principles: customer obsession rather than competitor focus, passion for invention, commitment to operational excellence, and long-term thinking. Customer reviews, 1-Click shopping, personalized recommendations, Prime, Fulfillment by Amazon, AWS, Kindle Direct Publishing, Kindle, Fire tablets, Fire TV, Amazon Echo, and Alexa are some of the products and services pioneered by Amazon. For more information, visit amazon.com/about and follow @AmazonNews. About Amazon in the Community Amazon is committed to helping more children and young adults, especially those from underrepresented and underserved communities, have the resources and skills they need to build their best future. Amazon focuses on building long-term, innovative, and high impact programs that leverage AmazonÃÂÃÂs unique assets and culture. Initiatives include Amazon Future Engineer, designed to inspire and excite hundreds of thousands of children and young adults from underserved and underrepresented communities each year to pursue computer science, as well as programs that support immediate needs, including addressing family homelessness through donations and housing a homeless shelter in its Seattle headquarters, as well as global relief efforts for people in need following natural disasters. About Communities In Schools NOVA Communities In Schools builds relationships that empower students to stay in school and succeed in life. Our school-based staff partner with teachers to identify challenges students face in class or at home and coordinate with community partners to bring outside resources inside schools. We remove barriers for students at risk of dropping out and leverage evidence, relationships, and local resources to drive results. While schools are closed, we're working in and across communities to bring resources like meals, educational materials, and emotional support to the kids that need them the most. CIS NOVA has partnered with Arlington Public Schools since 2013 and Alexandria City Public Schools since 2015. In the 2019-2020 school year, 100% of our case-managed students stayed in school and 97% were promoted to the next grade level. To learn more about Communities in Schools NOVA, visit https://cisofnova.org/.",https://www.businesswire.com/news/home/20201007005295/en/Amazon-Launches-Innovative-%E2%80%9CRight-Now-Needs-Fund%E2%80%9D-to-Help-Remove-Barriers-to-Learning-for-Thousands-of-Students-In-Need-Across-59-Northern-Virginia-Schools-Amid-COVID-19,businesswire.com,5,arlington vabusiness wireamazon nasdaq amzn community school nova today announced amazon making million donation support immediate need thousand student underserved community northern virginia amid covid pandemic community school nova distribute amazon donation innovative right need funda flexible fund designed meet basic need schoolchildren help eliminate barrier learning right need fund northern virginia provide student immediate access urgently needed item including food clothing school supply across arlington public school program alexandria city public school site coordinator school social worker within school district school work family identify individual student need request assistance fund community school nova leveraging existing relationship school district distribute amazon education assistance product voucher prepaid payment designed specifically educationrelated need student family redeem voucher wide variety carefully curated item student need successful school including food school supply athome learning warm clothing hygiene item using prepaid voucher student family redeem muchneeded item dignified convenient way start school year difficult many family across new home northern virginia determined provide support student need said jay carney amazon senior vice president global corporate affair amazon always looking innovative solution tough challenge confident flexibility speed built new right need fund help ensure student underserved community focus study fall behind covid pandemic continues amazon launched first right need fund hometown seattle date initial investment already provided seattle public school student instance support basic need moreover since beginning covid pandemic midmarch right need fund seattle distributed fund time last year since march amazon expanded right need fund seattle launched new right need fund bellevue washington support additional school greater seattle area amazon recently donated nearly mifi device secure thousand headset student across northern virginia starting school year home addition since start covid pandemic amazon hq region amazon donated million kickstart emergency response effort provided thousand device group supporting student need donated cash inkind product local nonprofit food bank paid local restaurant prepare deliver lunch dinner first responder frontline healthcare worker vulnerable neighbor funded delivery service provide meal pound fooddirectly doorstep local senior disproportionately impacted covid amazon also donated million nonprofit codeva help make virtual computer science curriculum training available virginia teacher student dont fall behind learning increasingly important skillset currently school counting state virginia part amazon future engineer program community school nova appreciates trust amazon placed ability collaborate school community partner implementing right need fund said patrick brennan executive director community school nova every student regardless circumstance deserves seamless system support stay school achieve life many family facing hardship pandemic voucher wonderful way provide direct support student purchase food clothing school supply essential said arlington public school superintendent dr francisco durn would also like thank amazon providing mifis help u bridge digital divide student facing pandemic appreciate commitment support amazon community school coming together help student family truly take village support equity effort another step allow student need focus learning home keeping goal expanding plus virtual plus model grateful amazon generous donation one virtual plus partner community school ci ci work closely alexandria city public school identify family need additional support academically successful help student greatest need stay connected school community pandemic providing targeted relief resource supply family said alexandria city public school superintendent dr gregory c hutchings jr response covid amazon supported community employee partner customer across country since march amazon donated laptop student need distributed million worth amazon device help healthcare worker nonprofit delivered million meal across u city launched free virtual computer science resource expanded amazon future engineer program student donated million help accelerate covid research donated million critically needed ppe supply learn amazon response covid check amazon blog day one amazon amazon guided four principle customer obsession rather competitor focus passion invention commitment operational excellence longterm thinking customer review click shopping personalized recommendation prime fulfillment amazon aws kindle direct publishing kindle fire tablet fire tv amazon echo alexa product service pioneered amazon information visit amazoncomabout follow amazonnews amazon community amazon committed helping child young adult especially underrepresented underserved community resource skill need build best future amazon focus building longterm innovative high impact program leverage amazon unique asset culture initiative include amazon future engineer designed inspire excite hundred thousand child young adult underserved underrepresented community year pursue computer science well program support immediate need including addressing family homelessness donation housing homeless shelter seattle headquarters well global relief effort people need following natural disaster community school nova community school build relationship empower student stay school succeed life schoolbased staff partner teacher identify challenge student face class home coordinate community partner bring outside resource inside school remove barrier student risk dropping leverage evidence relationship local resource drive result school closed working across community bring resource like meal educational material emotional support kid need ci nova partnered arlington public school since alexandria city public school since school year casemanaged student stayed school promoted next grade level learn community school nova visit,0.9996,0.4998,0.4998,0,Negative Impact
08/10/2020,161.2495,161.66,158.75,159.53,159.53,63482000,2.13,76.34428766,1.192,0,9.3404,0.9034837908,0.2283735172,0.09,260.388,11420.98047,13190.58008,5978,4911.939941,3218.052002,40182.67188,16534.5,159.8582785,125.5626593,156.2520014,132.4987499,155.3015495,163.3064229,147.2966762,62.35631678,-0.197748009,-0.866473976,0.6687259667,4.789607457,150.8171297,9870730000,88.20277437,81.68138691,26.36000061,"Carrier and AWS Collaborate to Transform How Food, Medicine, Vaccines, and Other Perishable Goods Are Moved and Monitored Globally","SEATTLE & PALM BEACH GARDENS, Fla.--(BUSINESS WIRE)--Today, Amazon Web Services, Inc. (AWS), an Amazon.com company (NASDAQ: AMZN), and Carrier Global Corporation (NYSE: CARR), a leading global provider of healthy, safe, and sustainable building and cold chain solutions, announced a multi-year agreement to co-develop CarrierÃÂÃÂs new LynxÃÂÃÂ digital platform. This suite of tools will provide Carrier customers around the world with enhanced visibility, increased connectivity, and actionable intelligence across their cold chain operations to improve outcomes for temperature-sensitive cargo, including food, medicine, and vaccines. The collaboration builds on CarrierÃÂÃÂs selection of AWS as its preferred cloud services provider in February 2020. The Lynx platform will combine AWSÃÂÃÂs IoT, analytics, and machine learning services with CarrierÃÂÃÂs refrigeration and monitoring solutions, extending CarrierÃÂÃÂs current digital offerings for managing the temperature-controlled transport and storage of perishables. Customers using the Lynx platform will benefit from end-to-end tracking, real-time alerts, automated processes, and predictive analytics to help them deliver temperature-controlled cargo more efficiently, in turn decreasing the cost of cold chain operations by optimizing resource utilization and reducing cargo loss and spoilage. Leveraging AWS IoT services to collect, integrate, organize, and analyze data from CarrierÃÂÃÂs large installed base of refrigeration equipment and monitoring solutions, along with sources such as traffic and weather reports, the Lynx platform will provide a comprehensive view of cargo location, temperature conditions, and external events that could impact cold chain operations. This information will feed into a data lake built on Amazon Simple Storage Service (Amazon S3) where Carrier can use AWS machine learning services to identify potential issues that could impact cargo, as well as run sophisticated analytics to develop recommendations for improving outcomes. For example, by analyzing historic and real-time performance data from CarrierÃÂÃÂs cloud-connected equipment, the Lynx platform could suggest proactive maintenance to maximize a specific piece of equipmentÃÂÃÂs availability. Looking ahead, Carrier and AWS plan to introduce a capability for the Lynx platform to provide recommendations related to cargo routing and improved fleet utilization, adding greater resilience into the cold chain that will help CarrierÃÂÃÂs customers to manage costs, schedules, and resources. ÃÂÃÂCarrier is committed to delivering a healthier, safer, and more sustainable cold chain. Through this collaboration with AWS, we are developing a uniquely powerful ecosystem to give our customers greater flexibility, visibility, and intelligence across the cold chain,ÃÂÃÂ said David Appel, President, Carrier Refrigeration. ÃÂÃÂThe Lynx platform will help our customers make faster, data-driven decisions to improve the effectiveness, efficiency, and sustainability of their supply chains. This digital solution will enhance connectivity across the cold chain, decreasing delays for cargo that is critical to global health and well-being, while reducing cargo damage, loss, and unanticipated costs.ÃÂÃÂ ÃÂÃÂCarrier and AWS are tackling the complexity and fragmentation of the cold chain to give supply chain customers the transparency, flexibility, and insights they require to reduce risk and deliver food, medicine, and vaccines when and where theyÃÂÃÂre needed,ÃÂÃÂ said Sarah Cooper, General Manager, IoT Solutions at Amazon Web Services, Inc. ÃÂÃÂThis project, which combines CarrierÃÂÃÂs cold chain expertise with AWSÃÂÃÂs digital experience and unparalleled portfolio of services, highlights how entire industries stand to benefit from digital transformation through increased efficiency, reduced costs, and greater dependability.ÃÂÃÂ Visit Carrier.com/Lynx to learn more. About Amazon Web Services For 14 years, Amazon Web Services has been the worldÃÂÃÂs most comprehensive and broadly adopted cloud platform. AWS offers over 175 fully featured services for compute, storage, databases, networking, analytics, robotics, machine learning and artificial intelligence (AI), Internet of Things (IoT), mobile, security, hybrid, virtual and augmented reality (VR and AR), media, and application development, deployment, and management from 77 Availability Zones (AZs) within 24 geographic regions, with announced plans for nine more Availability Zones and three more AWS Regions in Indonesia, Japan, and Spain. Millions of customersÃÂÃÂincluding the fastest-growing startups, largest enterprises, and leading government agenciesÃÂÃÂtrust AWS to power their infrastructure, become more agile, and lower costs. To learn more about AWS, visit aws.amazon.com. About Amazon Amazon is guided by four principles: customer obsession rather than competitor focus, passion for invention, commitment to operational excellence, and long-term thinking. Customer reviews, 1-Click shopping, personalized recommendations, Prime, Fulfillment by Amazon, AWS, Kindle Direct Publishing, Kindle, Fire tablets, Fire TV, Amazon Echo, and Alexa are some of the products and services pioneered by Amazon. For more information, visit www.amazon.com/about and follow @AmazonNews. About Carrier As the leading global provider of healthy, safe and sustainable building and cold chain solutions, Carrier Global Corporation is committed to making the world safer, sustainable and more comfortable for generations to come. From the beginning, weÃÂÃÂve led in inventing new technologies and entirely new industries. Today, we continue to lead because we have a world-class, diverse workforce that puts the customer at the center of everything we do. For more information, visit www.Corporate.Carrier.com or follow us on social media at @Carrier. This press release contains forward-looking statements concerning future business opportunities. Actual results may differ materially from those projected as a result of certain risks and uncertainties, including but not limited to challenges in the design, development, production, support, performance and realization of the anticipated benefits of advanced technologies; as well as other risks and uncertainties, including but not limited to those detailed from time to time in Carrier Global CorporationÃÂÃÂs Securities and Exchange Commission filings.",https://www.businesswire.com/news/home/20201008005287/en/Carrier-and-AWS-Collaborate-to-Transform-How-Food-Medicine-Vaccines-and-Other-Perishable-Goods-Are-Moved-and-Monitored-Globally,businesswire.com,5,seattle palm beach garden flabusiness wiretoday amazon web service inc aws amazoncom company nasdaq amzn carrier global corporation nyse carr leading global provider healthy safe sustainable building cold chain solution announced multiyear agreement codevelop carrier new lynx digital platform suite tool provide carrier customer around world enhanced visibility increased connectivity actionable intelligence across cold chain operation improve outcome temperaturesensitive cargo including food medicine vaccine collaboration build carrier selection aws preferred cloud service provider february lynx platform combine awss iot analytics machine learning service carrier refrigeration monitoring solution extending carrier current digital offering managing temperaturecontrolled transport storage perishable customer using lynx platform benefit endtoend tracking realtime alert automated process predictive analytics help deliver temperaturecontrolled cargo efficiently turn decreasing cost cold chain operation optimizing resource utilization reducing cargo loss spoilage leveraging aws iot service collect integrate organize analyze data carrier large installed base refrigeration equipment monitoring solution along source traffic weather report lynx platform provide comprehensive view cargo location temperature condition external event could impact cold chain operation information feed data lake built amazon simple storage service amazon carrier use aws machine learning service identify potential issue could impact cargo well run sophisticated analytics develop recommendation improving outcome example analyzing historic realtime performance data carrier cloudconnected equipment lynx platform could suggest proactive maintenance maximize specific piece equipment availability looking ahead carrier aws plan introduce capability lynx platform provide recommendation related cargo routing improved fleet utilization adding greater resilience cold chain help carrier customer manage cost schedule resource carrier committed delivering healthier safer sustainable cold chain collaboration aws developing uniquely powerful ecosystem give customer greater flexibility visibility intelligence across cold chain said david appel president carrier refrigeration lynx platform help customer make faster datadriven decision improve effectiveness efficiency sustainability supply chain digital solution enhance connectivity across cold chain decreasing delay cargo critical global health wellbeing reducing cargo damage loss unanticipated cost carrier aws tackling complexity fragmentation cold chain give supply chain customer transparency flexibility insight require reduce risk deliver food medicine vaccine theyre needed said sarah cooper general manager iot solution amazon web service inc project combine carrier cold chain expertise awss digital experience unparalleled portfolio service highlight entire industry stand benefit digital transformation increased efficiency reduced cost greater dependability visit carriercomlynx learn amazon web service year amazon web service world comprehensive broadly adopted cloud platform aws offer fully featured service compute storage database networking analytics robotics machine learning artificial intelligence ai internet thing iot mobile security hybrid virtual augmented reality vr ar medium application development deployment management availability zone az within geographic region announced plan nine availability zone three aws region indonesia japan spain million customersincluding fastestgrowing startup largest enterprise leading government agenciestrust aws power infrastructure become agile lower cost learn aws visit awsamazoncom amazon amazon guided four principle customer obsession rather competitor focus passion invention commitment operational excellence longterm thinking customer review click shopping personalized recommendation prime fulfillment amazon aws kindle direct publishing kindle fire tablet fire tv amazon echo alexa product service pioneered amazon information visit follow amazonnews carrier leading global provider healthy safe sustainable building cold chain solution carrier global corporation committed making world safer sustainable comfortable generation come beginning weve led inventing new technology entirely new industry today continue lead worldclass diverse workforce put customer center everything information visit follow u social medium carrier press release contains forwardlooking statement concerning future business opportunity actual result may differ materially projected result certain risk uncertainty including limited challenge design development production support performance realization anticipated benefit advanced technology well risk uncertainty including limited detailed time time carrier global corporation security exchange commission filing,0.9989,0.49945,0.49945,0,Negative Impact
09/10/2020,160.5,164.45,159.89,164.33,164.33,98158000,2.13,76.34428766,1.192,0,9.3404,0.9034837908,0.2283735172,0.09,260.388,11579.94043,13252.62012,6016.700195,4946.810059,3272.075928,40509.48828,16562.80078,160.0930487,125.9370193,156.5688838,132.8155037,155.7276245,164.6958525,146.7593965,65.62074982,0.3577805983,-0.621623061,0.9794036595,4.816178458,151.9018672,9968888000,99.27782226,93.15359394,25,Prime Day Deals Revealed! Jumpstart Your Holiday Shopping on October 13 & 14,"SEATTLE--(BUSINESS WIRE)--Two full days of canÃÂÃÂt-miss savings are almost here as Amazon prepares to kick off Prime Day at 12am PT / 3am ET on October 13 in 19 countries worldwide. Prime members will have exclusive access to more than one million deals on everything they need and love, including the most popular, beloved brands and must-have holiday gifts across every category from toys, electronics, fashion, Amazon devices and more. Shop with Alexa on an Echo device beginning Sunday, October 11 to get early access to select deals on devices. Just ask, ÃÂÃÂAlexa, what are my Prime Day deals?ÃÂÃÂ Anyone can get a jump-start on their holiday shopping and savings this Prime Day by joining Prime or starting a free 30-day trial at amazon.com/primeday. Support Small Businesses Prime members can support small businesses this Prime Day by shopping deals featured in the Support Small storefront, Amazon Handmade and Amazon Launchpad. More than half of the items sold in AmazonÃÂÃÂs store worldwide are from third-party sellers ÃÂÃÂ mostly small and medium-sized businesses, and last Prime Day, these sellers surpassed $2 billion in sales. To make it easier than ever for customers to support small businesses, Amazon has launched new, curated collections to connect customers with local small businesses. Through October 12, Amazon is offering a $10 credit to use on Prime Day to members who spend $10 on items sold by select small businesses in AmazonÃÂÃÂs store. Visit amazon.com/supportsmall to start shopping. ""WeÃÂÃÂve been thrilled with the increased traffic and revenue Pawstruck has experienced this week since the Spend $10, Get $10 small business promotion launched,ÃÂÃÂ said Kyle Goguen, founder of Pawstruck in El Segundo, CA. ÃÂÃÂWeÃÂÃÂre anxiously awaiting Prime Day 2020, where we expect even greater results."" Prime Day Deals Preview When it comes to incredible deals on amazing products, Prime Day 2020 delivers in a big way with more deals than any Prime Day event before. Additionally, members can shop featured lightning deals, which offer jaw-dropping prices on top-tier brands and products. Watch for deals on Nintendo Switch Titles, Barbie & Hot Wheels toys, iRobot Roomba vacuums, Panasonic Cameras and Premium Beauty brands this Prime Day. These offers could sell out quickly so be sure to come back and shop the entire 48 hours of Prime Day to cash in on the biggest savings. A preview of Prime Day deals members can expect include: Amazon Devices Save 60% on our most popular smart speaker, Echo Dot (3rd Gen), just $18.99 Save up to $80 on Echo Show devices. Get the Echo Show 5 for $44.99, Echo Show 8 for $64.99, and Echo Show (2nd Gen) for $149.99 Take Alexa on the road with $30 off Echo Auto, now with Auto Mode in the Alexa App and Start My Commute features, just $19.99 Fire TV Edition Smart TVs start at just $79.99. Plus, get the Insignia 32-inch Smart HD Fire TV Edition TV for $109.99 and the Toshiba 43-inch Smart 4K UHD Fire TV Edition TV for $209.99 Save $40 on Fire TV Cube and use your voice to control your entertainment experience, just $79.99 Save up to 45% on Fire tablets. Get the Fire HD 10 for $79.99 and Fire 7 Kids Edition tablet for $59.99 Save $75 on eero Mesh WiFi system ensuring you have whole home WiFi coverage, just $174.00 Save $20 on Ring Stick Up Cam, just $79.99. Save 30% on Ring Video Doorbell devices and get Ring Video Doorbell (2nd Gen) for $69.99 Get Blink Mini Indoor Cam, just $24.99 Get your smart home started with Ring Video Doorbell 3 and Echo Show 5, just $149.99 Get an Echo Dot and LIFX Smart Bulb (Wi-Fi set up), just $18.99 Save $50 on Kindle Paperwhite, just $79.99 Save $35 on the Kindle Kids Edition, just $74.99 Electronics Save 36% on 12 Month Nintendo Switch Online Family Membership + SanDisk 128GB Memory Card Save up to 33% on select Nintendo Switch titles Save up to 33% on DJI Mavic Mini Drone and Osmo cameras Save up to 35% on Nixplay WIFI digital frames Save up to 40% off on Panasonic cameras Save up to 46% on Garmin GPS units and smartwatches Save up to 30% on Tile trackers Save 30% on select cell phone cases Save on JBL Boombox Save up to 30% on headphones from top brands Save up to 30% on select Samsung and Sony TVs Save 20% on Mynt 3D pens Save 20% on Sindoh 3D printers Save 30% on Dremel 3D20 DigiLab 3D Printer Smart Home Save $75 on Select August Locks and get a free Echo Dot(3rd Gen) Save up to 30% off Arlo Smart Home Security Products Save up to 33% on iRobot Roomba vacuums Save on myQ Smart Garage Hub Save up to 35% on Smart Home products from Moen, Leviton, Kasa and more Save on ecobee3 lite Smart Thermostat Save up to 44% on Shark vacuums Save up to 22% on Hamilton Beach Works with Alexa Smart Coffee Maker Small Businesses Including Amazon Launchpad and Amazon Handmade Save up to 47% on Parker Baby Co. baby products and gear Save up to 40% on Pawstruck natural dog treats Save up to 25% on Simply Gum natural breath mints and chewing gum Save 20% on select Amazon Launchpad products including Skoolzy STEM Peg Board Toddler Stacking Toys and Taco vs. Burrito, the surprisingly strategic card game Save up to 25% on select Amazon Launchpad products including Trifo Robot Vacuum Cleaners Save up to 20% on handcrafted gifts and dÃÂÃÂ©cor from Amazon Handmade Save 20% on pumpkin bakery soy candles from Amazon Handmade Maker, Lorenzen Candle Co Save 20% on rose embossing rolling pins from Amazon Handmade Maker, Algis Crafts Save 20% on blue simulated turquoise hoop earrings from Amazon Handmade Maker, MJLuLu Save 20% on dog leash holders from Amazon Handmade Maker, G3 Studios Home & Kitchen Save up to 30% on Classic Brands, Furrino, and Sauder furniture Save up to 30% on Zinus furniture Save up to 30% on Casper mattresses Save up to 35% on Bissell floorcare Save up to 40% on kitchen essentials from Le Creuset, Pyrex, Corelle and more Save up to 50% on Instant Pot products Save up to 30% on Cuisinart appliances and cookware Save up to 37% on Ninja kitchen products Toys & Games Save up to 30% on Arts & Crafts sets for kids Save up to 30% on Barbie & Hot Wheels toys Save up to 40% on Fashion Dolls and Accessories from brands like L.O.L. Surprise!, Calico Critters and Journey Girls Save up to 30% on NERF Toys Save up to 30% on Playskool, Sesame Street and Littlest Pet Shop toys Save up to 30% on toys from Marvel, Star Wars and more Save up to 30% on toys from Melissa & Doug, V-Tech, Battat, Hape and more Save up to 30% on Outdoor and Ride-on products Save up to 30% on games from Magic the Gathering, Exploding Kittens and more Save up to 30% on STEM toys and building sets Save 15% on AmScope Microscopes for Kids Fashion Save up to 40% on select Levi's for the whole family Save up to 35% on select Calvin Klein underwear Save up to 50% on select watches from Citizen, Bulova, Anne Klein, Fossil and more Save up to 30% on select men's and women's clothing and more from our brands Save up to 30% on select Cubcoats for kids Save up to 15% on select Fall fashion from Shopbop Save up to 40% on select dresses from Shopbop Save up to 30% on select styles from The Drop Save up to 40% on select Champion apparel Save up to 30% on select Tommy Hilfiger apparel Save up to 30% on select New Balance for the family Beauty Save up to 43% on PanasonicÃÂÃÂs menÃÂÃÂs grooming products Save more than 35% on Waterpik Counterop Aquarius products Save up to 55% on select oral care favorites from Crest Save up to 50% on select Conair products Save up to 50% on select men's grooming favorites from Braun and Gillette Save 20% on skin care products from brands including Aquaphor, Coppertone, Eucerin and Nivea Save up to 40% on Premium Beauty hair and skin care appliances from top brands like BaBylissPro, ghd, Foreo, NuFace, Paul Mitchell, PMD Beauty, Rusk and T3 Save up to 40% on Premium Beauty favorites from brands including Bioderma, Elemis, HAUS Laboratories by Lady Gaga, Mustela, Oribe, Redken and Stila Save 30% or more on Mario Badescu, Pureology, Nioxin, Philosophy, R+Co, Dermablend, Stila, BaBylisspRO, Glo Science, NuFace, PMD Beauty and many more Premium Beauty brands Health & Personal Care Save 50% on 23andMe Health + Ancestry Personal Genetic Service Kit Save up to 30% on Fitbit Versa 2, Versa Lite and Aria Air Save up to 30% on household essentials from Proctor & Gamble (P&G) Save up to 30% on ÃÂÃÂon the goÃÂÃÂ snack bars and ready to drink beverages Save up to 20% on select products from Nature's Bounty Save up to 20% on nutrition & wellness favorites from brands including Garden of Life, Culturelle and Dymatize Save up to 20% on Marpac white noise machines Save up to 25% on home air fresheners from brands including Finish, Air Wick, Woolite and Rid-X Save 15% on First Aid Only 299 All-Purpose First Aid Kit Save 20% on Scott washroom essentials Amazon Brands Save up to 35% on coffee and espresso from Happy Belly and Solimo Save up to 50% on Belei skin care products Save 20% on baby essentials from Mama Bear Save 20% on health and personal care products from Solimo Save 20% on snacks and grocery essentials from Happy Belly Save 20% on health and wellness products from Revly, Amazon Elements and Amazon Basic Care Save up to 40% on AmazonBasics products including luggage and travel gear, home furnishings, and kitchen essentials Automotive, Tools & Home Improvement Save 50% on Tire Installation Save 35% off on NOCO Products Save 20% on Shell Rotella T6 Full Synthetic 5W-40 Diesel Engine Oil Save 20% on Select Chemical Guys Kits and Microfiber Towels Save 20% on Select Chemical Guys Kits Save 30% on Select Camco Rhino Heavy Duty Tote Tanks Save up to 40% on DEWALT tools Save up to 40% on CRAFTSMAN tools Save on Sylvania light bulbs Save up to 15% on select Kidde smoke & carbon monoxide alarms Lawn & Garden Save on select Scotts lawn and garden products Save up to 20% on select Shop Succulents live plants Save up to 20% on select Costa Farms live plants Save up to 20% on select Briggs & Stratton power products Save up to 20% on select Classic Accessories patio covers Save up to 20% on select Worx fall clean up equipment and power tools Save up to 15% on select Worx Hydroshot pressure washer and PowerShare products Save up to 30% on select BLACK+DECKER string and hedge trimmers Baby Save up to 35% on baby feeding essentials Save up to 20% on baby bath essentials Save 20% on 4-Star baby products Save 20% or more on baby nursery essentials Save up to 20% on Evenflo products Sports & Outdoors Save up to 30% on select Segway self-balancing electric scooters Save up to 20% on select Speedo Swim apparel and equipment Save up to 35% on select adidas clothing, footwear and accessories Save up to 40% on Coleman Outdoor Essentials Pets Save 30% on Wellness dog & cat food and treats Save up to 20% on Bayer K9 Advantix Major Appliances Save up to 15% on GE Profile Ice Maker Save up to 20% on Midea Fridges and Freezers Save up to 20% on Winia Compact Appliances Save up to 15% on New Air Appliances Save up to 20% on Broan Range Hoods Save up to 20% on Cosmo Appliances Grocery Save up to 35% on select products from Orgain Save 35% on customer favorite beverages from brands including Keurig, Crystal Light and more Save 30% on Hershey's Halloween candy favorites Save up to 25% on ConAgra products Save 30% or more on select pantry staples from Campbell's, Izze's, Planters, Quaker, RX Bar and more Additional Deals from Across Amazon Spend $10, Get $10 In-Store: Prime members who shop online or in store at Whole Foods Market, as well as at Amazon Fresh, Amazon Go or Amazon Go Grocery, Amazon Books or Amazon Pop Up, and Amazon 4-star can receive up to $50 in Amazon.com credit to use on Prime Day by earning the ÃÂÃÂSpend $10, Get $10ÃÂÃÂ in-store offer. Amazon Fresh: New Fresh customers can enjoy $15 off their first order of $50 or more on Amazon Fresh. Amazon Music Unlimited: For just $0.99, Prime members who havenÃÂÃÂt yet tried Amazon Music Unlimited can get four months of the premium streaming tier with unlimited access to more than 60 million songs ad-free, and now a wide selection of popular podcasts. With purchase of select Amazon Echo devices on Prime Day, Prime members new to Amazon Music Unlimited can get six months free access to the premium music streaming tier now featuring podcasts. Prime Video: Enjoy a selection of titles to rent or buy at up to 50% off and for a limited time, customers will be able to subscribe to select channels for $0.99 per month for up to two months if they are not already subscribed. Only pay for the channels you want and cancel anytime. A full list of Prime Video deals, including the offer window for each, can be found at amazon.com/primememberdeals. Kindle Unlimited: New customers to Kindle Unlimited get 3 months free with a new subscription Kindle Book Deals: Receive a $5 credit on any Kindle book with the purchase of select Kindle devices. Books: Discover discount and flash deals on select multi-genre books and ebooks, including kids content Crown Channel: Prime members can grab free in-game content for Yahtzee with Buddies from Prime Gaming. Yahtzee with Buddies is featured in Season 2 of Chasing the Crown on Crown Channel. Chasing the Crown supports up-and-coming Twitch streamers, helping them build their audiences and hone their skills as they compete for a $50,000 cash prize. Season 2 starts Friday, Oct. 9 at twitch.tv/crown. Amazon Gift Cards: On October 13 and 14, Prime members will receive a $10 promotional credit when they purchase an Amazon Gift Card of $40 or more (including newly-launched Amazon Video eGift Cards, available on mobile) or reload their own gift card balance with $40 or more. This limited-time offer is available while supplies last and has a limit of one per Amazon customer account. The promotional credit will expire on November 29, 2020. Other restrictions apply. Audible: Prime members can save $50 on a year of Audible Premium Plus. Audible members will also get access to the Plus catalog, featuring more than 10K Audible Originals, audiobooks, wellness programs and podcasts, all available on an all-you-can-listen basis. One upcoming highlight of the Plus catalog is The Sesame Street Podcast with Foley & Friends, releasing only on Audible on October 14. This first podcast of its kind from the iconic childrenÃÂÃÂs show introduces preschool listeners to brand new Sesame Street character Foley, and includes original music, interactive games, jokes, and visits from friends like Elmo. IMDbPro: Prime members receive a 30-day free trial and save 60% on a new annual membership to IMDbPro at imdbpro.com, the essential resource for the entertainment industry, making it just $95 ÃÂÃÂ the lowest price of the year ÃÂÃÂ for a full year of access. IMDbPro members who join through the Prime Day offer are also eligible for 50% off Dropbox Plus for one year ÃÂÃÂ the largest discount offered ever. This exclusive, limited-time offer is available for new and returning IMDbPro memberships. Amazon Warehouse: Members save an extra 20% on thousands of quality pre-owned, used and open box items for the kitchen, home, office, sports and outdoors, including major appliances, furniture, home dÃÂÃÂ©cor and more. Visit amazon.com/amazonwarehouse. Woot!: Amazon's daily deal site will have deals with deep discounts and free shipping available only to Prime members from October 11 through October 17. Visit woot.com or download the Woot! app. Ways to Shop This Prime Day Shop with Alexa: Prime members can discover deals by asking ÃÂÃÂAlexa, what are my Prime Day deals?ÃÂÃÂ Plus, starting today and for a limited time, new Prime members who sign up for Prime using an Echo device will receive a $5 Amazon credit. Just say, ÃÂÃÂAlexa, sign me up for Prime.ÃÂÃÂ Holiday Gift Guides: Get an early start on holiday shopping with AmazonÃÂÃÂs biggest-ever selection of gift guides and exclusive storefronts, available earlier than ever before at amazon.com/gifts. Launching in time for Prime Day, AmazonÃÂÃÂs gift guides offer Prime members exclusive gifting selection and Prime Day deals from some of the hottest brands in toys, electronics, home, beauty, fashion and more. Amazon Prime Credit Cards: Now through October 31, eligible Prime members who apply and are approved for the Amazon Prime Rewards Visa Signature Card will instantly receive a $100 Gift Card. To apply, visit amazon.com/primevisa. Additionally, from October 12 through October 18, eligible Prime members with an Amazon Prime Rewards Visa Signature Card or Amazon Prime Store Card will receive up to 25% back on a curated selection of best-selling products across categories including consumer electronics, home, digital gaming, and more. More details can be found at amazon.com/pcb. Go In-Store: Prime members can visit AmazonÃÂÃÂs physical retail locations, including Whole Foods Market, Amazon 4-star, Amazon Books, Amazon Pop Up, and Amazon Fresh to find in-store deals. Amazon Live: Tune in to Amazon Live throughout Prime Day to see live product demonstrations, hear directly from brands, and shop canÃÂÃÂt miss deals the minute they go live. Customers will see products in action through cooking demonstrations, try-on hauls, and more, and celebrities and influencers will be joining live to surprise customers with exclusive experiences. Viewers can easily shop the products and brands featured through a carousel that updates in real-time as hosts discuss the products. To watch, visit amazon.com/primeday and via the Amazon Shopping app on Fire TV. AmazonSmile: Customers can visit smile.amazon.com and find the exact same Amazon experience ÃÂÃÂ amazing deals, wide selection, fast and free delivery options ÃÂÃÂ with the added bonus that AmazonSmile will donate a portion of the purchase price of eligible purchases to the charity of their choice. AmazonSmile customers can now shop AmazonSmile on the latest version of the Amazon app by opening the app and finding ÃÂÃÂSettingsÃÂÃÂ in the main menu (?), tap on ÃÂÃÂAmazonSmileÃÂÃÂ and follow the on-screen instructions to turn on AmazonSmile on your phone. Climate Pledge Friendly: Customers can discover and shop for products that have one or more of 19 different sustainability certifications, which help preserve the natural world. Get details at amazon.com/ClimatePledgeFriendly. Amazon Photos Prime Day Photos Sweepstakes: Customers can enter for a chance to win the Prime Day Photos Sweepstakes by downloading the Amazon Photos app, sharing a photo that shows how Prime delivers joy, tagging Amazon Photos (@amazon.photos on Instagram and @amazonphotos on Facebook and Twitter), and using the hashtag #PrimeDayPhotos. A total of 30 winners will receive $1,000 Amazon.com Gift Cards good for purchases on Amazon.com. Get details at amazon.com/primedayphotos. Amazon.com in Spanish: Customers can visit amazon.com/espanol or use the Amazon App to shop, browse, search for millions of products, read reviews, view their carts, and place orders in Spanish. On the mobile App customers can go to Settings and tap on ÃÂÃÂCountry and LanguageÃÂÃÂ to select Spanish. Amazon.com in Spanish gives customers the same convenient shopping experience in their preferred language on any device. Amazon App: Prime members can shop anytime, anywhere with the Amazon App to ensure you never miss a Prime Day deal. Every Day Made Better with Prime Prime was designed to make your life better every single day. Over 150 million paid members around the world enjoy the many benefits of Prime, including the best of shopping and entertainment. In the U.S. that includes unlimited access to award-winning movies and TV episodes with Prime Video, ad-free listening of 2 million songs plus thousands of stations and playlists with Amazon Music, unlimited access to more than 1,000 books and magazines with Prime Reading, free in-game content and games with Prime Gaming, Prime Day, and more. Prime members can also get deep discounts on select popular products at Whole Foods Market plus an additional 10 percent off hundreds of sale items. Prime was built on the foundation of unlimited fast, free shipping. In addition to more than 10 million items eligible for free One-Day Delivery coast to coast, Prime members in thousands of cities and towns across 47 major metropolitan areas have access to millions of items with free Same-Day Delivery and the option to pick up and return their Amazon packages for free through Amazon Hub, a contactless, click and collect service at no additional cost. Prime members also have access to free and fast grocery delivery from Amazon Fresh and Whole Foods Market in more than 2,000 cities and towns. Prime is $119 a year or $12.99 a month and new members can start a free trial of Amazon Prime at amazon.com/prime. College students can join Prime Student for 50% off and enjoy the benefits of Prime with a six-month trial at amazon.com/primestudent. Plus, for an additional $0.99 a month, student members can get Amazon Music Unlimited and stream over 60 million songs ad-free. Customers receiving government assistance through EBT can also qualify for a discounted Prime membership of $5.99 a month at amazon.com/qualify. Amazon Business customersÃÂÃÂfrom small businesses to large enterprises, as well as education, government and non-profit organizationsÃÂÃÂcan also take advantage of PrimeÃÂÃÂs fast, free shipping and exclusive business-relevant benefits with Business Prime, which starts at $69 per year as an add-on for customers with Amazon Prime on their personal account or $179 per year for up to three users at amazon.com/businessprime. About Amazon Amazon is guided by four principles: customer obsession rather than competitor focus, passion for invention, commitment to operational excellence, and long-term thinking. Customer reviews, 1-Click shopping, personalized recommendations, Prime, Fulfillment by Amazon, AWS, Kindle Direct Publishing, Kindle, Fire tablets, Fire TV, Amazon Echo, and Alexa are some of the products and services pioneered by Amazon. For more information, visit amazon.com/about and follow @AmazonNews.",https://www.businesswire.com/news/home/20201008006027/en/Prime-Day-Deals-Revealed%21-Jumpstart-Your-Holiday-Shopping-on-October-13-14,businesswire.com,5,seattlebusiness wiretwo full day cantmiss saving almost amazon prepares kick prime day pt et october country worldwide prime member exclusive access one million deal everything need love including popular beloved brand musthave holiday gift across every category toy electronics fashion amazon device shop alexa echo device beginning sunday october get early access select deal device ask alexa prime day deal anyone get jumpstart holiday shopping saving prime day joining prime starting free day trial amazoncomprimeday support small business prime member support small business prime day shopping deal featured support small storefront amazon handmade amazon launchpad half item sold amazon store worldwide thirdparty seller mostly small mediumsized business last prime day seller surpassed billion sale make easier ever customer support small business amazon launched new curated collection connect customer local small business october amazon offering credit use prime day member spend item sold select small business amazon store visit amazoncomsupportsmall start shopping weve thrilled increased traffic revenue pawstruck experienced week since spend get small business promotion launched said kyle goguen founder pawstruck el segundo ca anxiously awaiting prime day expect even greater result prime day deal preview come incredible deal amazing product prime day delivers big way deal prime day event additionally member shop featured lightning deal offer jawdropping price toptier brand product watch deal nintendo switch title barbie hot wheel toy irobot roomba vacuum panasonic camera premium beauty brand prime day offer could sell quickly sure come back shop entire hour prime day cash biggest saving preview prime day deal member expect include amazon device save popular smart speaker echo dot rd gen save echo show device get echo show echo show echo show nd gen take alexa road echo auto auto mode alexa app start commute feature fire tv edition smart tv start plus get insignia inch smart hd fire tv edition tv toshiba inch smart k uhd fire tv edition tv save fire tv cube use voice control entertainment experience save fire tablet get fire hd fire kid edition tablet save eero mesh wifi system ensuring whole home wifi coverage save ring stick cam save ring video doorbell device get ring video doorbell nd gen get blink mini indoor cam get smart home started ring video doorbell echo show get echo dot lifx smart bulb wifi set save kindle paperwhite save kindle kid edition electronics save month nintendo switch online family membership sandisk gb memory card save select nintendo switch title save dji mavic mini drone osmo camera save nixplay wifi digital frame save panasonic camera save garmin gps unit smartwatches save tile tracker save select cell phone case save jbl boombox save headphone top brand save select samsung sony tv save mynt pen save sindoh printer save dremel digilab printer smart home save select august lock get free echo dotrd gen save arlo smart home security product save irobot roomba vacuum save myq smart garage hub save smart home product moen leviton kasa save ecobee lite smart thermostat save shark vacuum save hamilton beach work alexa smart coffee maker small business including amazon launchpad amazon handmade save parker baby co baby product gear save pawstruck natural dog treat save simply gum natural breath mint chewing gum save select amazon launchpad product including skoolzy stem peg board toddler stacking toy taco v burrito surprisingly strategic card game save select amazon launchpad product including trifo robot vacuum cleaner save handcrafted gift dcor amazon handmade save pumpkin bakery soy candle amazon handmade maker lorenzen candle co save rose embossing rolling pin amazon handmade maker algis craft save blue simulated turquoise hoop earring amazon handmade maker mjlulu save dog leash holder amazon handmade maker g studio home kitchen save classic brand furrino sauder furniture save zinus furniture save casper mattress save bissell floorcare save kitchen essential le creuset pyrex corelle save instant pot product save cuisinart appliance cookware save ninja kitchen product toy game save art craft set kid save barbie hot wheel toy save fashion doll accessory brand like lol surprise calico critter journey girl save nerf toy save playskool sesame street littlest pet shop toy save toy marvel star war save toy melissa doug vtech battat hape save outdoor rideon product save game magic gathering exploding kitten save stem toy building set save amscope microscope kid fashion save select levi whole family save select calvin klein underwear save select watch citizen bulova anne klein fossil save select men womens clothing brand save select cubcoats kid save select fall fashion shopbop save select dress shopbop save select style drop save select champion apparel save select tommy hilfiger apparel save select new balance family beauty save panasonics men grooming product save waterpik counterop aquarius product save select oral care favorite crest save select conair product save select men grooming favorite braun gillette save skin care product brand including aquaphor coppertone eucerin nivea save premium beauty hair skin care appliance top brand like babylisspro ghd foreo nuface paul mitchell pmd beauty rusk save premium beauty favorite brand including bioderma elemi haus laboratory lady gaga mustela oribe redken stila save mario badescu pureology nioxin philosophy rco dermablend stila babylisspro glo science nuface pmd beauty many premium beauty brand health personal care save andme health ancestry personal genetic service kit save fitbit versa versa lite aria air save household essential proctor gamble pg save go snack bar ready drink beverage save select product nature bounty save nutrition wellness favorite brand including garden life culturelle dymatize save marpac white noise machine save home air freshener brand including finish air wick woolite ridx save first aid allpurpose first aid kit save scott washroom essential amazon brand save coffee espresso happy belly solimo save belei skin care product save baby essential mama bear save health personal care product solimo save snack grocery essential happy belly save health wellness product revly amazon element amazon basic care save amazonbasics product including luggage travel gear home furnishing kitchen essential automotive tool home improvement save tire installation save noco product save shell rotella full synthetic w diesel engine oil save select chemical guy kit microfiber towel save select chemical guy kit save select camco rhino heavy duty tote tank save dewalt tool save craftsman tool save sylvania light bulb save select kidde smoke carbon monoxide alarm lawn garden save select scott lawn garden product save select shop succulent live plant save select costa farm live plant save select briggs stratton power product save select classic accessory patio cover save select worx fall clean equipment power tool save select worx hydroshot pressure washer powershare product save select blackdecker string hedge trimmer baby save baby feeding essential save baby bath essential save star baby product save baby nursery essential save evenflo product sport outdoors save select segway selfbalancing electric scooter save select speedo swim apparel equipment save select adidas clothing footwear accessory save coleman outdoor essential pet save wellness dog cat food treat save bayer k advantix major appliance save ge profile ice maker save midea fridge freezer save winia compact appliance save new air appliance save broan range hood save cosmo appliance grocery save select product orgain save customer favorite beverage brand including keurig crystal light save hershey halloween candy favorite save conagra product save select pantry staple campbell izzes planter quaker rx bar additional deal across amazon spend get instore prime member shop online store whole food market well amazon fresh amazon go amazon go grocery amazon book amazon pop amazon star receive amazoncom credit use prime day earning spend get instore offer amazon fresh new fresh customer enjoy first order amazon fresh amazon music unlimited prime member havent yet tried amazon music unlimited get four month premium streaming tier unlimited access million song adfree wide selection popular podcasts purchase select amazon echo device prime day prime member new amazon music unlimited get six month free access premium music streaming tier featuring podcasts prime video enjoy selection title rent buy limited time customer able subscribe select channel per month two month already subscribed pay channel want cancel anytime full list prime video deal including offer window found amazoncomprimememberdeals kindle unlimited new customer kindle unlimited get month free new subscription kindle book deal receive credit kindle book purchase select kindle device book discover discount flash deal select multigenre book ebooks including kid content crown channel prime member grab free ingame content yahtzee buddy prime gaming yahtzee buddy featured season chasing crown crown channel chasing crown support upandcoming twitch streamer helping build audience hone skill compete cash prize season start friday oct twitchtvcrown amazon gift card october prime member receive promotional credit purchase amazon gift card including newlylaunched amazon video egift card available mobile reload gift card balance limitedtime offer available supply last limit one per amazon customer account promotional credit expire november restriction apply audible prime member save year audible premium plus audible member also get access plus catalog featuring k audible original audiobooks wellness program podcasts available allyoucanlisten basis one upcoming highlight plus catalog sesame street podcast foley friend releasing audible october first podcast kind iconic childrens show introduces preschool listener brand new sesame street character foley includes original music interactive game joke visit friend like elmo imdbpro prime member receive day free trial save new annual membership imdbpro imdbprocom essential resource entertainment industry making lowest price year full year access imdbpro member join prime day offer also eligible dropbox plus one year largest discount offered ever exclusive limitedtime offer available new returning imdbpro membership amazon warehouse member save extra thousand quality preowned used open box item kitchen home office sport outdoors including major appliance furniture home dcor visit amazoncomamazonwarehouse woot amazon daily deal site deal deep discount free shipping available prime member october october visit wootcom download woot app way shop prime day shop alexa prime member discover deal asking alexa prime day deal plus starting today limited time new prime member sign prime using echo device receive amazon credit say alexa sign prime holiday gift guide get early start holiday shopping amazon biggestever selection gift guide exclusive storefront available earlier ever amazoncomgifts launching time prime day amazon gift guide offer prime member exclusive gifting selection prime day deal hottest brand toy electronics home beauty fashion amazon prime credit card october eligible prime member apply approved amazon prime reward visa signature card instantly receive gift card apply visit amazoncomprimevisa additionally october october eligible prime member amazon prime reward visa signature card amazon prime store card receive back curated selection bestselling product across category including consumer electronics home digital gaming detail found amazoncompcb go instore prime member visit amazon physical retail location including whole food market amazon star amazon book amazon pop amazon fresh find instore deal amazon live tune amazon live throughout prime day see live product demonstration hear directly brand shop cant miss deal minute go live customer see product action cooking demonstration tryon haul celebrity influencers joining live surprise customer exclusive experience viewer easily shop product brand featured carousel update realtime host discus product watch visit amazoncomprimeday via amazon shopping app fire tv amazonsmile customer visit smileamazoncom find exact amazon experience amazing deal wide selection fast free delivery option added bonus amazonsmile donate portion purchase price eligible purchase charity choice amazonsmile customer shop amazonsmile latest version amazon app opening app finding setting main menu tap amazonsmile follow onscreen instruction turn amazonsmile phone climate pledge friendly customer discover shop product one different sustainability certification help preserve natural world get detail amazoncomclimatepledgefriendly amazon photo prime day photo sweepstakes customer enter chance win prime day photo sweepstakes downloading amazon photo app sharing photo show prime delivers joy tagging amazon photo amazonphotos instagram amazonphotos facebook twitter using hashtag primedayphotos total winner receive amazoncom gift card good purchase amazoncom get detail amazoncomprimedayphotos amazoncom spanish customer visit amazoncomespanol use amazon app shop browse search million product read review view cart place order spanish mobile app customer go setting tap country language select spanish amazoncom spanish give customer convenient shopping experience preferred language device amazon app prime member shop anytime anywhere amazon app ensure never miss prime day deal every day made better prime prime designed make life better every single day million paid member around world enjoy many benefit prime including best shopping entertainment u includes unlimited access awardwinning movie tv episode prime video adfree listening million song plus thousand station playlist amazon music unlimited access book magazine prime reading free ingame content game prime gaming prime day prime member also get deep discount select popular product whole food market plus additional percent hundred sale item prime built foundation unlimited fast free shipping addition million item eligible free oneday delivery coast coast prime member thousand city town across major metropolitan area access million item free sameday delivery option pick return amazon package free amazon hub contactless click collect service additional cost prime member also access free fast grocery delivery amazon fresh whole food market city town prime year month new member start free trial amazon prime amazoncomprime college student join prime student enjoy benefit prime sixmonth trial amazoncomprimestudent plus additional month student member get amazon music unlimited stream million song adfree customer receiving government assistance ebt also qualify discounted prime membership month amazoncomqualify amazon business customersfrom small business large enterprise well education government nonprofit organizationscan also take advantage prime fast free shipping exclusive businessrelevant benefit business prime start per year addon customer amazon prime personal account per year three user amazoncombusinessprime amazon amazon guided four principle customer obsession rather competitor focus passion invention commitment operational excellence longterm thinking customer review click shopping personalized recommendation prime fulfillment amazon aws kindle direct publishing kindle fire tablet fire tv amazon echo alexa product service pioneered amazon information visit amazoncomabout follow amazonnews,1,0.5,0.5,0,Negative Impact
14/10/2020,172.35,173.24,167.00,168.19,168.19,116254000,2.13,76.34428766,1.192,0,9.3404,0.9034837908,0.2283735172,0.09,260.388,11768.73047,13143.16016,5935.100098,4941.660156,3340.778076,40794.73828,16455.40039,160.927919,127.1032219,158.1766005,133.9388518,158.0102997,172.2662706,143.7543288,67.84964545,2.517903758,0.722108156,1.795795602,4.774036952,158.9812918,10134812000,73.34689288,84.46955675,26.39999962,Amazon's 'October Surprise' Sends Warning To Rival Streamers (NASDAQ:AMZN),"Amazon this week revealed plans to acquire ÃÂÃÂComing 2 AmericaÃÂÃÂ from Paramount, changing the trajectory of the sequel from screen to stream.",https://seekingalpha.com/article/4378982-amazons-october-surprise-sends-warning-to-rival-streamers,seekingalpha.com,6,amazon week revealed plan acquire coming america paramount changing trajectory sequel screen stream,0.1779,0.10674,0.27179,-0.16505,Negative Impact
15/10/2020,164.6005,167.79,164.00,166.93,166.93,104468000,2.13,76.34428766,1.192,0,9.3404,0.9034837908,0.2283735172,0.09,260.388,11713.87012,13137.25,5832.5,4837.419922,3332.183105,39728.41016,16501,161.061539,127.4759244,158.5199689,134.2671467,158.8350998,173.1547034,144.5154962,63.33477939,2.618610951,1.101408715,1.517202236,4.706787109,161.1975905,10030344000,61.20764712,74.88377306,26.96999931,Amazon.com to Webcast Third Quarter 2020 Financial Results Conference Call,"SEATTLE--(BUSINESS WIRE)--Amazon.com, Inc. (NASDAQ: AMZN) announced today that it will hold a conference call to discuss its third quarter 2020 financial results on October 29, 2020 at 2:30 p.m. PT/5:30 p.m. ET. The event will be webcast live, and the audio and associated slides will be available for at least three months thereafter at www.amazon.com/ir.",http://www.businesswire.com/news/home/20201015005958/en/Amazon.com-to-Webcast-Third-Quarter-2020-Financial-Results-Conference-Call,businesswire.com,5,seattlebusiness wireamazoncom inc nasdaq amzn announced today hold conference call discus third quarter financial result october pm pt pm et event webcast live audio associated slide available least three month thereafter,0,0,0.26237,-0.26237,Negative Impact
16/10/2020,168.1615,169.98,158.00,163.64,163.64,129488000,2.13,76.34428766,1.192,0,9.3404,0.9034837908,0.2283735172,0.09,260.388,11671.55957,13169.32031,5919.600098,4935.859863,3336.35791,39982.98047,16438.80078,161.109249,127.8195994,158.7205779,134.5593691,159.6295998,173.0963811,146.1628185,55.48037559,2.404662564,1.362059485,1.04260308,5.277323042,174.8119965,9900856000,44.97587455,59.84347152,27.40999985,Amazon Announces Two New Fulfillment Centers in Kansas,"SEATTLE--(BUSINESS WIRE)--Amazon Announces Two New Fulfillment Centers and a New Delivery Station in Kansas Bringing Over 1,000 New Jobs.",https://www.businesswire.com/news/home/20201016005504/en/Amazon-Announces-Two-New-Fulfillment-Centers-in-Kansas/,businesswire.com,5,seattlebusiness wireamazon announces two new fulfillment center new delivery station kansa bringing new job,0,0,0.3331833333,-0.333183333,Negative Impact
20/10/2020,161.114,163.30,159.60,160.85,160.85,90194000,2.13,76.34428766,1.192,0,9.3404,0.9034837908,0.2283735172,0.09,260.388,11516.49023,13092.16016,5889.200195,4929.279785,3328.100098,40544.37109,16273.2998,161.2178488,128.4811919,158.8658929,135.0751456,160.4665001,172.6461599,148.2868402,53.62266512,1.607781955,1.505015669,0.1027662862,5.547466823,174.1462414,9886578000,31.2647474,35.03101664,29.35000038,"Coronavirus updates: San Francisco to lift more restrictions, mayor says; stimulus talks inch forward","The coronavirus has infected more than 40.6 million people globally as of Tuesday, killing at least 1.1 million people so far.",https://www.cnbc.com/2020/10/20/coronavirus-live-updates.html,cnbc.com,9,coronavirus infected million people globally tuesday killing least million people far,-0.8225,-0.74025,0.147995,-0.888245,Negative Impact
21/10/2020,160.625,161.69,158.00,159.25,159.25,91854000,2.13,76.34428766,1.192,0,9.3404,0.9034837908,0.2283735172,0.09,260.388,11484.69043,13040.12988,5776.5,4853.950195,3325.02002,40707.30859,16230.2002,161.3221188,128.8007119,158.880838,135.3156615,160.9292,172.0944245,149.7639755,47.98655243,1.194692778,1.442951091,-0.248258313,5.542502267,173.8233166,9794724000,23.37039605,27.82919048,28.64999962,"Coronavirus update: CDC says nearly 300,000 excess American deaths have occurred during pandemic","The U.S. death toll from the coronavirus illness COVID-19 rose above 221,000 on Wednesday, according to data aggregated by Johns Hopkins University, and the...",https://www.marketwatch.com/story/coronavirus-update-cdc-says-virus-has-caused-deaths-of-nearly-300000-americans-2020-10-21,marketwatch.com,8,u death toll coronavirus illness covid rose wednesday according data aggregated john hopkins university,-0.765,-0.612,0.2038458,-0.8158458,Negative Impact
22/10/2020,159.4935,159.94,156.10,158.82,158.82,84240000,2.13,76.34428766,1.192,0,9.3404,0.9034837908,0.2283735172,0.09,260.388,11506.00977,13145.91992,5785.700195,4851.379883,3312.5,40558.48828,16279.40039,161.336279,129.1218194,158.8784525,135.5495356,161.3207253,171.5263056,151.1151449,53.15640419,0.8233710626,1.319035085,-0.495664023,5.465894427,173.5068502,9710484000,21.2682556,25.30113302,28.11000061,Sequans Oversold Ahead Of Q3 Results Spells Opportunity (NYSE:SQNS),Performance of large broadband customers suggests possible upside for Critical IoT in Q3. Verizon moves Sequans powered hotspot from retail to education market to meet demand.,https://seekingalpha.com/article/4380602-sequans-oversold-ahead-of-q3-results-spells-opportunity,seekingalpha.com,6,performance large broadband customer suggests possible upside critical iot q verizon move sequans powered hotspot retail education market meet demand,-0.4215,-0.2529,0.1995084783,-0.452408478,Negative Impact
23/10/2020,159.55,160.27,157.00,160.22,160.22,69334000,2.13,76.34428766,1.192,0,9.3404,0.9034837908,0.2283735172,0.09,260.388,11548.28027,13199.86035,5860.299805,4909.640137,3277.99707,40685.5,16304.09961,161.3796591,129.4476569,158.9310623,135.7950128,161.5939003,171.3418927,151.8459079,50.33852582,0.6347467693,1.182177422,-0.547430653,5.422322954,172.8104562,9779818000,28.1607041,24.26645192,27.54999924,Borat bounces back just ahead of U.S. elections,Borat bounces back just ahead of U.S. elections,https://www.investing.com/news/general/borat-bounces-back-just-ahead-of-us-elections-2331392,investing.com,5,borat bounce back ahead u election,0,0,0.2941625,-0.2941625,Negative Impact
26/10/2020,159.937,164.15,157.67,160.35,160.35,118024000,2.13,76.34428766,1.192,0,9.3404,0.9034837908,0.2283735172,0.09,260.388,11358.94043,12936.38965,5792,4816.120117,3251.118896,40145.5,16079.59961,161.4386792,129.7786269,158.9867855,136.039361,161.6763756,171.3489847,152.0037664,57.974154,0.4902608382,1.043794105,-0.553533267,5.49546596,172.141918,9897842000,22.73580398,24.05492123,32.45999908,"Exclusive: In fight with Amazon, India's Future Retail sees liquidation if Reliance deal fails","India's Future Retail Ltd (FRL) will go into liquidation if its deal to sell assets to Reliance Industries fails, the group told a Singapore arbitrator while arguing against Amazon.com Inc's bid to scupper the deal, a legal order seen by Reuters showed.",https://www.reuters.com/article/us-amazon-com-india-future-reliance-excl/exclusive-in-fight-with-amazon-indias-future-retail-sees-liquidation-if-reliance-deal-fails-idUSKBN27B25B,reuters.com,10,india future retail ltd frl go liquidation deal sell asset reliance industry fails group told singapore arbitrator arguing amazoncom inc bid scupper deal legal order seen reuters showed,-0.4215,-0.4215,0.06743888889,-0.488938889,Negative Impact
27/10/2020,161.247,164.58,160.57,164.32,164.32,85820000,2.13,76.34428766,1.192,0,9.3404,0.9034837908,0.2283735172,0.09,260.388,11431.34961,12817.87012,5729,4730.660156,3254.315918,40522.10156,16020.90039,161.5425992,130.1273844,159.1957938,136.3207256,162.0300003,171.5360129,152.5239877,56.91929642,0.6877284278,0.9725809698,-0.284852542,5.44039372,171.5001213,9983662000,43.91931226,31.60527345,33.34999847,"Earnings Outlook: Amazon earnings preview: Consumers' ÃÂÃÂstay-at-home response' to COVID-19? Shopping on Amazon, analysts say",Experts say Amazon has a chance to make gains in an in-demand pandemic category ÃÂÃÂ fitness,https://www.marketwatch.com/story/amazon-earnings-preview-consumers-stay-at-home-response-to-covid-19-shopping-on-amazon-analysts-say-11603820975,marketwatch.com,8,expert say amazon chance make gain indemand pandemic category fitness,0.802,0.6416,0.3149210345,0.3266789655,Positive Impact
28/10/2020,162.465,163.20,158.12,158.14,158.14,111766000,2.13,76.34428766,1.192,0,9.3404,0.9034837908,0.2283735172,0.09,260.388,11004.87012,12415.41992,5582.799805,4571.120117,3269.23999,39922.46094,15586.59961,161.3928894,130.4507195,159.1543512,136.5378229,162.065126,171.5046304,152.6256217,48.20467027,0.3418108975,0.8464269554,-0.504616058,5.674535479,170.8839964,9871896000,10.91107585,25.85539736,40.27999878,"Amazon launches first online store in the Nordics, gets off to rocky start",The launch got off to a rocky start with Amazon using the wrong flag for Sweden and mistranslating product descriptions.,https://www.cnbc.com/2020/10/28/amazon-launches-online-store-in-sweden.html,cnbc.com,9,launch got rocky start amazon using wrong flag sweden mistranslating product description,-0.34,-0.306,0.1229557895,-0.428955789,Negative Impact
29/10/2020,160.0635,162.86,158.20,160.55,160.55,131930000,2.13,76.34428766,1.192,0,9.3404,0.9034837908,0.2283735172,0.09,260.388,11185.58984,12502.29004,5581.799805,4569.669922,3272.72998,39749.85156,15670.7002,161.3434195,130.787967,159.2091024,136.7767551,162.0395012,171.4932316,152.5857708,44.78718388,0.2592679011,0.7289951445,-0.469727243,5.660356794,170.2925166,10003826000,23.79645921,26.20894911,37.59000015,"Cramer reacts to Amazon, Alphabet, Apple and Facebook earnings","""In most cases, the earnings estimates were way, way, way, way, way, way, way too low,"" the ""Mad Money"" host said.",https://www.cnbc.com/2020/10/29/cramer-reacts-to-amazon-alphabet-apple-and-facebook-earnings.html,cnbc.com,9,case earnings estimate way way way way way way way low mad money host said,-0.6486,-0.58374,0.2273629268,-0.811102927,Negative Impact
30/10/2020,157.8875,158.35,150.95,151.81,151.81,167728000,2.13,76.34428766,1.192,0,9.3404,0.9034837908,0.2283735172,0.09,260.388,10911.58984,12429.33008,5577.299805,4594.240234,3224.532959,39614.07031,15580.59961,161.0821994,131.0775195,158.9188433,136.9263147,161.8173759,172.0227478,151.6120041,22.66628115,-0.505805367,0.4820350423,-0.987840409,5.597572327,169.7246959,9836098000,3.622873543,12.77680287,38.02000046,Dow futures fall more than 300 points as Apple and Amazon shares decline after earnings,Major averages are on pace to post their worst weekly performance in months.,https://www.cnbc.com/2020/10/29/stock-market-futures-open-to-close-news.html,cnbc.com,9,major average pace post worst weekly performance month,-0.6249,-0.56241,0.1088378947,-0.671247895,Negative Impact
02/11/2020,153.087,153.99,147.51,150.22,150.22,145148000,2.13,76.34428766,1.192,0,9.3404,0.9034837908,0.2283735172,0.09,260.229,10957.61035,12662.16992,5655,4691.140137,3225.120117,39757.57813,15696.90039,160.8019595,131.3624594,158.577869,137.0586299,161.3305756,172.7639316,149.8972195,21.67026873,-1.225776357,0.1404727624,-1.36624912,5.816965376,168.598214,9690950000,10.5602674,12.65986672,37.13000107,Judge dismisses Amazon worker lawsuit over coronavirus safety,"Four Amazon workers filed a lawsuit against the company in June, alleging it failed to follow public health guidelines around the coronavirus.",https://www.cnbc.com/2020/11/02/judge-dismisses-amazon-worker-lawsuit-over-coronavirus-safety.html,cnbc.com,9,four amazon worker filed lawsuit company june alleging failed follow public health guideline around coronavirus,-0.5423,-0.48807,0.17130375,-0.65937375,Negative Impact
03/11/2020,150.9265,153.75,149.05,152.42,152.42,97958000,2.13,76.34428766,1.192,0,9.3404,0.9034837908,0.2283735172,0.09,260.229,11160.57031,12877.4502,5786.799805,4805.609863,3271.073975,40261.12891,15939.2002,160.5429095,131.651562,158.3364036,137.2114844,161.2017006,172.9882539,149.4151473,28.66940704,-1.600667645,-0.207755319,-1.392912326,5.706393651,166.9108366,9788908000,21.86459007,12.01591034,35.54999924,4 Safe Stocks to Buy and Hold for the Next 4 Years,The election won't impact the ability of these great companies to deliver for their shareholders.,https://www.fool.com/investing/2020/11/03/4-safe-stocks-to-buy-and-hold-for-the-next-4-years/,fool.com,7,election wont impact ability great company deliver shareholder,-0.6435,-0.45045,0.07296916667,-0.523419167,Negative Impact
04/11/2020,157.9995,162.24,156.99,162.06,162.06,136780000,2.13,76.34428766,1.192,0,9.3404,0.9034837908,0.2283735172,0.09,260.229,11590.78027,12978.9502,5883.299805,4922.850098,3277.439941,40616.14063,15998.7002,160.4375797,131.989987,158.4823485,137.4587134,161.3153755,173.0882242,149.5425269,44.6243245,-1.107341487,-0.387672553,-0.719668935,6.10900007,165.3584494,9925688000,64.74173027,32.38886258,29.56999969,3 Stay-at-Home Tech Stocks to Buy Right Now,Zoom and two other hot stocks could head higher if the crisis continues.,https://www.fool.com/investing/2020/11/04/3-stay-at-home-tech-stocks-to-buy-right-now/,fool.com,7,zoom two hot stock could head higher crisis continues,-0.6249,-0.43743,0.1188033333,-0.556233333,Negative Impact
05/11/2020,165.9985,168.34,164.44,166.10,166.10,115786000,2.13,76.34428766,1.192,0,9.3404,0.9034837908,0.2283735172,0.09,260.229,11890.92969,13199.12012,5906.200195,4983.990234,3320.133057,41340.16016,16298.2002,160.3177298,132.349342,158.7810802,137.7437014,161.644001,173.5726143,149.7153877,52.67396129,-0.385773773,-0.387292797,0.001519023456,5.701785496,147.5059967,10041474000,89.24839074,58.61823703,27.57999992,Court Defers To OSHA In Covid-19 Public-Nuisance Suit Against Amazon,A New York federal judge properly refrained from using public-nuisance litigation as a means of regulating workplace safety.,https://www.forbes.com/sites/wlf/2020/11/05/court-defers-to-osha-in-covid-19-public-nuisance-suit-against-amazon/,forbes.com,8,new york federal judge properly refrained using publicnuisance litigation mean regulating workplace safety,0.25,0.2,0.39976375,-0.19976375,Negative Impact
06/11/2020,165.232,166.10,161.60,165.57,165.57,92946000,2.13,76.34428766,1.192,0,9.3404,0.9034837908,0.2283735172,0.09,260.229,11895.23047,13218.66992,5910,4960.879883,3312.158936,41893.05859,16282.7998,160.2290997,132.7117745,159.0472534,138.020565,161.7058006,173.7056546,149.7059467,56.00830045,0.1415537289,-0.281523492,0.4230772205,5.536570958,147.9226767,9948528000,86.69722721,80.22911607,24.86000061,"Analysis: High-flying U.S. tech stocks get post-election lift, near new highs","A weaker-than-expected election performance by Democrats and fears of new coronavirus restrictions have prompted investors to double down on high-flying technology stocks, which have come roaring back in recent days to put the Nasdaq within striking distance of a record.",https://www.reuters.com/article/us-usa-election-markets-tax-analysis/analysis-high-flying-u-s-tech-stocks-get-post-election-lift-near-new-highs-idUSKBN27M2X5,reuters.com,10,weakerthanexpected election performance democrat fear new coronavirus restriction prompted investor double highflying technology stock come roaring back recent day put nasdaq within striking distance record,-0.6486,-0.6486,0.1729706667,-0.821570667,Negative Impact
09/11/2020,161.5515,164.45,155.61,157.19,157.19,143808000,2.13,76.34428766,1.192,0,9.3404,0.9034837908,0.2283735172,0.09,260.229,11713.78027,13611.65039,6186.299805,5336.319824,3373.72998,42597.42969,16475.90039,159.9710397,133.0406245,158.9743022,138.2112758,160.9578255,172.0479388,149.8677122,46.42456442,-0.115520797,-0.248322953,0.1328021556,5.983963013,148.3310231,9804720000,46.46731269,74.13764355,25.75,"Got $5,000? 3 Tech Stocks to Buy and Hold for the Long Term",These companies have what it takes to crush the market.,https://www.fool.com/investing/2020/11/09/got-5000-3-tech-stocks-buy-hold-for-long-term/,fool.com,7,company take crush market,-0.1531,-0.10717,0.243284375,-0.350454375,Negative Impact
10/11/2020,154.751,155.70,150.97,151.75,151.75,131820000,2.13,76.34428766,1.192,0,9.3404,0.9034837908,0.2283735172,0.09,260.229,11553.86035,13707.99023,6296.899902,5418.970215,3360.148926,43277.64844,16615.40039,159.5550998,133.336067,158.6910357,138.3459995,159.9363007,170.4206721,149.4519292,43.19338438,-0.749256165,-0.348509595,-0.40074657,6.163891384,148.7312026,9672900000,20.37539815,51.17997935,24.79999924,Trxade's stock rockets to pace premarket gainers after Amazon marketing agreement,"Shares of Trxade Group Inc. soared 56% in active trading to pace all of the premarket's gainers Tuesday, after the online platform for pharmaceutical purchases announced a market program agreement with Amazon.com Services. Trading volume spiked up to 4.5 million shares, compared with the full-day average of about 160,000 shares.",https://www.marketwatch.com/story/trxades-stock-rockets-to-pace-premarket-gainers-after-amazon-marketing-agreement-2020-11-10,marketwatch.com,8,share trxade group inc soared active trading pace premarkets gainer tuesday online platform pharmaceutical purchase announced market program agreement amazoncom service trading volume spiked million share compared fullday average share,0.8885,0.7108,0.1013046154,0.6094953846,Positive Impact
11/11/2020,153.089,156.96,152.50,156.87,156.87,87338000,2.13,76.34428766,1.192,0,9.3404,0.9034837908,0.2283735172,0.09,260.229,11786.42969,13724.78027,6382.100098,5445.209961,3342.202881,43593.67188,16774.09961,159.1933701,133.6559145,158.6196032,138.530313,159.3705009,169.1800886,149.5609133,48.36793206,-0.828920576,-0.444591791,-0.384328785,6.26146262,149.1233784,9760238000,44.94341123,37.26204069,23.45000076,This Is What Amazon Looks Like Broken Into 3 Pieces,The European Commission has disclosed it believes Amazon.com Inc. (NASDAQ: AMZN) has broken some of its antitrust rules.,https://247wallst.com/technology-3/2020/11/11/this-is-what-amazon-looks-like-broken-into-3-pieces/,247wallst.com,5,european commission disclosed belief amazoncom inc nasdaq amzn broken antitrust rule,-0.4767,-0.23835,0.1877184211,-0.426068421,Negative Impact
12/11/2020,157.9975,158.79,154.30,155.51,155.51,87240000,2.13,76.34428766,1.192,0,9.3404,0.9034837908,0.2283735172,0.09,260.229,11709.58984,13551.46973,6338.899902,5362.569824,3338.679932,43357.19141,16582.19922,158.7722003,133.9658146,158.4978151,138.699305,158.7995766,168.070388,149.5287651,46.05935777,-0.990020321,-0.553677497,-0.436342823,6.348963056,149.5077108,9672998000,38.43722283,34.58534407,25.35000038,Fired Amazon worker files discrimination lawsuit over pandemic conditions,"A former Amazon.com Inc worker who protested conditions at his New York City fulfillment center sued the retailer on Thursday, accusing it of discrimination for firing him and for putting Black and Hispanic workers at heightened risk of contracting COVID-19.",https://www.reuters.com/article/us-health-coronavirus-amazon-com-lawsuit/fired-amazon-worker-files-discrimination-lawsuit-over-pandemic-conditions-idUSKBN27S34E,reuters.com,10,former amazoncom inc worker protested condition new york city fulfillment center sued retailer thursday accusing discrimination firing putting black hispanic worker heightened risk contracting covid,-0.6908,-0.6908,0.2936318182,-0.984431818,Negative Impact
13/11/2020,156.1,157.09,154.27,156.44,156.44,75124000,2.13,76.34428766,1.192,0,9.3404,0.9034837908,0.2283735172,0.09,260.229,11829.29004,13761.32031,6316.399902,5380.160156,3310.10498,43443,16675.59961,158.5330106,134.2458371,158.4171363,138.8758343,158.439827,167.4759349,149.4037191,46.76764966,-1.031047081,-0.649151414,-0.381895667,6.086997986,149.8843565,9748122000,42.88427299,42.08830235,23.10000038,"Amazon is facing a lawsuit that accuses it of violating civil rights laws by failing to protect Black, Brown, and immigrant warehouse workers from COVID-19 while looking out for its mostly white managers (AMZN)","Amazon is facing a class action lawsuit that accuses it of violating state and federal civil rights laws by intentionally working harder to protect its managers, who are disproportionately white, from COVID-19, while not taking the same precautions with its overwhelmingly Black, Brown, and immigrant warehouse workers. ""Its reaction to the pandemic subjected those minority workers to health threats to which Amazon did not subject its primarily Caucasian management staff,"" according to the lawsuit, which was filed Thursday in a federal court in New York by Chris Smalls, a former worker at Amazon's fulfillment center in Staten Island, New York.",https://www.businessinsider.com/amazon-class-action-lawsuit-alleges-racial-discrimination-covid-19-response-2020-11,businessinsider.com,7,amazon facing class action lawsuit accuses violating state federal civil right law intentionally working harder protect manager disproportionately white covid taking precaution overwhelmingly black brown immigrant warehouse worker reaction pandemic subjected minority worker health threat amazon subject primarily caucasian management staff according lawsuit filed thursday federal court new york chris small former worker amazon fulfillment center staten island new york,-0.7845,-0.54915,0.1812263636,-0.730376364,Negative Impact
16/11/2020,154.66,157.14,153.63,156.55,156.55,76174000,2.13,76.34428766,1.192,0,9.3404,0.9034837908,0.2283735172,0.09,260.229,11924.12988,13982.19043,6421.299805,5471.47998,3346.968994,43443,16889.80078,158.3694504,134.5275521,158.3440327,139.0517265,158.2494514,167.2756088,149.2232941,43.14825593,-1.042467344,-0.7278146,-0.314652744,6.034819467,150.2534693,9824296000,43.42419713,41.58189765,22.45000076,"Got $10,000? 10 Stocks to Buy and Hold for 10 Years",Owning innovative companies with clear-cut competitive advantages is a recipe for wealth creation.,https://www.fool.com/investing/2020/11/16/got-10000-10-stocks-to-buy-and-hold-for-10-years/,fool.com,7,owning innovative company clearcut competitive advantage recipe wealth creation,0.872,0.6104,0.202775,0.407625,Positive Impact
17/11/2020,159.177,159.46,156.76,156.78,156.78,68894000,2.13,76.34428766,1.192,0,9.3404,0.9034837908,0.2283735172,0.09,260.229,11899.33984,13949.09961,6365.299805,5483,3339.899902,43952.71094,16948.09961,158.3552704,134.7990496,158.2828159,139.2281571,158.046077,167.0085428,149.0836112,48.6628776,-1.02118642,-0.786488964,-0.234697456,5.800284249,150.6151998,9893190000,44.52821455,43.61222822,22.70999908,Big Tech Isn't the Key to Big Profits ÃÂÃÂ This Is,"Washington's regulatory ÃÂÃÂhammerÃÂÃÂ isn't now aimed at every tech company, and it would be foolish to abandon the entire tech sector because a few companies are being scrutinized. Make sure you stay on the right side of the 'Technocasm.",https://investorplace.com/2020/11/big-tech-isnt-the-key-to-big-profits-this-is/,investorplace.com,6,washington regulatory hammer isnt aimed every tech company would foolish abandon entire tech sector company scrutinized make sure stay right side technocasm,-0.4019,-0.24114,0.2608,-0.50194,Negative Impact
18/11/2020,156.7,157.00,155.26,155.27,155.27,58336000,2.13,76.34428766,1.192,0,9.3404,0.9034837908,0.2283735172,0.09,260.229,11801.59961,13808.65039,6385.200195,5511.450195,3347.302979,44180.05078,16889.80078,158.1921204,135.0654471,158.1647837,139.3878072,157.847377,166.8737205,148.8210335,44.70177442,-1.113332498,-0.851857671,-0.261474827,5.587534223,150.9696958,9834854000,37.28039948,41.74427039,23.84000015,Walgreens: Amazon Driven Panic Makes This The Next 'Target',"The market is irrationally selling Walgreens off on the news of Amazon's entry as an online pharmacy. Walgreens is selling off more than CVS, which doesn't make sense given their lack of mail-order pharmacy exposure.",https://seekingalpha.com/article/4390027-walgreens-amazon-driven-panic-makes-this-next-target,seekingalpha.com,6,market irrationally selling walgreens news amazon entry online pharmacy walgreens selling cv doesnt make sense given lack mailorder pharmacy exposure,-0.4939,-0.29634,0.2725962069,-0.568936207,Negative Impact
19/11/2020,155.2655,156.25,154.05,155.85,155.85,60206000,2.13,76.34428766,1.192,0,9.3404,0.9034837908,0.2283735172,0.09,260.229,11904.70996,13863.23047,6334.399902,5474.660156,3363.087891,43599.96094,16909.80078,158.1340305,135.3321446,158.074047,139.5516201,157.6989265,166.7555256,148.6423275,54.85536777,-1.126730674,-0.906832271,-0.219898402,5.059211731,151.3171018,9895060000,40.05472481,40.62111295,23.11000061,Amazon und Global Optimism heiÃÂÃÂen Henkel und Signify zum Klimaversprechen (ÃÂÃÂThe Climate PledgeÃÂÃÂ) willkommen,"SEATTLE--(BUSINESS WIRE)--Heute gaben Amazon (NASDAQ: AMZN) und Global Optimism bekannt, dass Henkel dem Klimaversprechen beigetreten ist, einer Verpflichtung, bis 2040 netto null Kohlenstoff zu erreichen ÃÂÃÂ ein Jahrzehnt vor dem Ziel des Pariser Abkommens bis 2050. Signify, das bereits Anfang dieses Jahres die KlimaneutralitÃÂÃÂ¤t erreicht hat, tritt auch dem Klimaversprechen bei, um mit anderen Unterzeichnern zusammenzuarbeiten und bewÃÂÃÂ¤hrte Praktiken auszutauschen. Die Unterzeichner des Klimaversprechens stimmen zu: Treibhausgasemissionen regelmÃÂÃÂ¤ÃÂÃÂig zu messen und darÃÂÃÂ¼ber zu berichten; Dekarbonisierungsstrategien im Einklang mit dem Pariser Abkommen durch echte geschÃÂÃÂ¤ftliche VerÃÂÃÂ¤nderungen und Innovationen umzusetzen, einschlieÃÂÃÂlich Effizienzsteigerungen, erneuerbarer Energien, Materialreduzierungen und anderer Strategien zur Beseitigung von Kohlenstoffemissionen; alle verbleibenden Emissionen durch zusÃÂÃÂ¤tzliche, quantifizierbare, reale, dauerhafte und sozial nÃÂÃÂ¼tzliche AusgleichsmaÃÂÃÂnahmen zu neutralisieren, um bis 2040 einen jÃÂÃÂ¤hrlichen Netto-KohlenstoffausstoÃÂÃÂ von Null zu erreichen. ÃÂÃÂMit der Unterzeichnung des Klimaversprechens ergreifen Unternehmen auf der ganzen Welt kollektive MaÃÂÃÂnahmen, um unseren Planeten vor den katastrophalen Auswirkungen des Klimawandels zu schÃÂÃÂ¼tzenÃÂÃÂ, sagte Jeff Bezos, Founder und CEO von Amazon. ÃÂÃÂWir begrÃÂÃÂ¼ÃÂÃÂen Henkel, da sie sich unserer Verpflichtung anschlieÃÂÃÂen, bis 2040, ein Jahrzehnt vor dem Pariser Abkommen, netto null Kohlenstoff zu erreichen. Wir freuen uns auch darÃÂÃÂ¼ber, dass Signify, das Anfang dieses Jahres die KlimaneutralitÃÂÃÂ¤t erreicht hat, dem Klimaversprechen beitreten wird, mit dem Ziel, mit anderen Unterzeichnern zusammenzuarbeiten und bewÃÂÃÂ¤hrte Verfahren auszutauschen. Diese Unternehmen stellen eine wichtige FÃÂÃÂ¼hrungsrolle unter Beweis, da sie uns helfen, den ÃÂÃÂbergang zu einer kohlenstoffarmen Wirtschaft zu beschleunigen und den Planeten fÃÂÃÂ¼r kÃÂÃÂ¼nftige Generationen zu schÃÂÃÂ¼tzen.ÃÂÃÂ Das Engagement von Henkel fÃÂÃÂ¼r eine FÃÂÃÂ¼hrungsrolle im Bereich Nachhaltigkeit ist seit Jahrzehnten in der Unternehmenskultur verankert. Das Unternehmen arbeitet eng mit Amazon zusammen, um nachhaltige Innovationen zu fÃÂÃÂ¶rdern ÃÂÃÂ zum Beispiel, um das Kundenerlebnis durch neue und nachhaltige Verpackungen zu verbessern. Langfristiges Ziel von Henkel ist es, bis 2040 klimafreundlich zu werden. Kurzfristig plant das Unternehmen, den CO2-FuÃÂÃÂabdruck seiner Produktion bis 2025 um 65 % und bis 2030 um 75 % zu reduzieren. Bis 2030 soll der Strom, den Henkel fÃÂÃÂ¼r seinen Betriebsablauf verbraucht, zu 100 % aus erneuerbaren Quellen stammen. Und bis 2040 will Henkel alle verbleibenden in der Produktion eingesetzten fossilen Brennstoffe auf klimaneutrale Alternativen umgestellt haben und ÃÂÃÂ¼berschÃÂÃÂ¼ssige klimaneutrale Energie an Dritte liefern. DarÃÂÃÂ¼ber hinaus will Henkel mit seinen Marken und Technologien Kunden, Konsumenten und Lieferanten dabei unterstÃÂÃÂ¼tzen, in einem Zehnjahreszeitraum von 2016 bis 2025 100 Millionen Tonnen CO2 einzusparen. ÃÂÃÂDer Klimawandel ist eine globale Herausforderung, die unser gemeinsames Handeln erfordert. Wir bei Henkel wollen einen positiven Beitrag zum Klimaschutz leisten. Basierend auf dem bisher Erreichten und im Einklang mit unseren Ambitionen fÃÂÃÂ¼r die kommenden Jahre freuen wir uns, dem Klimaversprechen beizutreten und es zu unterstÃÂÃÂ¼tzenÃÂÃÂ, sagte der CEO von Henkel Carsten Knobel. ÃÂÃÂGemeinsam mit Amazon, Global Optimism und den anderen Unterzeichnern verpflichten wir uns, spÃÂÃÂ¼rbare Fortschritte voranzutreiben und gemeinsam MaÃÂÃÂnahmen zur Begrenzung der globalen ErwÃÂÃÂ¤rmung zu ergreifen.ÃÂÃÂ Signify, das weltweit fÃÂÃÂ¼hrende Unternehmen im Bereich Beleuchtung, ist ein weiteres neues Mitglied des Klimaversprechens. Auf der Klimakonferenz der Vereinten Nationen (COP 21), die im Dezember 2015 in Paris stattfand, verpflichtete sich Signify, bis 2020 kohlenstoffneutrale BetriebsablÃÂÃÂ¤ufe zu erreichen. Im vergangenen September gab es bekannt, dass es diesen Meilenstein erreicht hat und plant, seine positiven Auswirkungen auf die Umwelt und die Gesellschaft bis 2025 zu verdoppeln. Signify wird sich dem Klimaversprechen anschlieÃÂÃÂen, um seine Erfahrungen zu teilen und andere Unterzeichner dabei zu unterstÃÂÃÂ¼tzen und zu ermutigen, ihre eigenen Programme zur Reduzierung von Kohlenstoff voranzubringen. ÃÂÃÂWir freuen uns, der Gemeinschaft des Klimaversprechens beizutreten, da sie Unternehmen dazu mobilisiert, die Ziele des Pariser Abkommens 10 Jahre frÃÂÃÂ¼her zu erreichenÃÂÃÂ, sagte Harry Verhaar, Head of Global Public and Government Affairs bei Signify. ÃÂÃÂWir haben uns verpflichtet, mit anderen Unternehmen bewÃÂÃÂ¤hrte Praktiken aus unserer eigenen Reise zur KlimaneutralitÃÂÃÂ¤t im Jahr 2020 auszutauschen und unseren positiven Einfluss auf die Umwelt und die Gesellschaft zu verstÃÂÃÂ¤rken.ÃÂÃÂ ÃÂÃÂDie Pariser Vereinbarung legte einen vereinheitlichenden Fahrplan fÃÂÃÂ¼r alle LÃÂÃÂ¤nder, alle Unternehmen und alle Menschen fest, um der Klimakrise zu begegnen, indem wir MaÃÂÃÂnahmen ergreifen, um sicherzustellen, dass wir bei der globalen ErwÃÂÃÂ¤rmung die 1,5 ÃÂÃÂ°C nicht ÃÂÃÂ¼berschreitenÃÂÃÂ, sagte Christiana Figueres, die ehemalige UNO-Chefin fÃÂÃÂ¼r Klimawandel und jetzt Founding Partner von Global Optimism. ÃÂÃÂMit dem Beitritt zum Klimaversprechen demonstrieren diese Unternehmen sowohl ihre Ambitionen fÃÂÃÂ¼r die Zukunft als auch fÃÂÃÂ¼r die Erholung jetzt. Ihre Aktionen und Investitionen schaffen dringend benÃÂÃÂ¶tigte ArbeitsplÃÂÃÂ¤tze, regen Innovationen an, regenerieren die natÃÂÃÂ¼rliche Umwelt und helfen ihren Verbrauchern, nachhaltigere Produkte zu kaufen. Das wachsende Kollektiv von Unternehmen, die sich dem Klimaversprechen anschlieÃÂÃÂen und im Einklang mit der Wissenschaft handeln, gibt Anlass zu Optimismus.ÃÂÃÂ Letztes Jahr grÃÂÃÂ¼ndeten Amazon und Global Optimism gemeinsam The Climate Pledge, eine Verpflichtung, das Pariser Abkommen 10 Jahre frÃÂÃÂ¼her zu erreichen und bis 2040 netto kohlenstofffrei zu sein. Amazon war der erste Unterzeichner, und dreizehn Organisationen haben nun das Klimaversprechen unterzeichnet, darunter: Amazon, Best Buy, Henkel, Infosys, McKinstry, Mercedes-Benz, Oak View Group, Real Betis, Reckitt Benckiser, Schneider Electric, Siemens, Signify und Verizon ÃÂÃÂ womit ein wichtiges Signal gesendet wird, dass die Nachfrage nach Produkten und Dienstleistungen, die zur Reduzierung von Kohlenstoffemissionen beitragen, rasch zunehmen wird. ÃÂÃÂber Henkel Henkel ist weltweit mit einem ausgewogenen und diversifizierten Portfolio tÃÂÃÂ¤tig. Mit seinen drei GeschÃÂÃÂ¤ftsbereichen im Industrie- und KonsumgÃÂÃÂ¼terbereich nimmt das Unternehmen dank starker Marken, Innovationen und Technologien fÃÂÃÂ¼hrende Positionen ein. Henkel Adhesive Technologies ist weltweit fÃÂÃÂ¼hrend im Klebstoffmarkt ÃÂÃÂ in allen Industriesegmenten weltweit. In den GeschÃÂÃÂ¤ftsbereichen Laundry & Home Care und Beauty Care nimmt Henkel in vielen MÃÂÃÂ¤rkten und Kategorien weltweit fÃÂÃÂ¼hrende Positionen ein. Henkel wurde 1876 gegrÃÂÃÂ¼ndet und blickt auf mehr als 140 Jahre Erfolg zurÃÂÃÂ¼ck. Im Jahr 2019 erzielte Henkel einen Umsatz von mehr als 20 Milliarden Euro und einen bereinigten Betriebsgewinn von mehr als 3,2 Milliarden Euro. Henkel beschÃÂÃÂ¤ftigt weltweit mehr als 52.000 Mitarbeiter ÃÂÃÂ ein leidenschaftliches und sehr vielfÃÂÃÂ¤ltiges Team, vereint durch eine starke Unternehmenskultur, ein gemeinsames Ziel der nachhaltigen WertschÃÂÃÂ¶pfung und gemeinsame Werte. Als anerkannter MarktfÃÂÃÂ¼hrer im Bereich der Nachhaltigkeit nimmt Henkel in vielen internationalen Indizes und Rankings SpitzenplÃÂÃÂ¤tze ein. Die Vorzugsaktien von Henkel sind im Deutschen Aktienindex DAX gelistet. Weitere Informationen finden Sie unter www.henkel.com. ÃÂÃÂber Signify Signify (Euronext: LIGHT) ist weltweit fÃÂÃÂ¼hrend in der Beleuchtung fÃÂÃÂ¼r Fachleute und Verbraucher sowie in der Beleuchtung fÃÂÃÂ¼r das Internet der Dinge. Unsere Philips-Produkte, Interact-verbundene Beleuchtungssysteme und datengestÃÂÃÂ¼tzte Dienste liefern geschÃÂÃÂ¤ftlichen Nutzen und verÃÂÃÂ¤ndern das Leben in Wohnungen, GebÃÂÃÂ¤uden und ÃÂÃÂ¶ffentlichen RÃÂÃÂ¤umen. Mit einem Umsatz von 6,2 Milliarden Euro im Jahr 2019 haben wir rund 37.000 Mitarbeiter und sind in ÃÂÃÂ¼ber 70 LÃÂÃÂ¤ndern vertreten. Wir erschlieÃÂÃÂen das auÃÂÃÂergewÃÂÃÂ¶hnliche Potenzial von Licht fÃÂÃÂ¼r ein helleres Leben und eine bessere Welt. Wir haben im Jahr 2020 KohlenstoffneutralitÃÂÃÂ¤t erreicht und sind seit drei Jahren in Folge als BranchenfÃÂÃÂ¼hrer im Dow Jones Sustainability Index gelistet. Neuigkeiten von Signify finden Sie im Newsroom oder auf Twitter, LinkedIn und Instagram. Informationen fÃÂÃÂ¼r Investoren finden Sie auf der Seite Investor Relations. ÃÂÃÂber Amazon Amazon orientiert sich an vier GrundsÃÂÃÂ¤tzen: Orientierung am Kunden statt an der Konkurrenz, Leidenschaft fÃÂÃÂ¼r Neuerungen, Einsatz fÃÂÃÂ¼r betriebliche Optimierung sowie langfristiges Denken. Kundenrezensionen, 1-Klick-EinkÃÂÃÂ¤ufe, persÃÂÃÂ¶nliche Empfehlungen, Prime, Versand durch Amazon, AWS, Kindle Direct Publishing, Kindle, Fire-Tablets, Fire TV, Amazon Echo und Alexa sind nur einige der von Amazon angebotenen Produkte und Dienstleistungen. FÃÂÃÂ¼r weitere Informationen besuchen Sie amazon.com/about und folgen Sie @AmazonNews. Die Ausgangssprache, in der der Originaltext verÃÂÃÂ¶ffentlicht wird, ist die offizielle und autorisierte Version. ÃÂÃÂbersetzungen werden zur besseren VerstÃÂÃÂ¤ndigung mitgeliefert. Nur die Sprachversion, die im Original verÃÂÃÂ¶ffentlicht wurde, ist rechtsgÃÂÃÂ¼ltig. Gleichen Sie deshalb ÃÂÃÂbersetzungen mit der originalen Sprachversion der VerÃÂÃÂ¶ffentlichung ab.",https://www.businesswire.com/news/home/20201119005556/de/,businesswire.com,5,seattlebusiness wireheute gaben amazon nasdaq amzn und global optimism bekannt das henkel dem klimaversprechen beigetreten ist einer verpflichtung bi netto null kohlenstoff zu erreichen ein jahrzehnt vor dem ziel de pariser abkommens bi signify da bereits anfang diesis jahres die klimaneutralitt erreicht hat tritt auch dem klimaversprechen bei um mit anderen unterzeichnern zusammenzuarbeiten und bewhrte praktiken auszutauschen die unterzeichner de klimaversprechens stimmen zu treibhausgasemissionen regelmig zu messen und darber zu berichten dekarbonisierungsstrategien im einklang mit dem pariser abkommen durch echte geschftliche vernderungen und innovationen umzusetzen einschlielich effizienzsteigerungen erneuerbarer energien materialreduzierungen und anderer strategien zur beseitigung von kohlenstoffemissionen alle verbleibenden emissionen durch zustzliche quantifizierbare reale dauerhafte und sozial ntzliche ausgleichsmanahmen zu neutralisieren um bi einen jhrlichen nettokohlenstoffaussto von null zu erreichen mit der unterzeichnung de klimaversprechens ergreifen unternehmen auf der ganzen welt kollektive manahmen um unseren planeten vor den katastrophalen auswirkungen de klimawandels zu schtzen sagte jeff bezos founder und ceo von amazon wir begren henkel da sie sich unserer verpflichtung anschlieen bi ein jahrzehnt vor dem pariser abkommen netto null kohlenstoff zu erreichen wir freuen un auch darber das signify da anfang diesis jahres die klimaneutralitt erreicht hat dem klimaversprechen beitreten wird mit dem ziel mit anderen unterzeichnern zusammenzuarbeiten und bewhrte verfahren auszutauschen diese unternehmen stellen eine wichtige fhrungsrolle unter beweis da sie un helfen den bergang zu einer kohlenstoffarmen wirtschaft zu beschleunigen und den planeten fr knftige generationen zu schtzen da engagement von henkel fr eine fhrungsrolle im bereich nachhaltigkeit ist seit jahrzehnten der unternehmenskultur verankert da unternehmen arbeitet eng mit amazon zusammen um nachhaltige innovationen zu frdern zum beispiel um da kundenerlebnis durch neue und nachhaltige verpackungen zu verbessern langfristiges ziel von henkel ist e bi klimafreundlich zu werden kurzfristig plant da unternehmen den cofuabdruck seiner produktion bi um und bi um zu reduzieren bi soll der strom den henkel fr seinen betriebsablauf verbraucht zu au erneuerbaren quellen stammen und bi henkel alle verbleibenden der produktion eingesetzten fossilen brennstoffe auf klimaneutrale alternativen umgestellt haben und berschssige klimaneutrale energie dritte liefern darber hinaus henkel mit seinen marken und technologien kunden konsumenten und lieferanten dabei untersttzen einem zehnjahreszeitraum von bi millionen tonnen co einzusparen der klimawandel ist eine globale herausforderung die unser gemeinsames handeln erfordert wir bei henkel wollen einen positiven beitrag zum klimaschutz leisten basierend auf dem bisher erreichten und im einklang mit unseren ambitionen fr die kommenden jahre freuen wir un dem klimaversprechen beizutreten und e zu untersttzen sagte der ceo von henkel carsten knobel gemeinsam mit amazon global optimism und den anderen unterzeichnern verpflichten wir un sprbare fortschritte voranzutreiben und gemeinsam manahmen zur begrenzung der globalen erwrmung zu ergreifen signify da weltweit fhrende unternehmen im bereich beleuchtung ist ein weiteres neues mitglied de klimaversprechens auf der klimakonferenz der vereinten nationen cop die im dezember paris stattfand verpflichtete sich signify bi kohlenstoffneutrale betriebsablufe zu erreichen im vergangenen september gab e bekannt das e diesen meilenstein erreicht hat und plant seine positiven auswirkungen auf die umwelt und die gesellschaft bi zu verdoppeln signify wird sich dem klimaversprechen anschlieen um seine erfahrungen zu teilen und andere unterzeichner dabei zu untersttzen und zu ermutigen ihre eigenen programme zur reduzierung von kohlenstoff voranzubringen wir freuen un der gemeinschaft de klimaversprechens beizutreten da sie unternehmen dazu mobilisiert die ziele de pariser abkommens jahre frher zu erreichen sagte harry verhaar head global public government affair bei signify wir haben un verpflichtet mit anderen unternehmen bewhrte praktiken au unserer eigenen reise zur klimaneutralitt im jahr auszutauschen und unseren positiven einfluss auf die umwelt und die gesellschaft zu verstrken die pariser vereinbarung legte einen vereinheitlichenden fahrplan fr alle lnder alle unternehmen und alle menschen fest um der klimakrise zu begegnen indem wir manahmen ergreifen um sicherzustellen das wir bei der globalen erwrmung die c nicht berschreiten sagte christiana figueres die ehemalige unochefin fr klimawandel und jetzt founding partner von global optimism mit dem beitritt zum klimaversprechen demonstrieren diese unternehmen sowohl ihre ambitionen fr die zukunft al auch fr die erholung jetzt ihre aktionen und investitionen schaffen dringend bentigte arbeitspltze regen innovationen regenerieren die natrliche umwelt und helfen ihren verbrauchern nachhaltigere produkte zu kaufen da wachsende kollektiv von unternehmen die sich dem klimaversprechen anschlieen und im einklang mit der wissenschaft handeln gibt anlass zu optimismus letztes jahr grndeten amazon und global optimism gemeinsam climate pledge eine verpflichtung da pariser abkommen jahre frher zu erreichen und bi netto kohlenstofffrei zu sein amazon war der erste unterzeichner und dreizehn organisationen haben nun da klimaversprechen unterzeichnet darunter amazon best buy henkel infosys mckinstry mercedesbenz oak view group real betis reckitt benckiser schneider electric siemens signify und verizon womit ein wichtiges signal gesendet wird das die nachfrage nach produkten und dienstleistungen die zur reduzierung von kohlenstoffemissionen beitragen rasch zunehmen wird ber henkel henkel ist weltweit mit einem ausgewogenen und diversifizierten portfolio ttig mit seinen drei geschftsbereichen im industrie und konsumgterbereich nimmt da unternehmen dank starker marken innovationen und technologien fhrende positionen ein henkel adhesive technology ist weltweit fhrend im klebstoffmarkt allen industriesegmenten weltweit den geschftsbereichen laundry home care und beauty care nimmt henkel vielen mrkten und kategorien weltweit fhrende positionen ein henkel wurde gegrndet und blickt auf mehr al jahre erfolg zurck im jahr erzielte henkel einen umsatz von mehr al milliarden euro und einen bereinigten betriebsgewinn von mehr al milliarden euro henkel beschftigt weltweit mehr al mitarbeiter ein leidenschaftliches und sehr vielfltiges team vereint durch eine starke unternehmenskultur ein gemeinsames ziel der nachhaltigen wertschpfung und gemeinsame werte al anerkannter marktfhrer im bereich der nachhaltigkeit nimmt henkel vielen internationalen indizes und ranking spitzenpltze ein die vorzugsaktien von henkel sind im deutschen aktienindex dax gelistet weitere informationen finden sie unter ber signify signify euronext light ist weltweit fhrend der beleuchtung fr fachleute und verbraucher sowie der beleuchtung fr da internet der dinge unsere philipsprodukte interactverbundene beleuchtungssysteme und datengesttzte dienste liefern geschftlichen nutzen und verndern da leben wohnungen gebuden und ffentlichen rumen mit einem umsatz von milliarden euro im jahr haben wir rund mitarbeiter und sind ber lndern vertreten wir erschlieen da auergewhnliche potenzial von licht fr ein helleres leben und eine bessere welt wir haben im jahr kohlenstoffneutralitt erreicht und sind seit drei jahren folge al branchenfhrer im dow jones sustainability index gelistet neuigkeiten von signify finden sie im newsroom oder auf twitter linkedin und instagram informationen fr investoren finden sie auf der seite investor relation ber amazon amazon orientiert sich vier grundstzen orientierung kunden statt der konkurrenz leidenschaft fr neuerungen einsatz fr betriebliche optimierung sowie langfristiges denken kundenrezensionen klickeinkufe persnliche empfehlungen prime versand durch amazon aws kindle direct publishing kindle firetablets fire tv amazon echo und alexa sind nur einige der von amazon angebotenen produkte und dienstleistungen fr weitere informationen besuchen sie amazoncomabout und folgen sie amazonnews die ausgangssprache der der originaltext verffentlicht wird ist die offizielle und autorisierte version bersetzungen werden zur besseren verstndigung mitgeliefert nur die sprachversion die im original verffentlicht wurde ist rechtsgltig gleichen sie deshalb bersetzungen mit der originalen sprachversion der verffentlichung ab,-0.9963,-0.49815,0.25,-0.74815,Negative Impact
20/11/2020,155.851,156.64,154.90,154.97,154.97,67488000,2.13,76.34428766,1.192,0,9.3404,0.9034837908,0.2283735172,0.09,260.229,11854.96973,13827,6351.5,5495.890137,3377.72998,43882.25,17019.09961,158.1172104,135.5871746,157.9523197,139.7050368,157.4364265,166.4896903,148.3831628,55.79671305,-1.194666523,-0.964399122,-0.230267402,4.720818656,151.6575597,9827572000,30.69309593,36.00940674,23.70000076,"In pandemic Christmas, U.S. rivals aim to challenge Amazon under the tree","Walmart Inc, Best Buy Co Inc and hundreds of smaller retailers are bolstering their online gift features, hoping to challenge Amazon.com Inc's dominance as a seller of holiday gifts to homebound shoppers.",https://www.reuters.com/article/us-usa-holidayshopping-amazon-com-gifts/in-pandemic-christmas-u-s-rivals-aim-to-challenge-amazon-under-the-tree-idUSKBN2801D6,reuters.com,10,walmart inc best buy co inc hundred smaller retailer bolstering online gift feature hoping challenge amazoncom inc dominance seller holiday gift homebound shopper,0.9485,0.9485,0.2874135714,0.6610864286,Positive Impact
23/11/2020,155.835,156.99,153.27,154.92,154.92,94178000,2.13,76.34428766,1.192,0,9.3404,0.9034837908,0.2283735172,0.09,260.229,11880.62988,13998.24023,6333.799805,5492.149902,3414.48999,44077.14844,17094.5,158.1126303,135.8282946,157.8333854,139.8564244,157.164801,166.175628,148.153974,53.22109757,-1.238307199,-1.019180737,-0.219126462,4.650712149,151.9912084,9733394000,22.71966035,31.15582703,22.65999985,3 Retail Stocks Poised for a Bull Run,"In a strange year, retail stocks are booming, and these three look to continue their momentum into 2021.",https://www.fool.com/investing/2020/11/23/3-retail-stocks-poised-for-a-bull-run/,fool.com,7,strange year retail stock booming three look continue momentum,-0.2023,-0.14161,0.1986727778,-0.340282778,Negative Impact
24/11/2020,155.025,156.71,154.31,155.90,155.90,72042000,2.13,76.34428766,1.192,0,9.3404,0.9034837908,0.2283735172,0.09,260.229,12036.79004,14249.5,6432.200195,5558.419922,3402.822998,44523.01953,17274.30078,158.0745602,136.0701096,157.757684,140.0160918,156.7441261,165.1117617,148.3764905,39.78831023,-1.179930589,-1.051330708,-0.128599882,4.120533534,152.3181842,9805436000,28.38305664,27.26527097,21.63999939,Zalando erklÃÂÃÂ¤rt AWS zum bevorzugten Cloud-Anbieter,"MÃÂÃÂNCHEN--(BUSINESS WIRE)--Der Online-HÃÂÃÂ¤ndler Zalando hat Amazon Web Services, Inc. (AWS), ein Unternehmen von Amazon.com Inc. (NASDAQ: AMZN), zu seinem bevorzugten Cloud-Anbieter erklÃÂÃÂ¤rt. Das hat AWS heute bekannt gegeben. Zalando setzt in dem Zuge vollstÃÂÃÂ¤ndig auf Machine Learning Dienste von AWS, um seine gesamten Workloads fÃÂÃÂ¼r maschinelles Lernen in der weltweit fÃÂÃÂ¼hrenden Cloud zu betreiben. Zalando, ein Anbieter von Lifestyle- und Modeprodukten fÃÂÃÂ¼r mehr als 35 Millionen Kunden in 17 LÃÂÃÂ¤ndern, wird die Dienste von AWS nutzen, um schneller Innovationen zu entwickeln und ein noch personalisierteres Online-Shopping-Erlebnis zu ermÃÂÃÂ¶glichen. ZusÃÂÃÂ¤tzlich zum maschinellen Lernen (ML) setzt Zalando in weiteren Bereichen AWS-Technologien in ihrer gesamten Breite und Tiefe ein, darunter Dienste fÃÂÃÂ¼r Analytics, Compute, Datenbanken, Netzwerk, Serverless und Speicherung. Damit zielt Zalando darauf ab, sich noch stÃÂÃÂ¤rker hin zu einer datengetriebenen Organisation zu entwickeln und gleichzeitig kritische GeschÃÂÃÂ¤ftsfunktionen wie Supply Chain Management, Preisgestaltung, Marketing und Kundenbetreuung zu optimieren. Mit den AWS Machine Learning Services kann Zalando die Zeit fÃÂÃÂ¼r die Entwicklung, EinfÃÂÃÂ¼hrung und Skalierung neuer Funktionen der E-Commerce-Plattform verkÃÂÃÂ¼rzen und auf diese Weise die Kundenerfahrung kontinuierlich verbessern. Durch den Einsatz von Amazon SageMaker fÃÂÃÂ¼r schnelles Erstellen, Trainieren und Bereitstellen von ML-Modellen sowie Amazon EMR fÃÂÃÂ¼r die Erfassung, Speicherung und Analyse groÃÂÃÂer Datenmengen kÃÂÃÂ¶nnen die technischen Teams von Zalando die Kaufdaten der Kunden nutzen, um personalisierte Einkaufsfunktionen zu erstellen ÃÂÃÂ etwa individuelle Produkt- und GrÃÂÃÂ¶ÃÂÃÂenempfehlungen und die Vorhersage zukÃÂÃÂ¼nftiger Outfit-PrÃÂÃÂ¤ferenzen. Auch ausgefeilte personalisierte Empfehlungen basierend auf den individuellen Stilvorlieben der Kunden oder den ethischen Praktiken einer Marke sind fÃÂÃÂ¼r Zalando mit AWS Machine Learning mÃÂÃÂ¶glich. Ferner kann das Unternehmen mit Hilfe der ML-Dienste von AWS den Lagerbestand genauer vorausplanen, um die Paketliefer- und RÃÂÃÂ¼ckgabezeiten zu prÃÂÃÂ¤zisieren und die VerfÃÂÃÂ¼gbarkeit der neuesten Modetrends in Echtzeit zu prognostizieren. Durch die Zusammenarbeit mit AWS kann Zalando zudem neue Kundenanwendungen schneller entwickeln und implementieren. Dazu gehÃÂÃÂ¶rt beispielsweise die Erstellung digitaler Avatare, mit deren Hilfe die Kunden KleidungsstÃÂÃÂ¼cke virtuell anprobieren kÃÂÃÂ¶nnen, was in einem umfassenden Kundenerlebnis resultiert: Die KÃÂÃÂ¤ufer sehen, welche Outfits ihnen am besten passen, ohne sie physisch anprobieren zu mÃÂÃÂ¼ssen. Um die betriebliche Effizienz zu steigern und die GeschÃÂÃÂ¤ftsentwicklung anhand gewonnener Daten und Erkenntnisse nahezu in Echtzeit verfolgen zu kÃÂÃÂ¶nnen, nutzt Zalando ein breites Portfolio an AWS-Diensten. So erstellte Zalando mit AWS Lake Formation einen Data Lake, der auf dem Amazon Simple Storage Service (Amazon S3) basiert. Damit kÃÂÃÂ¶nnen Entwicklerteams sicher und effektiv an Projekten ÃÂÃÂ¼ber verschiedene Servicelinien hinweg zusammenarbeiten. ZusÃÂÃÂ¤tzlich zum Data Lake kombiniert Zalando Daten aus internen SAP-Anwendungen wie Buchhaltung, Lieferkettenmanagement und E-Commerce-Plattformen mit dem Analyseportfolio von AWS, einschlieÃÂÃÂlich AWS Glue, Amazon Redshift und Amazon Athena. Auf diese Weise lassen sich Transaktions- und Analysedatenberichte erstellen, die die GeschÃÂÃÂ¤ftsentwicklung in Echtzeit verfolgen. Mithilfe solcher Informationen kann das Size&Fit-Team von Zalando grÃÂÃÂ¶ÃÂÃÂenbedingte Retouren deutlich reduzieren. MÃÂÃÂ¶glich sind zum Beispiel Prognosen, wie die Passform eines KleidungsstÃÂÃÂ¼cks durch das Material oder den Stretch beeinflusst wird sowie GrÃÂÃÂ¶ÃÂÃÂenempfehlungen, die den jeweiligen PassformprÃÂÃÂ¤ferenzen eines Kunden entsprechen. DarÃÂÃÂ¼ber hinaus konnte Zalando durch die Migration seiner SAP-Anwendungen zu AWS den Zeitaufwand fÃÂÃÂ¼r das IT-Management um mehr als 30 Prozent reduzieren. ÃÂÃÂDurch die Zusammenarbeit mit AWS haben wir eine maschinelle Lernplattform der nÃÂÃÂ¤chsten Generation geschaffen, die es unseren Datenwissenschaftlern und Entwicklern ermÃÂÃÂ¶glicht, besser und effizienter mit Teams im gesamten Unternehmen zusammenzuarbeitenÃÂÃÂ, betonte Rodrigue SchÃÂÃÂ¤fer, Vice President Digital Foundation bei Zalando. ÃÂÃÂMithilfe dieser Plattform kÃÂÃÂ¶nnen wir die Zeit fÃÂÃÂ¼r die Entwicklung und Implementierung hochmoderner Personalisierungstools und neuer Produktfunktionen deutlich verkÃÂÃÂ¼rzen und auf diese Weise die Kundenerfahrung kontinuierlich verbessern. Die Nutzung einiger zusÃÂÃÂ¤tzlicher AWS-Dienste trÃÂÃÂ¤gt zudem dazu bei, die Betriebseffizienz in allen Phasen der Customer Journey zu steigern ÃÂÃÂ von der Lagerverwaltung bis hin zum Retouren-Management.ÃÂÃÂ ÃÂÃÂZalando ist einer der grÃÂÃÂ¶ÃÂÃÂten Online-HÃÂÃÂ¤ndler in Deutschland und Europa, und es ist groÃÂÃÂartig zu sehen, wie Zalando bei maschinellem Lernen vollstÃÂÃÂ¤ndig auf AWS setzt, um sein Wachstum und seine Innovationsstrategie zu unterstÃÂÃÂ¼tzen. Mit Millionen von Kunden in ganz Europa ist Zalando ein groÃÂÃÂartiges Beispiel fÃÂÃÂ¼r ein Unternehmen, das mithilfe von Machine Learning skalierbar neue und stÃÂÃÂ¤rker personalisierte Funktionen entwickelt, testet und einfÃÂÃÂ¼hrtÃÂÃÂ, erlÃÂÃÂ¤uterte Klaus BÃÂÃÂ¼rg, General Manager fÃÂÃÂ¼r Amazon Web Services EMEA SARL in Deutschland, ÃÂÃÂsterreich und der Schweiz. ÃÂÃÂDadurch dass Zalando das gesamte Portfolio von AWS in Verbindung mit maschinellem Lernen einsetzt, entwickelt sich das Unternehmen zu einer datengetriebenen, flexibleren und skalierbareren Organisation, die Erkenntnisse ÃÂÃÂ¼ber ihre Kunden nutzt, um das Online-Einkaufserlebnis neu zu gestalten.ÃÂÃÂ ÃÂÃÂber Amazon Web Services Seit 14 Jahren ist Amazon Web Services die umfangreichste und am weitesten verbreitete Cloud-Plattform der Welt. AWS bietet mehr als 175 Dienste fÃÂÃÂ¼r Datenverarbeitung, Datenspeicherung, Datenbanken, Netzwerke, Analysen, Robotik, maschinelles Lernen, kÃÂÃÂ¼nstliche Intelligenz (KI), das Internet der Dinge, mobile Applikationen, Sicherheit, hybride Umgebungen, Virtual und Augmented Reality (VR und AR), Media sowie die Entwicklung, Bereitstellung und Verwaltung von Anwendungen. Die AWS Cloud ist in 77 VerfÃÂÃÂ¼gbarkeitszonen innerhalb von 24 Regionen verfÃÂÃÂ¼gbar. 15 weitere VerfÃÂÃÂ¼gbarkeitszonen und fÃÂÃÂ¼nf weitere AWS Regionen in Indien, Indonesien, Japan, Spanien und der Schweiz sind bereits angekÃÂÃÂ¼ndigt. Millionen von Kunden ÃÂÃÂ darunter einige der am schnellsten wachsenden Startup-Unternehmen sowie groÃÂÃÂe Konzerne und wichtige BehÃÂÃÂ¶rden ÃÂÃÂ vertrauen auf AWS, wenn es darum geht, agiler zu werden, Kosten zu senken und ihre Infrastruktur leistungsfÃÂÃÂ¤higer zu machen. Weitere Informationen zu AWS finden Sie unter https://aws.amazon.com/. ÃÂÃÂber Amazon Amazon wird von vier Grundprinzipien geleitet: Fokus auf den Kunden statt auf den Wettbewerb, Leidenschaft fÃÂÃÂ¼rs Erfinden, Verpflichtung zu operativer Exzellenz und langfristiges Denken. Kundenrezensionen, 1-Click Shopping, personalisierte Empfehlungen, Prime, Versand durch Amazon, AWS, Kindle Direct Publishing, Kindle, Fire Tablets, Fire TV, Amazon Echo und Alexa sind nur einige der Produkte und Dienstleistungen, fÃÂÃÂ¼r die Amazon Pionierarbeit geleistet hat. Weitere Informationen finden Sie unter amazon.com/about und @AmazonNews. ÃÂÃÂber Zalando Zalando ist Europas fÃÂÃÂ¼hrende Online-Plattform fÃÂÃÂ¼r Mode und Lifestyle. Im Jahr 2008 in Berlin gegrÃÂÃÂ¼ndet, bietet Zalando heute mehr als 35 Millionen aktiven Kunden in 17 LÃÂÃÂ¤ndern Produkte aus den Bereichen Bekleidung, Schuhe, Accessoires und Kosmetik. Das Sortiment umfasst weltbekannte, internationale Marken ebenso wie lokale Labels. Unseren Kunden bietet die Zalando-Plattform eine Destination fÃÂÃÂ¼r Inspiration, Innovation und Interaktion. Als Europas modischstes Tech-Unternehmen suchen wir laufend nach neuen digitalen LÃÂÃÂ¶sungen fÃÂÃÂ¼r jeden Teil des Einkaufserlebnisses ÃÂÃÂ fÃÂÃÂ¼r unsere Kunden, Partner und alle anderen Akteure, die Zalando mit uns gestalten wollen. Unser Ziel ist, zur ersten Anlaufstelle fÃÂÃÂ¼r Mode zu werden sowie eine nachhaltige Plattform mit einer netto-positiven Auswirkung auf Mensch und Erde.",https://www.businesswire.com/news/home/20201124005279/de/,businesswire.com,5,mnchenbusiness wireder onlinehndler zalando hat amazon web service inc aws ein unternehmen von amazoncom inc nasdaq amzn zu seinem bevorzugten cloudanbieter erklrt da hat aws heute bekannt gegeben zalando setzt dem zuge vollstndig auf machine learning dienste von aws um seine gesamten workload fr maschinelles lernen der weltweit fhrenden cloud zu betreiben zalando ein anbieter von lifestyle und modeprodukten fr mehr al millionen kunden lndern wird die dienste von aws nutzen um schneller innovationen zu entwickeln und ein noch personalisierteres onlineshoppingerlebnis zu ermglichen zustzlich zum maschinellen lernen ml setzt zalando weiteren bereichen awstechnologien ihrer gesamten breite und tiefe ein darunter dienste fr analytics compute datenbanken netzwerk serverless und speicherung damit zielt zalando darauf ab sich noch strker hin zu einer datengetriebenen organisation zu entwickeln und gleichzeitig kritische geschftsfunktionen wie supply chain management preisgestaltung marketing und kundenbetreuung zu optimieren mit den aws machine learning service kann zalando die zeit fr die entwicklung einfhrung und skalierung neuer funktionen der ecommerceplattform verkrzen und auf diese weise die kundenerfahrung kontinuierlich verbessern durch den einsatz von amazon sagemaker fr schnelles erstellen trainieren und bereitstellen von mlmodellen sowie amazon emr fr die erfassung speicherung und analyse groer datenmengen knnen die technischen team von zalando die kaufdaten der kunden nutzen um personalisierte einkaufsfunktionen zu erstellen etwa individuelle produkt und grenempfehlungen und die vorhersage zuknftiger outfitprferenzen auch ausgefeilte personalisierte empfehlungen basierend auf den individuellen stilvorlieben der kunden oder den ethischen praktiken einer marke sind fr zalando mit aws machine learning mglich ferner kann da unternehmen mit hilfe der mldienste von aws den lagerbestand genauer vorausplanen um die paketliefer und rckgabezeiten zu przisieren und die verfgbarkeit der neuesten modetrends echtzeit zu prognostizieren durch die zusammenarbeit mit aws kann zalando zudem neue kundenanwendungen schneller entwickeln und implementieren dazu gehrt beispielsweise die erstellung digitaler avatare mit deren hilfe die kunden kleidungsstcke virtuell anprobieren knnen einem umfassenden kundenerlebnis resultiert die kufer sehen welche outfit ihnen besten passen ohne sie physisch anprobieren zu mssen um die betriebliche effizienz zu steigern und die geschftsentwicklung anhand gewonnener daten und erkenntnisse nahezu echtzeit verfolgen zu knnen nutzt zalando ein breites portfolio awsdiensten erstellte zalando mit aws lake formation einen data lake der auf dem amazon simple storage service amazon basiert damit knnen entwicklerteams sicher und effektiv projekten ber verschiedene servicelinien hinweg zusammenarbeiten zustzlich zum data lake kombiniert zalando daten au internen sapanwendungen wie buchhaltung lieferkettenmanagement und ecommerceplattformen mit dem analyseportfolio von aws einschlielich aws glue amazon redshift und amazon athena auf diese weise lassen sich transaktions und analysedatenberichte erstellen die die geschftsentwicklung echtzeit verfolgen mithilfe solcher informationen kann da sizefitteam von zalando grenbedingte retouren deutlich reduzieren mglich sind zum beispiel prognosen wie die passform eines kleidungsstcks durch da material oder den stretch beeinflusst wird sowie grenempfehlungen die den jeweiligen passformprferenzen eines kunden entsprechen darber hinaus konnte zalando durch die migration seiner sapanwendungen zu aws den zeitaufwand fr da itmanagement um mehr al prozent reduzieren durch die zusammenarbeit mit aws haben wir eine maschinelle lernplattform der nchsten generation geschaffen die e unseren datenwissenschaftlern und entwicklern ermglicht besser und effizienter mit team im gesamten unternehmen zusammenzuarbeiten betonte rodrigue schfer vice president digital foundation bei zalando mithilfe dieser plattform knnen wir die zeit fr die entwicklung und implementierung hochmoderner personalisierungstools und neuer produktfunktionen deutlich verkrzen und auf diese weise die kundenerfahrung kontinuierlich verbessern die nutzung einiger zustzlicher awsdienste trgt zudem dazu bei die betriebseffizienz allen phasen der customer journey zu steigern von der lagerverwaltung bi hin zum retourenmanagement zalando ist einer der grten onlinehndler deutschland und europa und e ist groartig zu sehen wie zalando bei maschinellem lernen vollstndig auf aws setzt um sein wachstum und seine innovationsstrategie zu untersttzen mit millionen von kunden ganz europa ist zalando ein groartiges beispiel fr ein unternehmen da mithilfe von machine learning skalierbar neue und strker personalisierte funktionen entwickelt testet und einfhrt erluterte klaus brg general manager fr amazon web service emea sarl deutschland sterreich und der schweiz dadurch das zalando da gesamte portfolio von aws verbindung mit maschinellem lernen einsetzt entwickelt sich da unternehmen zu einer datengetriebenen flexibleren und skalierbareren organisation die erkenntnisse ber ihre kunden nutzt um da onlineeinkaufserlebnis neu zu gestalt ber amazon web service seit jahren ist amazon web service die umfangreichste und weitesten verbreitete cloudplattform der welt aws bietet mehr al dienste fr datenverarbeitung datenspeicherung datenbanken netzwerke analysen robotik maschinelles lernen knstliche intelligenz ki da internet der dinge mobile applikationen sicherheit hybride umgebungen virtual und augmented reality vr und ar medium sowie die entwicklung bereitstellung und verwaltung von anwendungen die aws cloud ist verfgbarkeitszonen innerhalb von regionen verfgbar weitere verfgbarkeitszonen und fnf weitere aws regionen indien indonesien japan spanien und der schweiz sind bereits angekndigt millionen von kunden darunter einige der schnellsten wachsenden startupunternehmen sowie groe konzerne und wichtige behrden vertrauen auf aws wenn e darum geht agiler zu werden kosten zu senken und ihre infrastruktur leistungsfhiger zu machen weitere informationen zu aws finden sie unter ber amazon amazon wird von vier grundprinzipien geleitet fokus auf den kunden statt auf den wettbewerb leidenschaft fr erfinden verpflichtung zu operativer exzellenz und langfristiges denken kundenrezensionen click shopping personalisierte empfehlungen prime versand durch amazon aws kindle direct publishing kindle fire tablet fire tv amazon echo und alexa sind nur einige der produkte und dienstleistungen fr die amazon pionierarbeit geleistet hat weitere informationen finden sie unter amazoncomabout und amazonnews ber zalando zalando ist europa fhrende onlineplattform fr mode und lifestyle im jahr berlin gegrndet bietet zalando heute mehr al millionen aktiven kunden lndern produkte au den bereichen bekleidung schuhe accessoires und kosmetik da sortiment umfasst weltbekannte internationale marken ebenso wie lokale label unseren kunden bietet die zalandoplattform eine destination fr inspiration innovation und interaktion al europa modischstes techunternehmen suchen wir laufend nach neuen digitalen lsungen fr jeden teil de einkaufserlebnisses fr unsere kunden partner und alle anderen akteure die zalando mit un gestalt wollen unser ziel ist zur ersten anlaufstelle fr mode zu werden sowie eine nachhaltige plattform mit einer nettopositiven auswirkung auf mensch und erde,-0.9991,-0.49955,0.3448888889,-0.844438889,Negative Impact
25/11/2020,157.0935,159.90,157.01,159.25,159.25,75808000,2.13,76.34428766,1.192,0,9.3404,0.9034837908,0.2283735172,0.09,260.229,12094.40039,14191.58008,6391.100098,5571.290039,3362.326904,43828.10156,17313.09961,158.1815302,136.3263771,157.8163433,140.2075088,156.7998505,165.2212696,148.3784313,38.37426888,-0.853471522,-1.011758871,0.1582873488,3.957318987,152.6386204,9881244000,54.73681981,35.2798456,21.25,India's NSE warned Future Retail of action over disclosures on Amazon dispute: emails,"India's National Stock Exchange (NSE) privately warned Future Retail it risked regulatory action for not making timely market disclosures about efforts by Amazon.com to block a disputed asset sale, according to e-mails reviewed by Reuters.",https://www.reuters.com/article/us-amazon-com-india-future-reliance/indias-nse-warned-future-retail-of-action-over-disclosures-on-amazon-dispute-emails-idUSKBN2850M7,reuters.com,10,india national stock exchange nse privately warned future retail risked regulatory action making timely market disclosure effort amazoncom block disputed asset sale according email reviewed reuters,-0.7003,-0.7003,0.024928,-0.725228,Negative Impact
27/11/2020,160.563,160.81,159.50,159.77,159.77,47858000,2.13,76.34428766,1.192,0,9.3404,0.9034837908,0.2283735172,0.09,260.229,12205.84961,14198.5,6367.600098,5598.180176,3408.306885,44149.71875,17396.59961,158.3681403,136.5877446,157.8928395,140.4021306,156.760675,165.1156581,148.405692,40.14272818,-0.547009292,-0.918808955,0.3717996626,3.747033255,152.9526479,9929102000,65.24933676,49.4564044,20.84000015,Ebay Vs. Amazon - Value Vs. Growth,"EBay is Seth Klarmans Largest position offering strong cash flows, buybacks and asset sales. Amazon on the other hand is a pure growth stock, but the growth can also provide a margin of safety.",https://seekingalpha.com/article/4391785-ebay-vs-amazon-value-vs-growth,seekingalpha.com,6,ebay seth klarmans largest position offering strong cash flow buyback asset sale amazon hand pure growth stock growth also provide margin safety,0.9493,0.56958,0.104203,0.465377,Positive Impact
30/11/2020,160.424,161.42,156.28,158.40,158.40,81278000,2.13,76.34428766,1.192,0,9.3404,0.9034837908,0.2283735172,0.09,260.229,12198.74023,14006.45996,6266.200195,5518.549805,3391.76001,44149.71875,17190.30078,158.5812701,136.846037,157.9128063,140.5812337,157.0903999,165.1371428,149.043657,52.71071294,-0.40955916,-0.816958996,0.4073998359,3.402676174,153.2603949,9847824000,71.11193241,63.69936299,20.56999969,"Cramer bemoans market rotation, says FAANG stocks are 'still the best in show'","""I'm so sick of hearing that it's time to rotate into the small caps, or the oils, or the cyclical smokestack stocks,"" the ""Mad Money"" host said.",https://www.cnbc.com/2020/11/30/cramer-bemoans-market-rotation-says-faang-names-still-best-in-show.html,cnbc.com,9,im sick hearing time rotate small cap oil cyclical smokestack stock mad money host said,-0.7579,-0.68211,0.2929472222,-0.975057222,Negative Impact
01/12/2020,159.425,162.45,157.86,161.00,161.00,90740000,2.13,76.34428766,1.192,0,9.3404,0.9034837908,0.2283735172,0.09,260.474,12355.11035,14146.63965,6384.700195,5581.640137,3451.939941,44655.44141,17296.90039,158.8408801,137.1121395,158.0340295,140.7844453,157.6293999,165.16767,150.0911297,73.63226812,-0.089635618,-0.67149432,0.5818587021,3.286640712,153.5619869,9938564000,85.48884141,73.95003686,20.77000046,BlackBerry's stock soars after development agreement with Amazon's AWS,"Shares of BlackBerry Ltd. soared 34.6% in active premarket trading Tuesday, after the security software services company and Amazon.com Inc.'s Amazon Web Services Inc. cloud business announced a ""multi-year, global agreement"" to develop BlackBerry's Intelligent Vehicle Data Platform, IVY.",https://www.marketwatch.com/story/blackberrys-stock-soars-after-development-agreement-with-amazons-aws-2020-12-01,marketwatch.com,8,share blackberry ltd soared active premarket trading tuesday security software service company amazoncom inc amazon web service inc cloud business announced multiyear global agreement develop blackberry intelligent vehicle data platform ivy,0.9217,0.73736,0.3101322807,0.4272277193,Positive Impact
02/12/2020,161.0825,161.60,158.66,160.18,160.18,62586000,2.13,76.34428766,1.192,0,9.3404,0.9034837908,0.2283735172,0.09,260.474,12349.37012,14188.24023,6463.399902,5583.009766,3449.381104,44618.03906,17358.19922,158.9154202,137.370467,158.1180479,140.977401,158.0171997,165.2176167,150.8167827,60.81704158,0.09602687051,-0.517990082,0.6140169527,3.124534607,153.8575471,9875978000,75.2466487,77.28247417,21.17000008,This Is the Big Ticking Time Bomb in Retail's Recovery,The industry needs to get out in front of this disaster in the making before it's too late.,https://www.fool.com/investing/2020/12/02/this-is-the-big-ticking-time-bomb-in-retails-recov/,fool.com,7,industry need get front disaster making late,-0.6249,-0.43743,0.2128210714,-0.650251071,Negative Impact
03/12/2020,160.273,161.43,159.07,159.34,159.34,57840000,2.13,76.34428766,1.192,0,9.3404,0.9034837908,0.2283735172,0.09,260.474,12377.17969,14217.17969,6490.299805,5574.359863,3442.135986,44632.64844,17398,159.1022903,137.6288745,158.1658304,141.1600786,157.8811249,164.8594477,150.9028021,62.9396044,0.1733863562,-0.379714795,0.5531011507,2.972748893,154.1471961,9818138000,66.09087583,75.60878865,21.28000069,"Uber, Rivian, JetBlue, Cabify und Boom Supersonic unterzeichnen Klimaschutzversprechen","SEATTLE--(BUSINESS WIRE)--Heute gaben Amazon (NASDAQ: AMZN) und Global Optimism im Rahmen des Web Summit 2020 bekannt, dass sich Boom Supersonic, Cabify, JetBlue, Rivian und Uber dem Klimaschutzversprechen (ÃÂÃÂThe Climate PledgeÃÂÃÂ) angeschlossen haben, einer Verpflichtung, bis 2040 ÃÂÃÂ ein Jahrzehnt vor dem Ziel des Pariser Abkommens von 2050 ÃÂÃÂ Netto-KlimaneutralitÃÂÃÂ¤t zu erreichen. Die Unterzeichner des Klimaversprechens stimmen zu: Treibhausgasemissionen regelmÃÂÃÂ¤ÃÂÃÂig zu messen und darÃÂÃÂ¼ber zu berichten; Dekarbonisierungsstrategien im Einklang mit dem Pariser Abkommen durch echte geschÃÂÃÂ¤ftliche VerÃÂÃÂ¤nderungen und Innovationen umzusetzen, einschlieÃÂÃÂlich Effizienzsteigerungen, erneuerbarer Energien, Materialreduzierungen und anderer Strategien zur Beseitigung von Kohlenstoffemissionen; alle verbleibenden Emissionen durch zusÃÂÃÂ¤tzliche, quantifizierbare, reale, dauerhafte und sozial nÃÂÃÂ¼tzliche AusgleichsmaÃÂÃÂnahmen zu neutralisieren, um bis 2040 einen jÃÂÃÂ¤hrlichen Netto-KohlenstoffausstoÃÂÃÂ von Null zu erreichen. ÃÂÃÂMit der Unterzeichnung des Klimaschutzversprechens gehen Unternehmen auf der ganzen Welt die mutige Verpflichtung ein, unseren Planeten vor den verheerenden Auswirkungen des Klimawandels zu schÃÂÃÂ¼tzenÃÂÃÂ, sagte Jeff Bezos, der GrÃÂÃÂ¼nder und CEO von Amazon. ÃÂÃÂDer Transportsektor spielt eine entscheidende Rolle bei der Beschleunigung unserer Kohlenstoffreduktionsziele, und wir begrÃÂÃÂ¼ÃÂÃÂen Boom, Cabify, JetBlue, Rivian und Uber, die sich uns auf dem Weg zu einem kohlenstofffreien Klima bis 2040 anschlieÃÂÃÂen. Die 18 Unternehmen, die das Klimaschutzversprechen bisher unterzeichnet haben, demonstrieren FÃÂÃÂ¼hrungsstÃÂÃÂ¤rke im notwendigen ÃÂÃÂbergang zu einer kohlenstoffarmen Wirtschaft, die dazu beitrÃÂÃÂ¤gt, die Umwelt fÃÂÃÂ¼r kÃÂÃÂ¼nftige Generationen zu erhalten.ÃÂÃÂ Boom revolutioniert den kommerziellen Flugverkehr, indem das Unternehmen den ÃÂÃÂberschallverkehr wieder zurÃÂÃÂ¼ck an den Himmel bringt. Das zukunftsweisende Passagierflugzeug von Boom, die Overture, wurde nach branchenweit fÃÂÃÂ¼hrenden Standards hinsichtlich Geschwindigkeit, Sicherheit und Nachhaltigkeit entwickelt. Im Februar 2020 kÃÂÃÂ¼ndigte das Unternehmen an, dass das Testprogramm fÃÂÃÂ¼r seinen XB-1-Demonstrator kohlenstoffneutral sein wird, und zwar durch die Verwendung nachhaltiger Flugkraftstoffe und qualitativ hochwertige, geprÃÂÃÂ¼fte CO2-Kompensation. Boom hat sich darÃÂÃÂ¼ber hinaus dazu verpflichtet, die Overture in der Entwicklung, der Erprobung und im Betrieb zu einem netto-klimaneutralen Flugzeug zu machen, und ist Mitglied mehrerer Organisationen, die sich fÃÂÃÂ¼r eine beschleunigte EinfÃÂÃÂ¼hrung und Bereitstellung nachhaltiger Flugkraftstoffe fÃÂÃÂ¼r die Luftfahrtindustrie engagieren. Bei der Umsetzung seiner Vision, die Welt zugÃÂÃÂ¤nglicher zu machen, betrachtet Boom Geschwindigkeit und Nachhaltigkeit als kompatible Ziele. ÃÂÃÂBeim Bau des weltweit schnellsten Verkehrsflugzeugs setzt Boom auf einen allumfassenden Nachhaltigkeitsansatz. Da wir Nachhaltigkeit von Tag eins an zu einer UnternehmensprioritÃÂÃÂ¤t gemacht haben, konnten wir von Anfang an optimale Vorgehensweisen des Umweltschutzes in unsere Initiativen integrierenÃÂÃÂ, sagte Blake Scholl, der GrÃÂÃÂ¼nder und CEO von Boom. ÃÂÃÂWir schlieÃÂÃÂen uns sehr gerne dem Klimaschutzversprechen an, um dafÃÂÃÂ¼r zu sorgen, dass Geschwindigkeit und Nachhaltigkeit miteinander im Einklang stehen.ÃÂÃÂ Cabify ist die erste und einzige App fÃÂÃÂ¼r stÃÂÃÂ¤dtische MobilitÃÂÃÂ¤t in Europa und Lateinamerika, die klimaneutral ist, indem sie 100 % aller CO2-Emissionen kompensiert, die sie erzeugt ÃÂÃÂ durch ihren GeschÃÂÃÂ¤ftsbetrieb und fÃÂÃÂ¼r jede ÃÂÃÂ¼ber die App gebuchte Fahrt. Auch die durch den GeschÃÂÃÂ¤ftsbetrieb des Unternehmens anfallenden Emissionen werden von Cabify genau gemessen und reduziert, und das Unternehmen strebt eine Elektrifizierung seiner Fahrzeugflotte in Spanien und Lateinamerika ÃÂÃÂ bis 2025 bzw. 2030 an ÃÂÃÂ, um seine CO2-Emissionen zu reduzieren. Das Unternehmen engagiert sich durch groÃÂÃÂ angelegte Unternehmungen in Chile, Peru und Brasilien unter Anwendung von LÃÂÃÂ¶sungen fÃÂÃÂ¼r den CO2-Ausgleich, wie der Blockchain-Technologie, fÃÂÃÂ¼r die Verbesserung des Umweltschutzes und die FÃÂÃÂ¶rderung erneuerbarer Energien. ÃÂÃÂEffiziente stÃÂÃÂ¤dtische MobilitÃÂÃÂ¤t ist im Kampf gegen den Klimawandel von entscheidender BedeutungÃÂÃÂ, sagte Juan de Antonio, der GrÃÂÃÂ¼nder und CEO von Cabify. ÃÂÃÂCabify will Teil der LÃÂÃÂ¶sung sein, und deshalb haben wir uns im dritten Jahr in Folge verpflichtet, die CO2-Emissionen, die unsere Fahrer und BetriebsstÃÂÃÂ¤tten verursachen, auszugleichen, wÃÂÃÂ¤hrend wir weiterhin die Elektrifizierung der Flotten, mit denen wir zusammenarbeiten, unterstÃÂÃÂ¼tzen. Wir freuen uns, uns dem Klimaschutzversprechen anzuschlieÃÂÃÂen, um unsere Nachhaltigkeitsreise weiterhin transparent zu gestalten.ÃÂÃÂ JetBlue ist die erste Fluggesellschaft, die sich dem Klimaschutzversprechen anschlieÃÂÃÂt, und dies unterstreicht die Entschlossenheit des Unternehmens, messbare Schritte hin zur Verringerung seiner Klimabilanz zu unternehmen. Im Juli 2020 war JetBlue die erste und einzige US-amerikanische Fluggesellschaft, die CO2-NeutralitÃÂÃÂ¤t bei allen InlandsflÃÂÃÂ¼gen erreichte. Sie geht nun davon aus, den Ausgleich der CO2-Emissionen auf mehr als sieben Millionen Tonnen pro Jahr erhÃÂÃÂ¶hen zu kÃÂÃÂ¶nnen. Dies entspricht einem jÃÂÃÂ¤hrlichen Wegfall von 1,5 Millionen Pkw von den StraÃÂÃÂen. JetBlue betrachtet den CO2-Ausgleich als ÃÂÃÂbergangslÃÂÃÂ¶sung, wÃÂÃÂ¤hrend die Fluggesellschaft die Intensivierung des Einsatzes kohlenstoffÃÂÃÂ¤rmerer Technologien, wie z. B. nachhaltiger Flugkraftstoffe, und den Bau treibstoffeffizienterer Flugzeuge und BetriebsstÃÂÃÂ¤tten, fortsetzt. Seit Juli 2020 fÃÂÃÂ¼hrt JetBlue regelmÃÂÃÂ¤ÃÂÃÂig vom San Francisco International Airport aus FlÃÂÃÂ¼ge durch und verwendet dabei einen nachhaltigen Flugtreibstofftyp, der eine Reduzierung der CO2-Emissionen um bis zu 80 Prozent ermÃÂÃÂ¶glicht, bevor er mit herkÃÂÃÂ¶mmlichem Kerosin gemischt wird. ÃÂÃÂFlugreisen verbinden Menschen und Kulturen und unterstÃÂÃÂ¼tzen eine globalisierte Wirtschaft. Unser Nachhaltigkeitsanspruch ist im Zuge der Vorbereitungen unseres Unternehmens auf eine neue KlimarealitÃÂÃÂ¤t noch wichtiger gewordenÃÂÃÂ, sagte Robin Hayes, der CEO von JetBlue. ÃÂÃÂWir sind stolz darauf, uns dem Klimaschutzversprechen und einer Gemeinschaft gleichgesinnter Unternehmen anzuschlieÃÂÃÂen, die sich fÃÂÃÂ¼r das Erreichen der Netto-KlimaneutralitÃÂÃÂ¤t bis 2040 einsetzen. Die Klimakrise ist nach wie vor eine der grÃÂÃÂ¶ÃÂÃÂten Bedrohungen fÃÂÃÂ¼r unsere Branche. Unser Planet verÃÂÃÂ¤ndert sich substanziell ÃÂÃÂ genauso wie die Erwartungen unserer Kunden, Besatzungsmitglieder und Investoren. Es ist jetzt an der Zeit, den Betrieb auf nachhaltigere Verfahren umzustellen, wie beispielsweise durch die EinfÃÂÃÂ¼hrung von nachhaltigem Flugkraftstoff und die Festlegung eindeutiger Strategien zur Reduzierung der Netto-CO2-Emissionen im Luftverkehr.ÃÂÃÂ Rivian bringt eine Serie von auf Abenteuer ausgerichteten Fahrzeugen sowie Lieferwagen speziell fÃÂÃÂ¼r Anwendungen der letzten Meile von Amazon auf den Markt. Die ersten Produkte des Unternehmens, der R1T und der R1S, bieten eine einzigartige Kombination aus Leistung, GelÃÂÃÂ¤ndegÃÂÃÂ¤ngigkeit und Nutzen. Diese Fahrzeuge basieren auf der flexiblen Rollbrett-Plattform des Unternehmens und werden in der Fertigungsanlage von Rivian in Normal, Illinois, hergestellt. Die Auslieferung an die Kunden soll im Juni 2021 beginnen. ÃÂÃÂRivian wurde gegrÃÂÃÂ¼ndet, um dazu beizutragen, die Art von Zukunft schaffen, die unsere Kinder und unsere Kindeskinder verdienen. Das Engagement von Rivian fÃÂÃÂ¼r eine nachhaltige Fahrzeugproduktion bei unseren Endkundenprodukten und Nutzfahrzeugen wird von diesem zentralen Ziel bestimmtÃÂÃÂ, sagte RJ Scaringe, der GrÃÂÃÂ¼nder und CEO von Rivian. ÃÂÃÂDer Kampf gegen den Klimawandel macht es notwendig, dass Einzelpersonen und ganze Branchen gemeinsam LÃÂÃÂ¶sungen zu schaffen, die die Denkweise der Verbraucher verÃÂÃÂ¤ndern und andere Unternehmen dazu inspirieren, ihre Arbeitsweise grundlegend zu ÃÂÃÂ¤ndern. Wir freuen uns darÃÂÃÂ¼ber, dass wir uns der Gemeinschaft des Klimaschutzversprechens anschlieÃÂÃÂen, bei der es um den Austausch von Wissen, Ideen und optimalen Vorgehensweisen in Bezug auf diese wichtige Aufgabe geht.ÃÂÃÂ Uber hat sich verpflichtet, bis 2040 eine vollstÃÂÃÂ¤ndig emissionsfreie Plattform zu werden, wobei 100 % der Fahrten in emissionsfreien Fahrzeugen, im ÃÂÃÂ¶ffentlichen Personennahverkehr oder mit MikromobilitÃÂÃÂ¤tsoptionen wie FahrrÃÂÃÂ¤dern und Rollern durchgefÃÂÃÂ¼hrt werden sollen. Uber hatte sich zuvor das Ziel gesetzt, bis zum Jahr 2030 in US-amerikanischen, kanadischen und europÃÂÃÂ¤ischen StÃÂÃÂ¤dten 100 % der Fahrten in Elektrofahrzeugen (EVs) durchzufÃÂÃÂ¼hren. Uber hat sich darÃÂÃÂ¼ber hinaus verpflichtet, bis 2030 bei seiner GeschÃÂÃÂ¤ftstÃÂÃÂ¤tigkeit Netto-KlimaneutralitÃÂÃÂ¤t zu erzielen. Um diese Ziele zu erreichen, bemÃÂÃÂ¼ht sich Uber um den Ausbau von Uber Green, um es FahrgÃÂÃÂ¤sten leichter zu machen sich fÃÂÃÂ¼r eine Fahrt in einem Hybrid- oder Elektrofahrzeug zu entscheiden. HierfÃÂÃÂ¼r stellt das Unternehmen Finanzmittel in HÃÂÃÂ¶he von 800 Millionen US-Dollar bereit, um Hunderttausende von Fahrern bis 2025 beim Umstieg auf Elektrofahrzeuge zu unterstÃÂÃÂ¼tzen. Weiterhin investiert Uber in unser multimodales Netzwerk, um nachhaltige Alternativen zu Privatfahrzeugen anbieten zu kÃÂÃÂ¶nnen, und dabei gegenÃÂÃÂ¼ber der ÃÂÃÂffentlichkeit transparent und verantwortlich zu sein. ÃÂÃÂWie bereits im September angekÃÂÃÂ¼ndigt, nimmt Uber diesen Moment als Chance an, eine grÃÂÃÂ¼ne Erholung von der Pandemie voranzutreibenÃÂÃÂ, sagte Uber-CEO Dara Khosrowshahi. ÃÂÃÂWir rufen alle Unternehmen der Welt auf, sich dem Klimaschutzversprechen anzuschlieÃÂÃÂen und MaÃÂÃÂnahmen zur Verringerung ihrer Auswirkungen auf die Umwelt zu ergreifen. Gemeinsam kÃÂÃÂ¶nnen wir die drÃÂÃÂ¤ngende Herausforderung des Klimawandels aggressiver angehen.ÃÂÃÂ ÃÂÃÂDas ÃÂÃÂbereinkommen von Paris hat einen einheitlichen Fahrplan fÃÂÃÂ¼r alle LÃÂÃÂ¤nder und alle Menschen festgelegt, um der Klimakrise durch MaÃÂÃÂnahmen zu begegnenÃÂÃÂ, sagte Christiana Figueres, die ehemalige Leiterin fÃÂÃÂ¼r Klimawandel der UNO und GrÃÂÃÂ¼ndungsgesellschafterin von Global Optimism. ÃÂÃÂMit dem Beitritt zum Klimaschutzversprechen geben die Unterzeichner nicht nur eine ErklÃÂÃÂ¤rung ab, in der sie sich der Zukunft verpflichten, sondern sie legen auch den Grundstein fÃÂÃÂ¼r bedeutende MaÃÂÃÂnahmen und Investitionen, die ArbeitsplÃÂÃÂ¤tze schaffen, Innovationen anregen, fÃÂÃÂ¼r die Regeneration der natÃÂÃÂ¼rlichen Umwelt sorgen und den Verbrauchern helfen, nachhaltigere Produkte zu kaufen.ÃÂÃÂ Race To Zero ist eine internationale Kampagne, die vom Klimaschutzversprechen, The Climate Pledge, unterstÃÂÃÂ¼tzt wird und deren Ziel es ist, FÃÂÃÂ¼hrerschaft und UnterstÃÂÃÂ¼tzung von Unternehmen, StÃÂÃÂ¤dten, Regionen und Investoren fÃÂÃÂ¼r eine gesunde, widerstandsfÃÂÃÂ¤hige, kohlenstofffreie Erholung zu gewinnen. Race to Zero kooperiert bei der diesjÃÂÃÂ¤hrigen virtuellen Konferenz, die vom 2. bis 4. Dezember stattfindet, mit Web Summit mit dem Ziel, auf die Bedeutung eines gemeinsamen Vorgehens von Unternehmen aufmerksam zu machen. Im Jahr 2019 riefen Amazon und Global Optimism gemeinsam das Klimaschutzversprechen ÃÂÃÂThe Climate PledgeÃÂÃÂ ins Leben, eine Verpflichtung, die Vorgaben des Pariser Abkommens zehn Jahre frÃÂÃÂ¼her zu erreichen und bis 2040 netto klimaneutral zu sein. Achtzehn Unternehmen haben bereits das Klimaschutzversprechen unterzeichnet: Amazon, Best Buy, Boom, Cabify, Henkel, Infosys, JetBlue, McKinstry, Mercedes-Benz, Oak View Group, Real Betis, Reckitt Benckiser (RB), Rivian, Schneider Electric, Siemens, Signify, Uber und Verizon. Diese Unternehmen senden das wichtige Signal aus, dass die Nachfrage nach Produkten und Dienstleistungen, die zur Reduzierung der CO2-Emissionen beitragen, rasch zunehmen wird. FÃÂÃÂ¼r weitere Informationen besuchen Sie www.theclimatepledge.com. ÃÂÃÂber Amazon Amazon orientiert sich an vier GrundsÃÂÃÂ¤tzen: Orientierung am Kunden statt an der Konkurrenz, Leidenschaft fÃÂÃÂ¼r Neuerungen, Einsatz fÃÂÃÂ¼r betriebliche Optimierung sowie langfristiges Denken. Kundenrezensionen, 1-Klick-EinkÃÂÃÂ¤ufe, persÃÂÃÂ¶nliche Empfehlungen, Prime, Versand durch Amazon, AWS, Kindle Direct Publishing, Kindle, Fire-Tablets, Fire TV, Amazon Echo und Alexa sind nur einige der von Amazon angebotenen Produkte und Dienstleistungen. Weitere Informationen finden Sie unter www.amazon.com/about. ÃÂÃÂber Global Optimism Global Optimism existiert, um transformatorische, branchenweite VerÃÂÃÂ¤nderungen herbeizufÃÂÃÂ¼hren. Das Erreichen einer emissionsfreien Zukunft ist keine weit in der Ferne liegende Herausforderung. Es ist eine, die wir jetzt in Angriff nehmen mÃÂÃÂ¼ssen. Jede wissenschaftliche Bewertung zeigt, dass wir unsere Emissionen zwischen 2020 und 2030 halbieren mÃÂÃÂ¼ssen, um das Ziel von Netto-Emissionen von Null bis 2050 zu erreichen und die globale ErwÃÂÃÂ¤rmung unter 1,5 Grad Celsius zu halten. Die BewÃÂÃÂ¤ltigung der Klimakrise ist nur mÃÂÃÂ¶glich, wenn alle ÃÂÃÂ¼berall ihren Beitrag leisten. Wir arbeiten mit gleichgesinnten Kollektiven aus allen Branchen zusammen, die bereit sind, in die erforderlichen Entscheidungen zu investieren, um sich auf diese herausfordernde und lebensbejahende Reise zu begeben. Weitere Informationen finden Sie unter https://globaloptimism.com/. Die Ausgangssprache, in der der Originaltext verÃÂÃÂ¶ffentlicht wird, ist die offizielle und autorisierte Version. ÃÂÃÂbersetzungen werden zur besseren VerstÃÂÃÂ¤ndigung mitgeliefert. Nur die Sprachversion, die im Original verÃÂÃÂ¶ffentlicht wurde, ist rechtsgÃÂÃÂ¼ltig. Gleichen Sie deshalb ÃÂÃÂbersetzungen mit der originalen Sprachversion der VerÃÂÃÂ¶ffentlichung ab.",https://www.businesswire.com/news/home/20201203005933/de/,businesswire.com,5,seattlebusiness wireheute gaben amazon nasdaq amzn und global optimism im rahmen de web summit bekannt das sich boom supersonic cabify jetblue rivian und uber dem klimaschutzversprechen climate pledge angeschlossen haben einer verpflichtung bi ein jahrzehnt vor dem ziel de pariser abkommens von nettoklimaneutralitt zu erreichen die unterzeichner de klimaversprechens stimmen zu treibhausgasemissionen regelmig zu messen und darber zu berichten dekarbonisierungsstrategien im einklang mit dem pariser abkommen durch echte geschftliche vernderungen und innovationen umzusetzen einschlielich effizienzsteigerungen erneuerbarer energien materialreduzierungen und anderer strategien zur beseitigung von kohlenstoffemissionen alle verbleibenden emissionen durch zustzliche quantifizierbare reale dauerhafte und sozial ntzliche ausgleichsmanahmen zu neutralisieren um bi einen jhrlichen nettokohlenstoffaussto von null zu erreichen mit der unterzeichnung de klimaschutzversprechens gehen unternehmen auf der ganzen welt die mutige verpflichtung ein unseren planeten vor den verheerenden auswirkungen de klimawandels zu schtzen sagte jeff bezos der grnder und ceo von amazon der transportsektor spielt eine entscheidende rolle bei der beschleunigung unserer kohlenstoffreduktionsziele und wir begren boom cabify jetblue rivian und uber die sich un auf dem weg zu einem kohlenstofffreien klima bi anschlieen die unternehmen die da klimaschutzversprechen bisher unterzeichnet haben demonstrieren fhrungsstrke im notwendigen bergang zu einer kohlenstoffarmen wirtschaft die dazu beitrgt die umwelt fr knftige generationen zu erhalten boom revolutioniert den kommerziellen flugverkehr indem da unternehmen den berschallverkehr wieder zurck den himmel bringt da zukunftsweisende passagierflugzeug von boom die overture wurde nach branchenweit fhrenden standard hinsichtlich geschwindigkeit sicherheit und nachhaltigkeit entwickelt im februar kndigte da unternehmen das da testprogramm fr seinen xbdemonstrator kohlenstoffneutral sein wird und zwar durch die verwendung nachhaltiger flugkraftstoffe und qualitativ hochwertige geprfte cokompensation boom hat sich darber hinaus dazu verpflichtet die overture der entwicklung der erprobung und im betrieb zu einem nettoklimaneutralen flugzeug zu machen und ist mitglied mehrerer organisationen die sich fr eine beschleunigte einfhrung und bereitstellung nachhaltiger flugkraftstoffe fr die luftfahrtindustrie engagieren bei der umsetzung seiner vision die welt zugnglicher zu machen betrachtet boom geschwindigkeit und nachhaltigkeit al kompatible ziele beim bau de weltweit schnellsten verkehrsflugzeugs setzt boom auf einen allumfassenden nachhaltigkeitsansatz da wir nachhaltigkeit von tag eins zu einer unternehmensprioritt gemacht haben konnten wir von anfang optimale vorgehensweisen de umweltschutzes unsere initiativen integrieren sagte blake scholl der grnder und ceo von boom wir schlieen un sehr gerne dem klimaschutzversprechen um dafr zu sorgen das geschwindigkeit und nachhaltigkeit miteinander im einklang stehen cabify ist die erste und einzige app fr stdtische mobilitt europa und lateinamerika die klimaneutral ist indem sie aller coemissionen kompensiert die sie erzeugt durch ihren geschftsbetrieb und fr jede ber die app gebuchte fahrt auch die durch den geschftsbetrieb de unternehmens anfallenden emissionen werden von cabify genau gemessen und reduziert und da unternehmen strebt eine elektrifizierung seiner fahrzeugflotte spanien und lateinamerika bi bzw um seine coemissionen zu reduzieren da unternehmen engagiert sich durch gro angelegte unternehmungen chile peru und brasilien unter anwendung von lsungen fr den coausgleich wie der blockchaintechnologie fr die verbesserung de umweltschutzes und die frderung erneuerbarer energien effiziente stdtische mobilitt ist im kampf gegen den klimawandel von entscheidender bedeutung sagte juan de antonio der grnder und ceo von cabify cabify teil der lsung sein und deshalb haben wir un im dritten jahr folge verpflichtet die coemissionen die unsere fahrer und betriebssttten verursachen auszugleichen whrend wir weiterhin die elektrifizierung der flotten mit denen wir zusammenarbeiten untersttzen wir freuen un un dem klimaschutzversprechen anzuschlieen um unsere nachhaltigkeitsreise weiterhin transparent zu gestalt jetblue ist die erste fluggesellschaft die sich dem klimaschutzversprechen anschliet und dy unterstreicht die entschlossenheit de unternehmens messbare schritte hin zur verringerung seiner klimabilanz zu unternehmen im juli war jetblue die erste und einzige usamerikanische fluggesellschaft die coneutralitt bei allen inlandsflgen erreichte sie geht nun davon au den ausgleich der coemissionen auf mehr al sieben millionen tonnen pro jahr erhhen zu knnen dy entspricht einem jhrlichen wegfall von millionen pkw von den straen jetblue betrachtet den coausgleich al bergangslsung whrend die fluggesellschaft die intensivierung de einsatzes kohlenstoffrmerer technologien wie z b nachhaltiger flugkraftstoffe und den bau treibstoffeffizienterer flugzeuge und betriebssttten fortsetzt seit juli fhrt jetblue regelmig vom san francisco international airport au flge durch und verwendet dabei einen nachhaltigen flugtreibstofftyp der eine reduzierung der coemissionen um bi zu prozent ermglicht bevor er mit herkmmlichem kerosin gemischt wird flugreisen verbinden menschen und kulturen und untersttzen eine globalisierte wirtschaft unser nachhaltigkeitsanspruch ist im zuge der vorbereitungen unseres unternehmens auf eine neue klimarealitt noch wichtiger geworden sagte robin hayes der ceo von jetblue wir sind stolz darauf un dem klimaschutzversprechen und einer gemeinschaft gleichgesinnter unternehmen anzuschlieen die sich fr da erreichen der nettoklimaneutralitt bi einsetzen die klimakrise ist nach wie vor eine der grten bedrohungen fr unsere branche unser planet verndert sich substanziell genauso wie die erwartungen unserer kunden besatzungsmitglieder und investoren e ist jetzt der zeit den betrieb auf nachhaltigere verfahren umzustellen wie beispielsweise durch die einfhrung von nachhaltigem flugkraftstoff und die festlegung eindeutiger strategien zur reduzierung der nettocoemissionen im luftverkehr rivian bringt eine serie von auf abenteuer ausgerichteten fahrzeugen sowie lieferwagen speziell fr anwendungen der letzten meile von amazon auf den markt die ersten produkte de unternehmens der rt und der r bieten eine einzigartige kombination au leistung gelndegngigkeit und nutzen diese fahrzeuge basieren auf der flexiblen rollbrettplattform de unternehmens und werden der fertigungsanlage von rivian normal illinois hergestellt die auslieferung die kunden soll im juni beginnen rivian wurde gegrndet um dazu beizutragen die art von zukunft schaffen die unsere kinder und unsere kindeskinder verdienen da engagement von rivian fr eine nachhaltige fahrzeugproduktion bei unseren endkundenprodukten und nutzfahrzeugen wird von diesem zentralen ziel bestimmt sagte rj scaringe der grnder und ceo von rivian der kampf gegen den klimawandel macht e notwendig das einzelpersonen und ganze branchen gemeinsam lsungen zu schaffen die die denkweise der verbraucher verndern und andere unternehmen dazu inspirieren ihre arbeitsweise grundlegend zu ndern wir freuen un darber das wir un der gemeinschaft de klimaschutzversprechens anschlieen bei der e um den austausch von wissen ideen und optimalen vorgehensweisen bezug auf diese wichtige aufgabe geht uber hat sich verpflichtet bi eine vollstndig emissionsfreie plattform zu werden wobei der fahrten emissionsfreien fahrzeugen im ffentlichen personennahverkehr oder mit mikromobilittsoptionen wie fahrrdern und rollern durchgefhrt werden sollen uber hatte sich zuvor da ziel gesetzt bi zum jahr usamerikanischen kanadischen und europischen stdten der fahrten elektrofahrzeugen ev durchzufhren uber hat sich darber hinaus verpflichtet bi bei seiner geschftsttigkeit nettoklimaneutralitt zu erzielen um diese ziele zu erreichen bemht sich uber um den ausbau von uber green um e fahrgsten leichter zu machen sich fr eine fahrt einem hybrid oder elektrofahrzeug zu entscheiden hierfr stellt da unternehmen finanzmittel hhe von millionen usdollar bereit um hunderttausende von fahrern bi beim umstieg auf elektrofahrzeuge zu untersttzen weiterhin investiert uber unser multimodales netzwerk um nachhaltige alternativen zu privatfahrzeugen anbieten zu knnen und dabei gegenber der ffentlichkeit transparent und verantwortlich zu sein wie bereits im september angekndigt nimmt uber diesen moment al chance eine grne erholung von der pandemie voranzutreiben sagte uberceo dara khosrowshahi wir rufen alle unternehmen der welt auf sich dem klimaschutzversprechen anzuschlieen und manahmen zur verringerung ihrer auswirkungen auf die umwelt zu ergreifen gemeinsam knnen wir die drngende herausforderung de klimawandels aggressiver angehen da bereinkommen von paris hat einen einheitlichen fahrplan fr alle lnder und alle menschen festgelegt um der klimakrise durch manahmen zu begegnen sagte christiana figueres die ehemalige leiterin fr klimawandel der uno und grndungsgesellschafterin von global optimism mit dem beitritt zum klimaschutzversprechen geben die unterzeichner nicht nur eine erklrung ab der sie sich der zukunft verpflichten sondern sie legen auch den grundstein fr bedeutende manahmen und investitionen die arbeitspltze schaffen innovationen anregen fr die regeneration der natrlichen umwelt sorgen und den verbrauchern helfen nachhaltigere produkte zu kaufen race zero ist eine internationale kampagne die vom klimaschutzversprechen climate pledge untersttzt wird und deren ziel e ist fhrerschaft und untersttzung von unternehmen stdten regionen und investoren fr eine gesunde widerstandsfhige kohlenstofffreie erholung zu gewinnen race zero kooperiert bei der diesjhrigen virtuellen konferenz die vom bi dezember stattfindet mit web summit mit dem ziel auf die bedeutung eines gemeinsamen vorgehens von unternehmen aufmerksam zu machen im jahr riefen amazon und global optimism gemeinsam da klimaschutzversprechen climate pledge in leben eine verpflichtung die vorgaben de pariser abkommens zehn jahre frher zu erreichen und bi netto klimaneutral zu sein achtzehn unternehmen haben bereits da klimaschutzversprechen unterzeichnet amazon best buy boom cabify henkel infosys jetblue mckinstry mercedesbenz oak view group real betis reckitt benckiser rb rivian schneider electric siemens signify uber und verizon diese unternehmen senden da wichtige signal au das die nachfrage nach produkten und dienstleistungen die zur reduzierung der coemissionen beitragen rasch zunehmen wird fr weitere informationen besuchen sie ber amazon amazon orientiert sich vier grundstzen orientierung kunden statt der konkurrenz leidenschaft fr neuerungen einsatz fr betriebliche optimierung sowie langfristiges denken kundenrezensionen klickeinkufe persnliche empfehlungen prime versand durch amazon aws kindle direct publishing kindle firetablets fire tv amazon echo und alexa sind nur einige der von amazon angebotenen produkte und dienstleistungen weitere informationen finden sie unter ber global optimism global optimism existiert um transformatorische branchenweite vernderungen herbeizufhren da erreichen einer emissionsfreien zukunft ist keine weit der ferne liegende herausforderung e ist eine die wir jetzt angriff nehmen mssen jede wissenschaftliche bewertung zeigt das wir unsere emissionen zwischen und halbieren mssen um da ziel von nettoemissionen von null bi zu erreichen und die globale erwrmung unter grad celsius zu halten die bewltigung der klimakrise ist nur mglich wenn alle berall ihren beitrag leisten wir arbeiten mit gleichgesinnten kollektiven au allen branchen zusammen die bereit sind die erforderlichen entscheidungen zu investieren um sich auf diese herausfordernde und lebensbejahende reise zu begeben weitere informationen finden sie unter die ausgangssprache der der originaltext verffentlicht wird ist die offizielle und autorisierte version bersetzungen werden zur besseren verstndigung mitgeliefert nur die sprachversion die im original verffentlicht wurde ist rechtsgltig gleichen sie deshalb bersetzungen mit der originalen sprachversion der verffentlichung ab,-0.9997,-0.49985,0.2395907407,-0.739440741,Negative Impact
04/12/2020,159.9105,159.91,157.94,158.13,158.13,58272000,2.13,76.34428766,1.192,0,9.3404,0.9034837908,0.2283735172,0.09,260.474,12464.23047,14417.33008,6550.200195,5609.149902,3444.581055,45079.55078,17521,159.2450803,137.895527,158.164386,141.3289236,157.4825745,163.2980761,151.6670728,55.60903756,0.1356945997,-0.276632916,0.4123275154,2.912463597,154.4310521,9759866000,52.92934837,64.7556243,20.79000092,Boxed in: French activists protest against Amazon's expansion,"Climate activists piled up giant cardboard delivery boxes outside the finance ministry in Paris on Friday, protesting against Amazon's expansion in France as the online retailer launched a delayed ""Black Friday"" sales drive.",https://www.reuters.com/article/us-france-amazon-protest/boxed-in-french-activists-protest-against-amazons-expansion-idUSKBN28E1J5,reuters.com,10,climate activist piled giant cardboard delivery box outside finance ministry paris friday protesting amazon expansion france online retailer launched delayed black friday sale drive,-0.3612,-0.3612,0.172532,-0.533732,Negative Impact
07/12/2020,157.824,159.04,157.08,157.90,157.90,55026000,2.13,76.34428766,1.192,0,9.3404,0.9034837908,0.2283735172,0.09,260.474,12519.9502,14354.96973,6555.399902,5573.379883,3416.604004,45426.96875,17582.40039,159.3079501,138.1827045,158.1540177,141.4938099,157.0991493,161.5119796,152.6863191,54.4402562,0.08634952627,-0.204036427,0.2903859535,2.801963806,154.709231,9704840000,50.43325683,56.48449367,21.29999924,AWS Announces Plans to Open Second Region in Australia,"SEATTLE--(BUSINESS WIRE)--Amazon Web Services, Inc. (AWS), an Amazon.com company (NASDAQ: AMZN), today announced plans to open a second infrastructure region in Australia in the second half of 2022. The new AWS Asia Pacific (Melbourne) Region, which will consist of three Availability Zones (AZs) at launch, will join the existing 25 Availability Zones in eight AWS Regions across Asia Pacific in Australia, China, India, Japan, Korea, and Singapore. Globally, AWS has 77 Availability Zones across 24 geographic regions, with plans to launch 18 more Availability Zones and six more AWS Regions in India, Indonesia, Japan, Spain, Switzerland, and the new region in Australia. The new AWS Asia Pacific (Melbourne) Region will enable even more developers, startups, and enterprises as well as government, education, and non-profit organizations to run their applications and serve end users from data centers located in Australia. For more information on AWSÃÂÃÂs global infrastructure, visit: https://aws.amazon.com/about-aws/global-infrastructure/. ÃÂÃÂOver the last decade, customers in Australia have relied upon the cloud to transform businesses, educational institutions, and government agencies, and with another AWS Region coming to Asia Pacific, we look forward to helping accelerate these transformations,ÃÂÃÂ said Peter DeSantis, Senior Vice President of Global Infrastructure and Customer Support, AWS. ÃÂÃÂTogether with our AWS Asia Pacific (Sydney) Region, weÃÂÃÂre providing customers with more flexibility and choice, while allowing them to architect their infrastructure for even greater fault tolerance, resiliency, and availability across geographic locations.ÃÂÃÂ ÃÂÃÂWe welcome the investment of one of the worldÃÂÃÂs leading tech companies into Melbourne ÃÂÃÂ the new AWS Region will draw on our highly skilled talent, culture of innovation, and renowned capabilities in growing employment fields such as cloud computing,ÃÂÃÂ said Tim Pallas, Victorian Minister for Economic Development. ÃÂÃÂAttracting companies like AWS will not only strengthen our world-leading tech reputation but contribute to our economic recovery.ÃÂÃÂ AWS Regions are comprised of Availability Zones, which are technology infrastructure in separate and distinct geographic locations with enough distance to significantly reduce the risk of a single event impacting customersÃÂÃÂ business continuity, yet near enough to provide low latency for high availability applications. Each Availability Zone has independent power, cooling, and physical security and is connected via redundant, ultra-low-latency networks. AWS customers focused on high availability can design their applications to run in multiple Availability Zones to achieve even greater fault tolerance. The launch of the AWS Asia Pacific (Melbourne) Region will provide customers with even lower latency across the country. Additionally, Australian customers, from startups to enterprises and the public sector, will have additional infrastructure to leverage advanced technologies from the worldÃÂÃÂs leading cloud with the broadest and deepest suite of cloud services including compute, storage, analytics, artificial intelligence, database, Internet of Things (IoT), machine learning, mobile services, serverless, and more to drive innovation. Customers in Australia also benefit from AmazonÃÂÃÂs continued investment in its global backbone through the Hawaiki Submarine Cable, a 15,000- kilometre transpacific cable system operational since 2018 that provides a low-latency and high-bandwidth connection from Australia to New Zealand and the United States. Customers and AWS Partners welcome the news of the AWS Asia Pacific (Melbourne) Region Hundreds of thousands of active customers use AWS services in Australia each month to accelerate innovation, increase agility, and drive cost savings. This includes the Commonwealth Bank of Australia (CBA), Woodside, David Jones, Network Ten, Australia Post, National Australia Bank (NAB), The Australian Bureau of Statistics (ABS), Kmart Group, Origin Energy, Telstra, Qantas, Atlassian, Canva, Commonwealth Scientific and Industrial Research Organisation (CSIRO), Siteminder, Realestate.com.au, Afterpay, Xero, David Jones, Myer, SEEK, Australia Post, and Swinburne University, among many others. CBA is AustraliaÃÂÃÂs leading provider of personal, business and institutional banking, and share brokering services. ÃÂÃÂHaving safe, secure and resilient infrastructure is paramount to providing the best banking experiences for our customers. CBA has long been an advocate of cloud computing as a way of taking advantage of modern compute infrastructure. As more traditional banking services continue to become available online, our annual investments in technology and innovation will continue to meet this demand, underpinned by our ongoing development of cloud-first, resilient, and modern platforms,ÃÂÃÂ said Mark Vudrag, Executive General Manager, Global Technology Services, Commonwealth Bank of Australia. ÃÂÃÂCBA has been using AWS since the launch of its first Australian AWS Region in 2012, and the new region in Australia will further support the resiliency and reliability of our cloud services.ÃÂÃÂ Swinburne University of Technology is a leading Australian university that focuses on innovation, industry engagement, and social inclusion. ÃÂÃÂWe have worked with AWS since 2016, and in that time have collaborated on many innovations that support communities in Victoria. This includes the Swinburne Data for Social Good Cloud Innovation Centre, which uses cloud technologies and intelligent data analytics to solve real-world health, wellbeing, and social challenges affecting Australians, and the recent Beatcovid19now symptom tracker to provide valuable information to health authorities in Australia to deal with the pandemic,ÃÂÃÂ said SwinburneÃÂÃÂs Deputy Vice Chancellor (Research and Enterprise), Professor Bronwyn Fox. ÃÂÃÂA new AWS Region here in Melbourne will allow us to further scale our innovation, and continue to transform our research and development projects that protect, prioritise, and benefit people across the city, state, and country.ÃÂÃÂ XY Sense is a Melbourne-based technology startup using smart sensors and machine learning powered analytics to create technology-enabled workplaces. ÃÂÃÂAWS is like rocket fuel for startups. TheyÃÂÃÂve been with us from the early days of our big data platform design and today we leverage many of their machine learning and IoT capabilities to help us quickly process billions of anonymous data points. ItÃÂÃÂs not just about the support we receive on the tech side of things but about how the AWS Partner programs have helped us scale our go-to-market launch this year. With a second local AWS Region and AWSÃÂÃÂs incredible enablement programs for startups such as Activate, we will be able to continue to evolve our service capabilities and accelerate our growth,ÃÂÃÂ said Alex Birch, CEO and co-founder of XY Sense. The AWS Partner Network (APN) includes tens of thousands of Independent Software Vendors (ISV) and Systems Integrators (SI) around the world. AWS Partners build innovative solutions and services on AWS, and the APN helps by providing business, technical, marketing, and go-to-market support. SI Consulting Partners supporting enterprise and public sector customers migrating to AWS include Accenture, Capgemini, Deloitte, Versent, Wipro, DXC, TCS and many others. AWS ISVs in Australia including Atlassian, Faethm, Whispir, Max Kelsen, Contino, and many others are already using AWS to deliver their software to customers around the world and intend to serve their Australian customers from the AWS Asia Pacific (Melbourne) Region at launch. For the full list of AWS Partner Network (APN) members, visit: https://aws.amazon.com/partners/ Versent Group is an Australian company, headquartered in Melbourne, comprising specialist digital transformation consultants and a world-class managed services team. ÃÂÃÂOur collaboration with AWS has been critical to our long-term growth, and just as critical to our ability to pivot and support customers during recent times. The announcement of a new AWS Region in Melbourne will allow us to continue to innovate rapidly, hire more skilled Australians for the 70-plus roles we currently have open, and ensure the availability and delivery of world-leading technology foundations to businesses around Australia. Since our inception, we have experienced double-digit growth year on year and now have 350 employees across Australia, Singapore, and the US with offices in Perth, Sydney, Brisbane, and Melbourne. With the new region in Australia, we expect that we will be able to expand our business and hire more highly skilled tech employees, further supporting the local workforce,ÃÂÃÂ said Thor Essman, CEO of Versent. Deloitte is one of AustraliaÃÂÃÂs leading professional services firms. ÃÂÃÂDeloitte has been an AWS Strategic Global Premier Partner since 2015, and with AWS, we have delivered advanced technology products and services to Australian businesses and public sector agencies, including the University of Newcastle, Jemena, and David Jones. Critical to this has been arming our employees with the latest skills needed to help these ÃÂÃÂ and many more ÃÂÃÂ businesses adapt quicker than ever, which is why we have given more than 4,000 employees across Deloitte the opportunity to further develop their skills in cloud computing via the Deloitte Cloud Guild, a technology training program in collaboration with AWS. The announcement of the Asia Pacific (Melbourne) Region will allow us to leverage these enhanced cloud skills to deliver secure, highly available, and disruptive solutions to our customers,ÃÂÃÂ said Rob Hillard, Deloitte Asia Pacific Chief Transformation Officer. Amazon Continued Investment in Australia The new AWS Asia Pacific (Melbourne) Region demonstrates AmazonÃÂÃÂs continuing investment in Australia. Over the last decade, Amazon has invested more than AUD $3 billion in Australia, including infrastructure and compensation. In 2012, Amazon established its first infrastructure in Australia, launching the AWS Asia Pacific (Sydney) Region followed by Amazon CloudFront Points of Presence infrastructure in Sydney, Melbourne (July 2014), and Perth (January 2018). Amazon currently has four fulfillment centers (FCs) in Australia Dandenong South, Melbourne, (December 2017); Moorebank, Sydney (August 2018); PerthÃÂÃÂs Airport Precinct (November 2019); and its most recent in Lytton, Brisbane (June 2020). This year Amazon opened 10 logistics sites in Australia across Sydney (4), Melbourne (4), Brisbane (1) and Perth (1). Amazon also announced a second Melbourne FC in Ravenhall and AustraliaÃÂÃÂs first Amazon Robotics FC. Amazon continues to create jobs in Australia, with more than 3,000 employees across amazon.com.au, AWS, Kindle, Audible, Alexa and Prime Video. Additionally, Amazon is committed to running its business in the most environmentally friendly way. To further its commitment to sustainability, Amazon aims to reach net zero carbon across all of AmazonÃÂÃÂs operations by 2040 as part of The Climate Pledge. Amazon has invested in two renewable energy projects in Australia, which in total will add a combined 165 megawatts (MWs) of capacity and are expected to generate 392,000 MWh annually ÃÂÃÂ or enough to power 63,000 average Australian homes each year. Amazon is also continuing to invest in the upskilling of local developers, students, and the next generation of IT leaders in Australia through programs such as AWS re/Start, AWS Academy, and AWS Educate. AWS re/Start is a digital skills training program that prepares unemployed, underemployed, and transitioning individuals for careers in cloud computing and connects students to potential employers. AWS Academy provides higher education institutions with a free, ready-to-teach cloud computing curriculum that prepares students to pursue industry-recognised certifications and in-demand cloud jobs. AWS Educate provides student access to AWS services and content designed to build knowledge and skills in cloud computing. Customers and AWS Partners looking to learn more about AWS should visit https://aws.amazon.com About Amazon Web Services For 14 years, Amazon Web Services has been the worldÃÂÃÂs most comprehensive and broadly adopted cloud platform. AWS offers over 175 fully featured services for compute, storage, databases, networking, analytics, robotics, machine learning and artificial intelligence (AI), Internet of Things (IoT), mobile, security, hybrid, virtual and augmented reality (VR and AR), media, and application development, deployment, and management from 77 Availability Zones (AZs) within 24 geographic regions, with announced plans for 18 more Availability Zones and six more AWS Regions in Australia, India, Indonesia, Japan, Spain and Switzerland. Millions of customersÃÂÃÂincluding the fastest-growing startups, largest enterprises, and leading government agenciesÃÂÃÂtrust AWS to power their infrastructure, become more agile, and lower costs. To learn more about AWS, visit aws.amazon.com. About Amazon Amazon is guided by four principles: customer obsession rather than competitor focus, passion for invention, commitment to operational excellence, and long-term thinking. Customer reviews, 1-Click shopping, personalized recommendations, Prime, Fulfillment by Amazon, AWS, Kindle Direct Publishing, Kindle, Fire tablets, Fire TV, Amazon Echo, and Alexa are some of the products and services pioneered by Amazon. For more information, visit amazon.com/about and follow @AmazonNews.",https://www.businesswire.com/news/home/20201207005969/en/AWS-Announces-Plans-to-Open-Second-Region-in-Australia,businesswire.com,5,seattlebusiness wireamazon web service inc aws amazoncom company nasdaq amzn today announced plan open second infrastructure region australia second half new aws asia pacific melbourne region consist three availability zone az launch join existing availability zone eight aws region across asia pacific australia china india japan korea singapore globally aws availability zone across geographic region plan launch availability zone six aws region india indonesia japan spain switzerland new region australia new aws asia pacific melbourne region enable even developer startup enterprise well government education nonprofit organization run application serve end user data center located australia information awss global infrastructure visit last decade customer australia relied upon cloud transform business educational institution government agency another aws region coming asia pacific look forward helping accelerate transformation said peter desantis senior vice president global infrastructure customer support aws together aws asia pacific sydney region providing customer flexibility choice allowing architect infrastructure even greater fault tolerance resiliency availability across geographic location welcome investment one world leading tech company melbourne new aws region draw highly skilled talent culture innovation renowned capability growing employment field cloud computing said tim pallas victorian minister economic development attracting company like aws strengthen worldleading tech reputation contribute economic recovery aws region comprised availability zone technology infrastructure separate distinct geographic location enough distance significantly reduce risk single event impacting customer business continuity yet near enough provide low latency high availability application availability zone independent power cooling physical security connected via redundant ultralowlatency network aws customer focused high availability design application run multiple availability zone achieve even greater fault tolerance launch aws asia pacific melbourne region provide customer even lower latency across country additionally australian customer startup enterprise public sector additional infrastructure leverage advanced technology world leading cloud broadest deepest suite cloud service including compute storage analytics artificial intelligence database internet thing iot machine learning mobile service serverless drive innovation customer australia also benefit amazon continued investment global backbone hawaiki submarine cable kilometre transpacific cable system operational since provides lowlatency highbandwidth connection australia new zealand united state customer aws partner welcome news aws asia pacific melbourne region hundred thousand active customer use aws service australia month accelerate innovation increase agility drive cost saving includes commonwealth bank australia cba woodside david jones network ten australia post national australia bank nab australian bureau statistic ab kmart group origin energy telstra qantas atlassian canva commonwealth scientific industrial research organisation csiro siteminder realestatecomau afterpay xero david jones myer seek australia post swinburne university among many others cba australia leading provider personal business institutional banking share brokering service safe secure resilient infrastructure paramount providing best banking experience customer cba long advocate cloud computing way taking advantage modern compute infrastructure traditional banking service continue become available online annual investment technology innovation continue meet demand underpinned ongoing development cloudfirst resilient modern platform said mark vudrag executive general manager global technology service commonwealth bank australia cba using aws since launch first australian aws region new region australia support resiliency reliability cloud service swinburne university technology leading australian university focus innovation industry engagement social inclusion worked aws since time collaborated many innovation support community victoria includes swinburne data social good cloud innovation centre us cloud technology intelligent data analytics solve realworld health wellbeing social challenge affecting australian recent beatcovidnow symptom tracker provide valuable information health authority australia deal pandemic said swinburne deputy vice chancellor research enterprise professor bronwyn fox new aws region melbourne allow u scale innovation continue transform research development project protect prioritise benefit people across city state country xy sense melbournebased technology startup using smart sensor machine learning powered analytics create technologyenabled workplace aws like rocket fuel startup theyve u early day big data platform design today leverage many machine learning iot capability help u quickly process billion anonymous data point support receive tech side thing aws partner program helped u scale gotomarket launch year second local aws region awss incredible enablement program startup activate able continue evolve service capability accelerate growth said alex birch ceo cofounder xy sense aws partner network apn includes ten thousand independent software vendor isv system integrator si around world aws partner build innovative solution service aws apn help providing business technical marketing gotomarket support si consulting partner supporting enterprise public sector customer migrating aws include accenture capgemini deloitte versent wipro dxc tc many others aws isvs australia including atlassian faethm whispir max kelsen contino many others already using aws deliver software customer around world intend serve australian customer aws asia pacific melbourne region launch full list aws partner network apn member visit versent group australian company headquartered melbourne comprising specialist digital transformation consultant worldclass managed service team collaboration aws critical longterm growth critical ability pivot support customer recent time announcement new aws region melbourne allow u continue innovate rapidly hire skilled australian plus role currently open ensure availability delivery worldleading technology foundation business around australia since inception experienced doubledigit growth year year employee across australia singapore u office perth sydney brisbane melbourne new region australia expect able expand business hire highly skilled tech employee supporting local workforce said thor essman ceo versent deloitte one australia leading professional service firm deloitte aws strategic global premier partner since aws delivered advanced technology product service australian business public sector agency including university newcastle jemena david jones critical arming employee latest skill needed help many business adapt quicker ever given employee across deloitte opportunity develop skill cloud computing via deloitte cloud guild technology training program collaboration aws announcement asia pacific melbourne region allow u leverage enhanced cloud skill deliver secure highly available disruptive solution customer said rob hillard deloitte asia pacific chief transformation officer amazon continued investment australia new aws asia pacific melbourne region demonstrates amazon continuing investment australia last decade amazon invested aud billion australia including infrastructure compensation amazon established first infrastructure australia launching aws asia pacific sydney region followed amazon cloudfront point presence infrastructure sydney melbourne july perth january amazon currently four fulfillment center fcs australia dandenong south melbourne december moorebank sydney august perth airport precinct november recent lytton brisbane june year amazon opened logistics site australia across sydney melbourne brisbane perth amazon also announced second melbourne fc ravenhall australia first amazon robotics fc amazon continues create job australia employee across amazoncomau aws kindle audible alexa prime video additionally amazon committed running business environmentally friendly way commitment sustainability amazon aim reach net zero carbon across amazon operation part climate pledge amazon invested two renewable energy project australia total add combined megawatt mws capacity expected generate mwh annually enough power average australian home year amazon also continuing invest upskilling local developer student next generation leader australia program aws restart aws academy aws educate aws restart digital skill training program prepares unemployed underemployed transitioning individual career cloud computing connects student potential employer aws academy provides higher education institution free readytoteach cloud computing curriculum prepares student pursue industryrecognised certification indemand cloud job aws educate provides student access aws service content designed build knowledge skill cloud computing customer aws partner looking learn aws visit amazon web service year amazon web service world comprehensive broadly adopted cloud platform aws offer fully featured service compute storage database networking analytics robotics machine learning artificial intelligence ai internet thing iot mobile security hybrid virtual augmented reality vr ar medium application development deployment management availability zone az within geographic region announced plan availability zone six aws region australia india indonesia japan spain switzerland million customersincluding fastestgrowing startup largest enterprise leading government agenciestrust aws power infrastructure become agile lower cost learn aws visit awsamazoncom amazon amazon guided four principle customer obsession rather competitor focus passion invention commitment operational excellence longterm thinking customer review click shopping personalized recommendation prime fulfillment amazon aws kindle direct publishing kindle fire tablet fire tv amazon echo alexa product service pioneered amazon information visit amazoncomabout follow amazonnews,0.9996,0.4998,0.3124057143,0.1873942857,Positive Impact
08/12/2020,157.945,159.21,156.00,158.86,158.86,65726000,2.13,76.34428766,1.192,0,9.3404,0.9034837908,0.2283735172,0.09,260.474,12582.76953,14402.16992,6558.799805,5560.669922,3410.179932,45608.51172,17639,159.3111902,138.483842,158.1818798,141.6666526,157.1830246,161.6660954,152.6999538,56.5445423,0.1236456296,-0.138500016,0.2621456455,2.823105948,154.9818463,9770566000,60.94617969,54.76959496,20.68000031,Amazon To Buy Cyprus And Move HQ ThereÃÂÃÂ10 Outrageous Predictions For 2021,"From Germany bailing out France to blockchain killing off fake news, Saxo Bank says these are the potential tail risks for the year ahead.",https://www.forbes.com/sites/jamesphillipps/2020/12/08/amazon-to-buy-cyprus-and-move-hq-there10-outrageous-predictions-for-2021/,forbes.com,8,germany bailing france blockchain killing fake news saxo bank say potential tail risk year ahead,-0.8625,-0.69,0.2200137931,-0.910013793,Negative Impact
09/12/2020,158.3945,158.72,154.40,155.21,155.21,82016000,2.13,76.34428766,1.192,0,9.3404,0.9034837908,0.2283735172,0.09,260.474,12338.9502,14374.08008,6564.299805,5546.819824,3371.964111,46103.5,17559.90039,159.2705103,138.7649945,158.0653358,141.8014123,157.3559746,161.174293,153.5376562,49.82548849,-0.140069529,-0.138813919,-0.001255611,3.017356873,168.3399963,9688550000,21.11299604,44.16414419,22.27000046,Twitch updates its hateful content and harassment policy after company called out for its own abuses,"Following several reports of a toxic workplace and abuse this year, Twitch today announced the introduction of a new hateful content and harassment policy for its streamer community that will go into effect on Jan. 22, 2021. Under the updated guidelines, Twitch's Safety team will change the way it evaluates potentially violating content.",https://techcrunch.com/2020/12/09/twitch-updates-its-hateful-content-and-harassment-policy-after-company-called-out-for-its-ownabuses/,techcrunch.com,5,following several report toxic workplace abuse year twitch today announced introduction new hateful content harassment policy streamer community go effect jan updated guideline twitch safety team change way evaluates potentially violating content,-0.9118,-0.4559,0.2322054545,-0.688105455,Negative Impact
10/12/2020,154.4495,157.11,153.80,155.07,155.07,60604000,2.13,76.34428766,1.192,0,9.3404,0.9034837908,0.2283735172,0.09,260.474,12405.80957,14394.33984,6599.799805,5549.649902,3373.275879,45959.87891,17593.30078,159.2232703,139.069292,157.9480478,141.9334828,157.2662239,161.214849,153.3175988,47.7945899,-0.355897914,-0.182230718,-0.173667197,3.095999581,168.0611963,9627946000,19.63593121,33.89836898,22.52000046,"Amazon wird zum weltweit grÃÂÃÂ¶ÃÂÃÂten Abnehmer von erneuerbarer Energie und erweitert sein Klimaversprechen, bis 2040 kohlenstofffrei zu sein","SEATTLE--(BUSINESS WIRE)--Amazon (NASDAQ: AMZN) kÃÂÃÂ¼ndigte heute 26 neue Wind- und Solarenergieprojekte im Versorgungsbereich mit einer GesamtkapazitÃÂÃÂ¤t von 3,4 Gigawatt (GW) StromerzeugungskapazitÃÂÃÂ¤t an. Damit wird Amazon im Jahr 2020 insgesamt 35 Projekte und mehr als 4 GW KapazitÃÂÃÂ¤t in erneuerbare Energien investieren ÃÂÃÂ die grÃÂÃÂ¶ÃÂÃÂte Investition eines Unternehmens in erneuerbare Energien innerhalb eines einzigen Jahres. Durch diese neuen Projekte wird Amazon zum grÃÂÃÂ¶ÃÂÃÂten gewerblichen Abnehmer von erneuerbarer Energie, den es je gab. Amazon hat mittlerweile in 6,5 GW Wind- und Solarprojekte investiert, die es dem Unternehmen ermÃÂÃÂ¶glichen werden, seinen Betrieb jÃÂÃÂ¤hrlich mit mehr als 18 Millionen Megawattstunden (MWh) an erneuerbarer Energie zu versorgen. Das reicht aus, um 1,7 Millionen US-Haushalte ein Jahr lang mit Strom zu versorgen. Diese Projekte werden erneuerbare Energie fÃÂÃÂ¼r die Niederlassungen, Fulfillment-Zentren und ÃÂÃÂAmazon Web Services (AWS)ÃÂÃÂ-Rechenzentren von Amazon liefern, die Millionen von Kunden weltweit unterstÃÂÃÂ¼tzen. Sie werden auÃÂÃÂerdem dazu beitragen, Amazons Ziel voranzutreiben, bis 2040 einen Netto-NullausstoÃÂÃÂ an Kohlendioxidemissionen im gesamten Unternehmen zu erreichen. Teil dieser Verpflichtung ist es, Amazons Infrastruktur zu 100 % mit erneuerbarer Energie zu versorgen, und das Unternehmen ist nun auf dem Weg, diesen Meilenstein bis 2025 zu erreichen, fÃÂÃÂ¼nf Jahre vor dem ursprÃÂÃÂ¼nglichen Ziel fÃÂÃÂ¼r 2030. ÃÂÃÂAmazon trÃÂÃÂ¤gt zur BekÃÂÃÂ¤mpfung des Klimawandels bei, indem das Unternehmen schnell dazu ÃÂÃÂ¼bergeht, seine GeschÃÂÃÂ¤fte mit erneuerbarer Energie zu betreibenÃÂÃÂ, sagte Jeff Bezos, GrÃÂÃÂ¼nder und CEO von Amazon. ÃÂÃÂMit insgesamt 127 Solar- und Windprojekten ist Amazon heute der grÃÂÃÂ¶ÃÂÃÂte gewerbliche Abnehmer von erneuerbaren Energien ÃÂÃÂ¼berhaupt. Wir sind auf dem Weg, bis 2025 unser GeschÃÂÃÂ¤ft zu 100 % mit erneuerbarer Energie zu betreiben ÃÂÃÂ fÃÂÃÂ¼nf Jahre vor unserem ursprÃÂÃÂ¼nglichen Ziel bis 2030. Dies ist nur einer der vielen Schritte, die wir unternehmen und die uns dabei helfen werden, unser Klimaversprechen zu erfÃÂÃÂ¼llen. Ich kÃÂÃÂ¶nnte nicht stolzer auf all die Teams bei Amazon sein, die weiterhin hart, intelligent und schnell daran arbeiten, diese Projekte zum Laufen zu bringen.ÃÂÃÂ Die 26 neuen Wind- und Solarprojekte, die heute angekÃÂÃÂ¼ndigt wurden, befinden sich in Australien, Frankreich, Deutschland, Italien, SÃÂÃÂ¼dafrika, Schweden, GroÃÂÃÂbritannien und den USA. Die neuen Projekte sind die ersten von Amazon in Frankreich, Deutschland, Italien und SÃÂÃÂ¼dafrika. In den USA hat Amazon inzwischen Wind- und Solarprojekte in Kalifornien, Delaware, Illinois, Indiana, Kansas, Kentucky, Nebraska, North Carolina, Ohio, Texas und Virginia realisiert. Amazon verfÃÂÃÂ¼gt weltweit ÃÂÃÂ¼ber insgesamt 127 Projekte im Bereich erneuerbare Energien, darunter 59 Wind- und Solarprojekte im Versorgungsbereich und 68 SolardÃÂÃÂ¤cher auf Fulfillment- und Sortierzentren rund um den Globus. ÃÂÃÂInvestitionen des privaten Sektors sind unerlÃÂÃÂ¤sslich, um erneuerbare Energien in dem Tempo auszubauen, das fÃÂÃÂ¼r den globalen Klimaschutz erforderlich istÃÂÃÂ, sagte Miranda Ballentine, CEO der Renewable Energy Buyers Alliance (REBA). ÃÂÃÂAllein die in den USA angesiedelten Projekte machen Amazons AnkÃÂÃÂ¼ndigung um 270 % umfangreicher als die bisher grÃÂÃÂ¶ÃÂÃÂte AnkÃÂÃÂ¼ndigung eines einzelnen Abnehmers im Bereich der Unternehmensbeschaffung und verdeutlichen die FÃÂÃÂ¼hrungsrolle und das Engagement des Unternehmens fÃÂÃÂ¼r eine saubere und blÃÂÃÂ¼hende Energiezukunft.ÃÂÃÂ ÃÂÃÂIm Namen des Sektors fÃÂÃÂ¼r erneuerbare Energien gratulieren wir Amazon fÃÂÃÂ¼r seinen beispiellosen Beitrag zum ÃÂÃÂbergang zu erneuerbaren Energien in diesem Jahr. Mit beeindruckenden 35 groÃÂÃÂen neuen Projekten im Bereich der erneuerbaren Energien im Jahr 2020 gebÃÂÃÂ¼hrt Amazon ein enormes Lob fÃÂÃÂ¼r seine FÃÂÃÂ¼hrungsrolle bei der weltweiten Umstellung auf erneuerbare Energien. Die Beschaffung von mehr als 4.000 MW an neuer erneuerbarer Energie in einem einzigen Jahr ist eine unglaubliche Leistung und ein groÃÂÃÂer Fortschritt auf dem Weg zu Amazons Ziel, sich zu 100 % mit erneuerbarer Energie zu versorgen. Wir sind Amazon sehr dankbar fÃÂÃÂ¼r die BemÃÂÃÂ¼hungen des Unternehmens, uns dabei zu helfen, in greifbarer NÃÂÃÂ¤he der Reduzierung der Treibhausgasemissionen zu bleiben, die laut Wissenschaftlern notwendig ist, um die schlimmsten Auswirkungen des Klimawandels zu vermeidenÃÂÃÂ, sagte Gregory Wetstone, President und CEO des American Council on Renewable Energy (ACORE). Letztes Jahr grÃÂÃÂ¼ndeten Amazon und Global Optimism gemeinsam The Climate Pledge, eine Verpflichtung, das Pariser Abkommen 10 Jahre frÃÂÃÂ¼her zu erreichen und bis 2040 netto kohlenstofffrei zu sein. Das Klimaversprechen (ÃÂÃÂThe PledgeÃÂÃÂ) hat inzwischen 31 Unterzeichner, darunter Unilever, Verizon, Siemens, Microsoft und Best Buy. Um sein Ziel zu erreichen, wird Amazon die Emissionen in allen Bereichen seiner GeschÃÂÃÂ¤ftstÃÂÃÂ¤tigkeit weiter reduzieren. Zu diesem Zweck wird das Unternehmen einen Weg finden, seinen Betrieb zu 100 % mit erneuerbarer Energie zu versorgen, fÃÂÃÂ¼nf Jahre vor dem ursprÃÂÃÂ¼nglichen Ziel des Unternehmens bis 2030; es wird seine ÃÂÃÂShipment ZeroÃÂÃÂ-Vision verwirklichen, wonach alle Lieferungen bis 2030 zu 50 % netto kohlenstofffrei sein sollen; und es wird 100.000 elektrische Lieferfahrzeuge kaufen, die bisher grÃÂÃÂ¶ÃÂÃÂte Bestellung von elektrischen Lieferfahrzeugen. Weitere Informationen finden Sie unter https://sustainability.aboutamazon.com/. ÃÂÃÂber Amazon Amazon orientiert sich an vier GrundsÃÂÃÂ¤tzen: Orientierung am Kunden statt an der Konkurrenz, Leidenschaft fÃÂÃÂ¼r Neuerungen, Einsatz fÃÂÃÂ¼r betriebliche Optimierung sowie langfristiges Denken. Kundenrezensionen, 1-Klick-EinkÃÂÃÂ¤ufe, persÃÂÃÂ¶nliche Empfehlungen, Prime, Versand durch Amazon, AWS, Kindle Direct Publishing, Kindle, Fire-Tablets, Fire TV, Amazon Echo und Alexa sind nur einige der von Amazon angebotenen Produkte und Dienstleistungen. FÃÂÃÂ¼r weitere Informationen besuchen Sie amazon.com/about und folgen Sie @AmazonNews. ÃÂÃÂber Amazon Web Services Seit 14 Jahren ist Amazon Web Services die umfassendste und am weitesten verbreitete Cloud-Plattform der Welt. AWS bietet ÃÂÃÂ¼ber 175 voll ausgestattete Dienste fÃÂÃÂ¼r Computing, Speicher, Datenbanken, Networking, Analytik, Robotertechnik, maschinelles Lernen und kÃÂÃÂ¼nstliche Intelligenz (KI), das Internet der Dinge (Internet of Things, IoT), mobile Technologien, Sicherheit, Hybrid, Virtual und Augmented Reality (VR und AR), Medien und Anwendungsentwicklung, Bereitstellung sowie Management aus 77 VerfÃÂÃÂ¼gbarkeitszonen (Availability Zones, AZs) in 24 geografischen Regionen, mit angekÃÂÃÂ¼ndigten PlÃÂÃÂ¤nen fÃÂÃÂ¼r 18 weitere VerfÃÂÃÂ¼gbarkeitszonen und fÃÂÃÂ¼nf weitere AWS-Regionen in Australien, Indien, Indonesien, Japan, Spanien und der Schweiz. Millionen von Kunden ÃÂÃÂ darunter die am schnellsten wachsenden Start-ups, grÃÂÃÂ¶ÃÂÃÂten Unternehmen und fÃÂÃÂ¼hrenden RegierungsbehÃÂÃÂ¶rden ÃÂÃÂ vertrauen AWS, um ihre Infrastruktur mit Strom zu versorgen, agiler zu werden und Kosten zu senken. Mehr Informationen zu AWS erhalten Sie unter aws.amazon.com. Die Ausgangssprache, in der der Originaltext verÃÂÃÂ¶ffentlicht wird, ist die offizielle und autorisierte Version. ÃÂÃÂbersetzungen werden zur besseren VerstÃÂÃÂ¤ndigung mitgeliefert. Nur die Sprachversion, die im Original verÃÂÃÂ¶ffentlicht wurde, ist rechtsgÃÂÃÂ¼ltig. Gleichen Sie deshalb ÃÂÃÂbersetzungen mit der originalen Sprachversion der VerÃÂÃÂ¶ffentlichung ab.",https://www.businesswire.com/news/home/20201210006214/de/,businesswire.com,5,seattlebusiness wireamazon nasdaq amzn kndigte heute neue wind und solarenergieprojekte im versorgungsbereich mit einer gesamtkapazitt von gigawatt gw stromerzeugungskapazitt damit wird amazon im jahr insgesamt projekte und mehr al gw kapazitt erneuerbare energien investieren die grte investition eines unternehmens erneuerbare energien innerhalb eines einzigen jahres durch diese neuen projekte wird amazon zum grten gewerblichen abnehmer von erneuerbarer energie den e je gab amazon hat mittlerweile gw wind und solarprojekte investiert die e dem unternehmen ermglichen werden seinen betrieb jhrlich mit mehr al millionen megawattstunden mwh erneuerbarer energie zu versorgen da reicht au um millionen ushaushalte ein jahr lang mit strom zu versorgen diese projekte werden erneuerbare energie fr die niederlassungen fulfillmentzentren und amazon web service awsrechenzentren von amazon liefern die millionen von kunden weltweit untersttzen sie werden auerdem dazu beitragen amazon ziel voranzutreiben bi einen nettonullaussto kohlendioxidemissionen im gesamten unternehmen zu erreichen teil dieser verpflichtung ist e amazon infrastruktur zu mit erneuerbarer energie zu versorgen und da unternehmen ist nun auf dem weg diesen meilenstein bi zu erreichen fnf jahre vor dem ursprnglichen ziel fr amazon trgt zur bekmpfung de klimawandels bei indem da unternehmen schnell dazu bergeht seine geschfte mit erneuerbarer energie zu betreiben sagte jeff bezos grnder und ceo von amazon mit insgesamt solar und windprojekten ist amazon heute der grte gewerbliche abnehmer von erneuerbaren energien berhaupt wir sind auf dem weg bi unser geschft zu mit erneuerbarer energie zu betreiben fnf jahre vor unserem ursprnglichen ziel bi dy ist nur einer der vielen schritte die wir unternehmen und die un dabei helfen werden unser klimaversprechen zu erfllen ich knnte nicht stolzer auf die team bei amazon sein die weiterhin hart intelligent und schnell daran arbeiten diese projekte zum laufen zu bringen die neuen wind und solarprojekte die heute angekndigt wurden befinden sich australien frankreich deutschland italien sdafrika schweden grobritannien und den usa die neuen projekte sind die ersten von amazon frankreich deutschland italien und sdafrika den usa hat amazon inzwischen wind und solarprojekte kalifornien delaware illinois indiana kansa kentucky nebraska north carolina ohio texas und virginia realisiert amazon verfgt weltweit ber insgesamt projekte im bereich erneuerbare energien darunter wind und solarprojekte im versorgungsbereich und solardcher auf fulfillment und sortierzentren rund um den globus investitionen de privaten sektors sind unerlsslich um erneuerbare energien dem tempo auszubauen da fr den globalen klimaschutz erforderlich ist sagte miranda ballentine ceo der renewable energy buyer alliance reba allein die den usa angesiedelten projekte machen amazon ankndigung um umfangreicher al die bisher grte ankndigung eines einzelnen abnehmers im bereich der unternehmensbeschaffung und verdeutlichen die fhrungsrolle und da engagement de unternehmens fr eine saubere und blhende energiezukunft im namen de sektors fr erneuerbare energien gratulieren wir amazon fr seinen beispiellosen beitrag zum bergang zu erneuerbaren energien diesem jahr mit beeindruckenden groen neuen projekten im bereich der erneuerbaren energien im jahr gebhrt amazon ein enormes lob fr seine fhrungsrolle bei der weltweiten umstellung auf erneuerbare energien die beschaffung von mehr al mw neuer erneuerbarer energie einem einzigen jahr ist eine unglaubliche leistung und ein groer fortschritt auf dem weg zu amazon ziel sich zu mit erneuerbarer energie zu versorgen wir sind amazon sehr dankbar fr die bemhungen de unternehmens un dabei zu helfen greifbarer nhe der reduzierung der treibhausgasemissionen zu bleiben die laut wissenschaftlern notwendig ist um die schlimmsten auswirkungen de klimawandels zu vermeiden sagte gregory wetstone president und ceo de american council renewable energy acore letztes jahr grndeten amazon und global optimism gemeinsam climate pledge eine verpflichtung da pariser abkommen jahre frher zu erreichen und bi netto kohlenstofffrei zu sein da klimaversprechen pledge hat inzwischen unterzeichner darunter unilever verizon siemens microsoft und best buy um sein ziel zu erreichen wird amazon die emissionen allen bereichen seiner geschftsttigkeit weiter reduzieren zu diesem zweck wird da unternehmen einen weg finden seinen betrieb zu mit erneuerbarer energie zu versorgen fnf jahre vor dem ursprnglichen ziel de unternehmens bi e wird seine shipment zerovision verwirklichen wonach alle lieferungen bi zu netto kohlenstofffrei sein sollen und e wird elektrische lieferfahrzeuge kaufen die bisher grte bestellung von elektrischen lieferfahrzeugen weitere informationen finden sie unter ber amazon amazon orientiert sich vier grundstzen orientierung kunden statt der konkurrenz leidenschaft fr neuerungen einsatz fr betriebliche optimierung sowie langfristiges denken kundenrezensionen klickeinkufe persnliche empfehlungen prime versand durch amazon aws kindle direct publishing kindle firetablets fire tv amazon echo und alexa sind nur einige der von amazon angebotenen produkte und dienstleistungen fr weitere informationen besuchen sie amazoncomabout und folgen sie amazonnews ber amazon web service seit jahren ist amazon web service die umfassendste und weitesten verbreitete cloudplattform der welt aws bietet ber voll ausgestattete dienste fr computing speicher datenbanken networking analytik robotertechnik maschinelles lernen und knstliche intelligenz ki da internet der dinge internet thing iot mobile technologien sicherheit hybrid virtual und augmented reality vr und ar medien und anwendungsentwicklung bereitstellung sowie management au verfgbarkeitszonen availability zone az geografischen regionen mit angekndigten plnen fr weitere verfgbarkeitszonen und fnf weitere awsregionen australien indien indonesien japan spanien und der schweiz millionen von kunden darunter die schnellsten wachsenden startup grten unternehmen und fhrenden regierungsbehrden vertrauen aws um ihre infrastruktur mit strom zu versorgen agiler zu werden und kosten zu senken mehr informationen zu aws erhalten sie unter awsamazoncom die ausgangssprache der der originaltext verffentlicht wird ist die offizielle und autorisierte version bersetzungen werden zur besseren verstndigung mitgeliefert nur die sprachversion die im original verffentlicht wurde ist rechtsgltig gleichen sie deshalb bersetzungen mit der originalen sprachversion der verffentlichung ab,-0.9966,-0.4983,0.1822151515,-0.680515152,Negative Impact
11/12/2020,154.833,155.93,153.64,155.82,155.82,61294000,2.13,76.34428766,1.192,0,9.3404,0.9034837908,0.2283735172,0.09,260.474,12377.87012,14355.29004,6546.799805,5507.549805,3347.190918,46099.01172,17548.90039,159.1184302,139.3774595,157.8646342,142.071667,157.2815735,161.2038175,153.3593295,52.4355914,-0.461388096,-0.238062193,-0.223325902,3.135320391,167.4907486,9689240000,27.77267738,22.84053488,23.30999947,AWS und Arm demonstrieren Elektronik-Design-Automatisierung im ProduktionsmaÃÂÃÂstab in der Cloud,"SEATTLE--(BUSINESS WIRE)--Amazon Web Services, Inc. (AWS), ein Unternehmen von Amazon.com, Inc. (NASDAQ: AMZN), gab heute bekannt, dass Arm, ein weltweit fÃÂÃÂ¼hrendes Unternehmen in den Bereichen Halbleiterdesign sowie Entwicklung und Lizenzierung von geistigem Eigentum an Silizium, AWS fÃÂÃÂ¼r seine Cloud-Nutzung, einschlieÃÂÃÂlich des grÃÂÃÂ¶ÃÂÃÂten Teils seines EDA-Arbeitsaufkommens (Electronic Design Automation), einsetzen wird. Arm migriert EDA-Arbeitslasten auf AWS, nutzt AWS Graviton2-basierte Instanzen (die von Arm-Neoverse-Kernen angetrieben werden) und ist fÃÂÃÂ¼hrend bei der Transformation der Halbleiterindustrie, die traditionell vor Ort Rechenzentren fÃÂÃÂ¼r die rechenintensive Arbeit der Verifizierung von Halbleiterdesigns verwendet hat. Um die Verifikation effizienter durchfÃÂÃÂ¼hren zu kÃÂÃÂ¶nnen, nutzt Arm die Cloud zur DurchfÃÂÃÂ¼hrung von Simulationen realer Berechnungsszenarien und nutzt dabei die praktisch unbegrenzte SpeicherkapazitÃÂÃÂ¤t und die Hochleistungs-Computing-Infrastruktur von AWS, um die Anzahl der Simulationen, die parallel ausgefÃÂÃÂ¼hrt werden kÃÂÃÂ¶nnen, zu skalieren. Seit Beginn seiner AWS-Cloud-Migration hat Arm eine sechsfache Verbesserung der Leistungszeit fÃÂÃÂ¼r EDA-Workflows auf AWS realisiert. DarÃÂÃÂ¼ber hinaus generiert Arm durch die AusfÃÂÃÂ¼hrung von Telemetrie (die Sammlung und Integration von Daten aus entfernten Quellen) und Analysen auf AWS leistungsfÃÂÃÂ¤higere technische, geschÃÂÃÂ¤ftliche und BetriebsablÃÂÃÂ¤ufe, die zur Steigerung der Workflow-Effizienz und zur Optimierung von Kosten und Ressourcen im gesamten Unternehmen beitragen. Letztendlich plant Arm, seinen globalen Rechenzentrums-FuÃÂÃÂabdruck um mindestens 45 % zu reduzieren, und seine Vor-Ort-Rechnungen um 80 %, wenn die Migration auf AWS abgeschlossen ist. Hochspezialisierte HalbleitergerÃÂÃÂ¤te sind die Grundlage fÃÂÃÂ¼r die wachsenden FÃÂÃÂ¤higkeiten aller GerÃÂÃÂ¤te, von Smartphones ÃÂÃÂ¼ber die Infrastruktur von Rechenzentren bis hin zu medizinischen GerÃÂÃÂ¤ten und selbstfahrenden Fahrzeugen. Jeder Chip kann Milliarden von Transistoren enthalten, die bis in den einstelligen Nanometerbereich (etwa 100.000x kleiner als die Breite eines menschlichen Haares) entwickelt wurden, um maximale Leistung auf minimalem Raum zu erzielen. EDA ist eine der SchlÃÂÃÂ¼sseltechnologien, die eine solche extreme Technik mÃÂÃÂ¶glich machen. EDA-Workflows sind komplex und umfassen Front-End-Design, Simulation und Verifikation sowie zunehmend groÃÂÃÂe Back-End-Arbeitslasten, die Zeit- und Leistungsanalysen, DesignregelprÃÂÃÂ¼fungen und andere Anwendungen zur Vorbereitung des Chips fÃÂÃÂ¼r die Produktion umfassen. Diese hochgradig iterativen Workflows nehmen traditionell viele Monate oder sogar Jahre in Anspruch, um ein neues GerÃÂÃÂ¤t, wie z. B. ein System-on-a-Chip, herzustellen, und erfordern eine enorme Rechenleistung. Halbleiterunternehmen, die diese Arbeitslasten vor Ort ausfÃÂÃÂ¼hren, mÃÂÃÂ¼ssen stÃÂÃÂ¤ndig Kosten, ZeitplÃÂÃÂ¤ne und Rechenzentrumsressourcen ausgleichen, um mehrere Projekte gleichzeitig voranzubringen. Infolgedessen kÃÂÃÂ¶nnen sie mit EngpÃÂÃÂ¤ssen bei der Rechenleistung konfrontiert werden, die den Fortschritt verlangsamen oder die Kosten fÃÂÃÂ¼r die Aufrechterhaltung ungenutzter RechenkapazitÃÂÃÂ¤ten tragen. Durch die Migration seiner EDA-Arbeitslasten auf AWS ÃÂÃÂ¼berwindet Arm die EinschrÃÂÃÂ¤nkungen herkÃÂÃÂ¶mmlich verwalteter EDA-Workflows und gewinnt an ElastizitÃÂÃÂ¤t durch massiv skalierbare Rechenleistung, die es ihm ermÃÂÃÂ¶glicht, Simulationen parallel auszufÃÂÃÂ¼hren, Telemetrie und Analyse zu vereinfachen, die Iterationszeit fÃÂÃÂ¼r Halbleiter-Designs zu reduzieren und Testzyklen hinzuzufÃÂÃÂ¼gen, ohne die LieferplÃÂÃÂ¤ne zu beeintrÃÂÃÂ¤chtigen. Arm nutzt die Amazon Elastic Compute Cloud (Amazon EC2), um seine Kosten und ZeitplÃÂÃÂ¤ne durch die Optimierung von EDA-Workflows ÃÂÃÂ¼ber die groÃÂÃÂe Vielfalt an spezialisierten Amazon-EC2-Instanzarten hinweg zu rationalisieren. So verwendet das Unternehmen beispielsweise AWS Graviton2-basierte Instanzen, um eine hohe Leistung und Skalierbarkeit zu erreichen, was zu einem kostengÃÂÃÂ¼nstigeren Betriebsablauf fÃÂÃÂ¼hrt als der Betrieb von Hunderttausenden von Servern vor Ort. Arm verwendet AWS Compute Optimizer, eine Dienstleistung, die Maschinelles Lernen verwendet, um die optimalen Amazon-EC2-Instanzentypen fÃÂÃÂ¼r bestimmte Arbeitslasten zu empfehlen, um seine ArbeitsablÃÂÃÂ¤ufe zu rationalisieren. ZusÃÂÃÂ¤tzlich zu den Kostenvorteilen nutzt Arm die hohe Leistung der AWS-Graviton2-Instanzen, um den Durchsatz fÃÂÃÂ¼r seine Engineering-Workloads zu erhÃÂÃÂ¶hen, wobei der Durchsatz pro Dollar im Vergleich zu den x86-Prozessor-basierten M5-Instanzen der vorherigen Generation um ÃÂÃÂ¼ber 40 % verbessert wird. DarÃÂÃÂ¼ber hinaus nutzt Arm Dienstleistungen des AWS-Partners Databricks, um Machine-Learning-Anwendungen in der Cloud zu entwickeln und auszufÃÂÃÂ¼hren. Durch die Databricks-Plattform, die auf Amazon EC2 lÃÂÃÂ¤uft, kann Arm Daten aus jedem Schritt in seinen technischen ArbeitsablÃÂÃÂ¤ufen verarbeiten, um umsetzbare Erkenntnisse fÃÂÃÂ¼r die Hardware- und Softwaregruppen des Unternehmens zu generieren und eine messbare Verbesserung der technischen Effizienz zu erreichen. ÃÂÃÂDurch unsere Zusammenarbeit mit AWS haben wir uns auf die Verbesserung der Effizienz und die Maximierung des Durchsatzes konzentriert, um unseren Ingenieuren wertvolle Zeit zurÃÂÃÂ¼ckzugeben, damit sie sich auf Innovationen konzentrieren kÃÂÃÂ¶nnenÃÂÃÂ, sagte Rene Haas, President von IPG, Arm. ÃÂÃÂJetzt, da wir auf Amazon EC2 mit AWS-Graviton2-Instanzen mit auf Arm Neoverse basierenden Prozessoren laufen kÃÂÃÂ¶nnen, optimieren wir die technischen ArbeitsablÃÂÃÂ¤ufe, reduzieren die Kosten und beschleunigen die ProjektzeitplÃÂÃÂ¤ne, um unseren Kunden schneller und kostengÃÂÃÂ¼nstiger als je zuvor leistungsstarke Ergebnisse zu liefern.ÃÂÃÂ ÃÂÃÂAWS bietet wirklich elastische Hochleistungsrechner, unÃÂÃÂ¼bertroffene Netzwerkleistung und skalierbaren Speicher, der fÃÂÃÂ¼r die nÃÂÃÂ¤chste Generation von EDA-Arbeitslasten erforderlich ist, und deshalb freuen wir uns so sehr auf die Zusammenarbeit mit Arm, um ihre anspruchsvollen EDA-Arbeitslasten mit unseren hochleistungsfÃÂÃÂ¤higen Arm-basierten Graviton2-Prozessoren zu versorgenÃÂÃÂ, sagte Peter DeSantis, Senior Vice President of Global Infrastructure and Customer Support, AWS. ÃÂÃÂGraviton2-Prozessoren kÃÂÃÂ¶nnen einen Preis-Leistungs-Vorteil von bis zu 40 % gegenÃÂÃÂ¼ber x86-basierten Instanzen der aktuellen Generation bieten.ÃÂÃÂ ÃÂÃÂber Amazon Web Services Seit 14 Jahren ist Amazon Web Services die umfassendste und am weitesten verbreitete Cloud-Plattform der Welt. AWS bietet ÃÂÃÂ¼ber 175 voll ausgestattete Dienste fÃÂÃÂ¼r Computing, Speicher, Datenbanken, Networking, Analytik, Robotertechnik, maschinelles Lernen und kÃÂÃÂ¼nstliche Intelligenz (KI), das Internet der Dinge (Internet of Things, IoT), mobile Technologien, Sicherheit, Hybrid, Virtual und Augmented Reality (VR und AR), Medien und Anwendungsentwicklung, Bereitstellung sowie Management aus 77 VerfÃÂÃÂ¼gbarkeitszonen (Availability Zones, AZs) in 24 geografischen Regionen, mit angekÃÂÃÂ¼ndigten PlÃÂÃÂ¤nen fÃÂÃÂ¼r 18 weitere VerfÃÂÃÂ¼gbarkeitszonen und fÃÂÃÂ¼nf weitere AWS-Regionen in Australien, Indien, Indonesien, Japan, Spanien und der Schweiz. Millionen von Kunden ÃÂÃÂ darunter die am schnellsten wachsenden Start-ups, grÃÂÃÂ¶ÃÂÃÂten Unternehmen und fÃÂÃÂ¼hrenden RegierungsbehÃÂÃÂ¶rden ÃÂÃÂ vertrauen AWS, um ihre Infrastruktur mit Strom zu versorgen, agiler zu werden und Kosten zu senken. Mehr Informationen zu AWS erhalten Sie unter aws.amazon.com. ÃÂÃÂber Amazon Amazon orientiert sich an vier GrundsÃÂÃÂ¤tzen: Orientierung am Kunden statt an der Konkurrenz, Leidenschaft fÃÂÃÂ¼r Neuerungen, Einsatz fÃÂÃÂ¼r betriebliche Optimierung sowie langfristiges Denken. Kundenrezensionen, 1-Klick-EinkÃÂÃÂ¤ufe, persÃÂÃÂ¶nliche Empfehlungen, Prime, Versand durch Amazon, AWS, Kindle Direct Publishing, Kindle, Fire-Tablets, Fire TV, Amazon Echo und Alexa sind nur einige der von Amazon angebotenen Produkte und Dienstleistungen. FÃÂÃÂ¼r weitere Informationen besuchen Sie amazon.com/about und folgen Sie @AmazonNews. Die Ausgangssprache, in der der Originaltext verÃÂÃÂ¶ffentlicht wird, ist die offizielle und autorisierte Version. ÃÂÃÂbersetzungen werden zur besseren VerstÃÂÃÂ¤ndigung mitgeliefert. Nur die Sprachversion, die im Original verÃÂÃÂ¶ffentlicht wurde, ist rechtsgÃÂÃÂ¼ltig. Gleichen Sie deshalb ÃÂÃÂbersetzungen mit der originalen Sprachversion der VerÃÂÃÂ¶ffentlichung ab.",https://www.businesswire.com/news/home/20201211005205/de/,businesswire.com,5,seattlebusiness wireamazon web service inc aws ein unternehmen von amazoncom inc nasdaq amzn gab heute bekannt das arm ein weltweit fhrendes unternehmen den bereichen halbleiterdesign sowie entwicklung und lizenzierung von geistigem eigentum silizium aws fr seine cloudnutzung einschlielich de grten teils seine edaarbeitsaufkommens electronic design automation einsetzen wird arm migriert edaarbeitslasten auf aws nutzt aws gravitonbasierte instanzen die von armneoversekernen angetrieben werden und ist fhrend bei der transformation der halbleiterindustrie die traditionell vor ort rechenzentren fr die rechenintensive arbeit der verifizierung von halbleiterdesigns verwendet hat um die verifikation effizienter durchfhren zu knnen nutzt arm die cloud zur durchfhrung von simulationen realer berechnungsszenarien und nutzt dabei die praktisch unbegrenzte speicherkapazitt und die hochleistungscomputinginfrastruktur von aws um die anzahl der simulationen die parallel ausgefhrt werden knnen zu skalieren seit beginn seiner awscloudmigration hat arm eine sechsfache verbesserung der leistungszeit fr edaworkflows auf aws realisiert darber hinaus generiert arm durch die ausfhrung von telemetrie die sammlung und integration von daten au entfernten quellen und analysen auf aws leistungsfhigere technische geschftliche und betriebsablufe die zur steigerung der workfloweffizienz und zur optimierung von kosten und ressourcen im gesamten unternehmen beitragen letztendlich plant arm seinen globalen rechenzentrumsfuabdruck um mindestens zu reduzieren und seine vorortrechnungen um wenn die migration auf aws abgeschlossen ist hochspezialisierte halbleitergerte sind die grundlage fr die wachsenden fhigkeiten aller gerte von smartphones ber die infrastruktur von rechenzentren bi hin zu medizinischen gerten und selbstfahrenden fahrzeugen jeder chip kann milliarden von transistoren enthalten die bi den einstelligen nanometerbereich etwa x kleiner al die breite eines menschlichen haares entwickelt wurden um maximale leistung auf minimalem raum zu erzielen eda ist eine der schlsseltechnologien die eine solche extreme technik mglich machen edaworkflows sind komplex und umfassen frontenddesign simulation und verifikation sowie zunehmend groe backendarbeitslasten die zeit und leistungsanalysen designregelprfungen und andere anwendungen zur vorbereitung de chip fr die produktion umfassen diese hochgradig iterativen workflow nehmen traditionell viele monate oder sogar jahre anspruch um ein neues gert wie z b ein systemonachip herzustellen und erfordern eine enorme rechenleistung halbleiterunternehmen die diese arbeitslasten vor ort ausfhren mssen stndig kosten zeitplne und rechenzentrumsressourcen ausgleichen um mehrere projekte gleichzeitig voranzubringen infolgedessen knnen sie mit engpssen bei der rechenleistung konfrontiert werden die den fortschritt verlangsamen oder die kosten fr die aufrechterhaltung ungenutzter rechenkapazitten tragen durch die migration seiner edaarbeitslasten auf aws berwindet arm die einschrnkungen herkmmlich verwalteter edaworkflows und gewinnt elastizitt durch massiv skalierbare rechenleistung die e ihm ermglicht simulationen parallel auszufhren telemetrie und analyse zu vereinfachen die iterationszeit fr halbleiterdesigns zu reduzieren und testzyklen hinzuzufgen ohne die lieferplne zu beeintrchtigen arm nutzt die amazon elastic compute cloud amazon ec um seine kosten und zeitplne durch die optimierung von edaworkflows ber die groe vielfalt spezialisierten amazonecinstanzarten hinweg zu rationalisieren verwendet da unternehmen beispielsweise aws gravitonbasierte instanzen um eine hohe leistung und skalierbarkeit zu erreichen zu einem kostengnstigeren betriebsablauf fhrt al der betrieb von hunderttausenden von servern vor ort arm verwendet aws compute optimizer eine dienstleistung die maschinelles lernen verwendet um die optimalen amazonecinstanzentypen fr bestimmte arbeitslasten zu empfehlen um seine arbeitsablufe zu rationalisieren zustzlich zu den kostenvorteilen nutzt arm die hohe leistung der awsgravitoninstanzen um den durchsatz fr seine engineeringworkloads zu erhhen wobei der durchsatz pro dollar im vergleich zu den xprozessorbasierten minstanzen der vorherigen generation um ber verbessert wird darber hinaus nutzt arm dienstleistungen de awspartners databricks um machinelearninganwendungen der cloud zu entwickeln und auszufhren durch die databricksplattform die auf amazon ec luft kann arm daten au jedem schritt seinen technischen arbeitsablufen verarbeiten um umsetzbare erkenntnisse fr die hardware und softwaregruppen de unternehmens zu generieren und eine messbare verbesserung der technischen effizienz zu erreichen durch unsere zusammenarbeit mit aws haben wir un auf die verbesserung der effizienz und die maximierung de durchsatzes konzentriert um unseren ingenieuren wertvolle zeit zurckzugeben damit sie sich auf innovationen konzentrieren knnen sagte rene haas president von ipg arm jetzt da wir auf amazon ec mit awsgravitoninstanzen mit auf arm neoverse basierenden prozessoren laufen knnen optimieren wir die technischen arbeitsablufe reduzieren die kosten und beschleunigen die projektzeitplne um unseren kunden schneller und kostengnstiger al je zuvor leistungsstarke ergebnisse zu liefern aws bietet wirklich elastische hochleistungsrechner unbertroffene netzwerkleistung und skalierbaren speicher der fr die nchste generation von edaarbeitslasten erforderlich ist und deshalb freuen wir un sehr auf die zusammenarbeit mit arm um ihre anspruchsvollen edaarbeitslasten mit unseren hochleistungsfhigen armbasierten gravitonprozessoren zu versorgen sagte peter desantis senior vice president global infrastructure customer support aws gravitonprozessoren knnen einen preisleistungsvorteil von bi zu gegenber xbasierten instanzen der aktuellen generation bieten ber amazon web service seit jahren ist amazon web service die umfassendste und weitesten verbreitete cloudplattform der welt aws bietet ber voll ausgestattete dienste fr computing speicher datenbanken networking analytik robotertechnik maschinelles lernen und knstliche intelligenz ki da internet der dinge internet thing iot mobile technologien sicherheit hybrid virtual und augmented reality vr und ar medien und anwendungsentwicklung bereitstellung sowie management au verfgbarkeitszonen availability zone az geografischen regionen mit angekndigten plnen fr weitere verfgbarkeitszonen und fnf weitere awsregionen australien indien indonesien japan spanien und der schweiz millionen von kunden darunter die schnellsten wachsenden startup grten unternehmen und fhrenden regierungsbehrden vertrauen aws um ihre infrastruktur mit strom zu versorgen agiler zu werden und kosten zu senken mehr informationen zu aws erhalten sie unter awsamazoncom ber amazon amazon orientiert sich vier grundstzen orientierung kunden statt der konkurrenz leidenschaft fr neuerungen einsatz fr betriebliche optimierung sowie langfristiges denken kundenrezensionen klickeinkufe persnliche empfehlungen prime versand durch amazon aws kindle direct publishing kindle firetablets fire tv amazon echo und alexa sind nur einige der von amazon angebotenen produkte und dienstleistungen fr weitere informationen besuchen sie amazoncomabout und folgen sie amazonnews die ausgangssprache der der originaltext verffentlicht wird ist die offizielle und autorisierte version bersetzungen werden zur besseren verstndigung mitgeliefert nur die sprachversion die im original verffentlicht wurde ist rechtsgltig gleichen sie deshalb bersetzungen mit der originalen sprachversion der verffentlichung ab,-0.9996,-0.4998,0.1179636364,-0.617763636,Negative Impact
14/12/2020,157.15,159.52,156.30,157.85,157.85,83116000,2.13,76.34428766,1.192,0,9.3404,0.9034837908,0.2283735172,0.09,260.474,12440.04004,14214.92969,6531.799805,5527.839844,3369.120117,46253.46094,17387.40039,159.1504001,139.6782145,157.8640013,142.2286504,157.351973,161.261176,153.4427699,57.5307125,-0.377041514,-0.265858058,-0.111183457,3.134462629,166.659764,9772356000,47.77715016,31.72858625,24.71999931,"Star Alliance geht All-In bei AWS, um die nÃÂÃÂ¤chste ÃÂÃÂra des Flugverkehrs zu erfinden","SEATTLE--(BUSINESS WIRE)--Heute gab Amazon Web Services (AWS), ein Unternehmen von Amazon.com, Inc. (NASDAQ: AMZN), bekannt, dass die Star Alliance, die weltweit grÃÂÃÂ¶ÃÂÃÂte Airline-Allianz, all-in auf AWS setzt und ihre gesamte IT-Infrastruktur in die weltweit fÃÂÃÂ¼hrende Cloud verlagert, um Kosten zu senken, die Leistung zu verbessern und ein agileres Unternehmen in der Cloud zu werden. Star Alliance arbeitet mit Tata Consultancy Services (TCS) ÃÂÃÂ einem Premier Consulting Partner des AWS Partnernetzwerks ÃÂÃÂ zusammen, um alle ihre Daten, Plattformen und geschÃÂÃÂ¤ftskritischen Anwendungen auf AWS zu migrieren und ihre Rechenzentren zu schlieÃÂÃÂen, wodurch die Gesamtbetriebskosten der Infrastruktur um 25 % gesenkt werden. Die Airline-Allianz nutzt die unÃÂÃÂ¼bertroffenen FÃÂÃÂ¤higkeiten von AWS, darunter Analytik, Sicherheit, verwaltete Datenbanken, Speicherung und Maschinelles Lernen, um ihren 26 Mitgliedsfluggesellschaften Echtzeit-Einblicke zu verschaffen, die dazu beitragen werden, das globale Reiseerlebnis fÃÂÃÂ¼r ihre Passagiere zu verbessern, selbst mit der durch die COVID-19-Pandemie verursachten Unsicherheit. Durch den Umstieg auf AWS hat die Star Alliance die FlexibilitÃÂÃÂ¤t gewonnen, ihre bestehende Infrastrukturnutzung und Kosten sofort zu optimieren, um den sich ÃÂÃÂ¤ndernden Anforderungen im weltweiten Flugverkehr, insbesondere im Hinblick auf COVID-19, gerecht zu werden. Als die QuarantÃÂÃÂ¤neanweisungen und ReisebeschrÃÂÃÂ¤nkungen in Kraft traten, reduzierte das Unternehmen sofort seinen Infrastrukturbedarf und seine Ausgaben um 30 % und verringerte die Nutzung von AWS, anstatt fÃÂÃÂ¼r ÃÂÃÂ¼berschÃÂÃÂ¼ssige KapazitÃÂÃÂ¤ten vor Ort zu bezahlen. Mit der Nutzung von AWS rÃÂÃÂ¼stet sich die Star Alliance fÃÂÃÂ¼r die Zukunft, wenn die weltweiten ReisebeschrÃÂÃÂ¤nkungen nachlassen und die Kunden wieder regelmÃÂÃÂ¤ÃÂÃÂig fliegen. Die Organisation ist nun in der Lage, Anwendungen in der HÃÂÃÂ¤lfte der Zeit einzufÃÂÃÂ¼hren, indem sie den Amazon Elastic Container Service mit AWS Fargate (eine serverlose Rechenmaschine fÃÂÃÂ¼r Container, die die Erstellung von Anwendungen erleichtert) nutzt, um Dienstleistungen zu betreiben, die das Reisen fÃÂÃÂ¼r die Passagiere einfacher und sicherer machen. Beispielsweise hat die Star Alliance eine Anwendung zur GepÃÂÃÂ¤ckverfolgung entwickelt, die Amazon Aurora (die relationale Datenbank von AWS, die fÃÂÃÂ¼r die Cloud entwickelt wurde) nutzt, um Daten von verschiedenen GepÃÂÃÂ¤cksystemen von Fluggesellschaften zu verarbeiten und BetriebsablÃÂÃÂ¤ufe und zentralisierte Berichte bereitzustellen, sodass die Kundendienstmitarbeiter der Fluggesellschaften GepÃÂÃÂ¤ck an FlughÃÂÃÂ¤fen auf der ganzen Welt verfolgen kÃÂÃÂ¶nnen. DarÃÂÃÂ¼ber hinaus macht die Anwendung ÃÂÃÂStar Alliance Inter Airline Through Check-in HubÃÂÃÂ ÃÂÃÂ eine Anwendung, die in Spitzenzeiten mehr als 12 Millionen Transaktionen pro Monat verarbeitet und analysiert und auf AWS lÃÂÃÂ¤uft ÃÂÃÂ den Check-in-Prozess fÃÂÃÂ¼r Reisende nahtlos, indem sie es den Passagieren ermÃÂÃÂ¶glicht, einzuchecken und Bordkarten fÃÂÃÂ¼r Reisen mit mehreren Zwischenstopps bei allen Star-Alliance-Mitgliedsgesellschaften zu erhalten. Durch die Entwicklung zu einer datengesteuerten Organisation in der Cloud nutzt die Star Alliance Analysen und Datenbanken von AWS, darunter Amazon Relational Database Service (Amazon RDS), Amazon Athena (der serverlose, interaktive Abfragedienst von AWS, der Standard-SQL verwendet) und Amazon QuickSight (der Business Intelligence-Dienst von AWS), um die zukÃÂÃÂ¼nftige Nachfrage nach Reisen und Trends zu ermitteln und das Erlebnis fÃÂÃÂ¼r die Kunden zu verbessern. Das Transfer Decision Tool der Alliance hilft ihren Mitgliedsfluggesellschaften bei der Verwaltung risikobehafteter Flugverbindungen in Echtzeit, sodass sie proaktive MaÃÂÃÂnahmen ergreifen kÃÂÃÂ¶nnen ÃÂÃÂ wie z. B. die schnelle Verfolgung eines Passagiers durch den Zoll und die EinwanderungsbehÃÂÃÂ¶rde ÃÂÃÂ um Kunden und ihr GepÃÂÃÂ¤ck schnell auf einen Anschlussflug umzubuchen. Dieses Tool ergÃÂÃÂ¤nzt den neuen Connections Service der Alliance (eine mobile App, die Reisende auf dem schnellsten Weg zu ihrem Abfluggate fÃÂÃÂ¼hrt und bei EngpÃÂÃÂ¤ssen die Fast Track Lanes des Flughafens freischaltet) und bietet ein schnelleres, kontaktloses Erlebnis am Flughafen. DarÃÂÃÂ¼ber hinaus ermÃÂÃÂ¶glicht die Star Alliance durch die Migration ihrer Altdatenbanken auf Amazon Aurora den Kundenservice-Teams ihrer Mitglieder schnelle, fundierte Entscheidungen zu treffen, die ihnen helfen, Vielflieger-PrÃÂÃÂ¤mienanfragen schneller zu bearbeiten und die PrÃÂÃÂ¤ferenzen der Passagiere zu berÃÂÃÂ¼cksichtigen, um personalisierte Reiseerlebnisse zu ermÃÂÃÂ¶glichen. FÃÂÃÂ¼r die Zukunft plant die Star Alliance die Schaffung eines Datensees auf Amazon Simple Storage Service (Amazon S3), der den Datenzugriff fÃÂÃÂ¼r die Mitgliedsfluggesellschaften zentralisieren wird, um die Entwicklung von Unternehmensanwendungen und Kundenfunktionen zu beschleunigen. Die Star Alliance wird dann in der Lage sein, AWS-Dienste fÃÂÃÂ¼r Maschinelles Lernen, wie Amazon SageMaker (die Dienstleistung von AWS, die es Datenwissenschaftlern und Entwicklern ermÃÂÃÂ¶glicht, maschinelle Lernmodelle schnell zu erstellen, zu trainieren und einzusetzen), auf die konsolidierten Daten anzuwenden, um einen Mehrwert wie die Verhinderung von Betrug im Zusammenhang mit LoyalitÃÂÃÂ¤t in den Vielfliegernetzwerken der Mitglieder zu erzielen. ÃÂÃÂWir haben uns fÃÂÃÂ¼r AWS entschieden, um die ZuverlÃÂÃÂ¤ssigkeit und Skalierbarkeit zu erreichen, die wir brauchten, um die steigende Zahl der Reisenden zu unterstÃÂÃÂ¼tzen, die jedes Jahr der Alliance beitreten, aber die Pandemie hat auch gezeigt, wie wertvoll eine flexible und agile Infrastruktur in der Cloud ist. Niemand hÃÂÃÂ¤tte vorhersagen kÃÂÃÂ¶nnen, was im Jahr 2020 bisher passiert ist, aber dank unserer Zusammenarbeit mit AWS konnten wir unsere Ziele schnell anpassen und unsere Ausgaben senkenÃÂÃÂ, sagte Jeremy Drury, Head of Digital & Technology bei Star Alliance. ÃÂÃÂNeben Kosteneinsparungen und ElastizitÃÂÃÂ¤t bietet uns AWS das umfassendste Angebot an Cloud-Diensten, mit denen wir schnell innovativ sein, neue Dienste zur Sicherheit der Reisenden einfÃÂÃÂ¼hren und das globale Reiseerlebnis immer wieder neu erfinden kÃÂÃÂ¶nnen.ÃÂÃÂ ÃÂÃÂMit dem Einstieg bei AWS nutzt die Star Alliance die ElastizitÃÂÃÂ¤t der Cloud, um von Branchentrends zu profitieren und ihre BetriebsablÃÂÃÂ¤ufe so zu gestalten, dass sie auf die sich drastisch verÃÂÃÂ¤ndernde Marktdynamik reagieren kÃÂÃÂ¶nnenÃÂÃÂ, sagte David Peller, Managing Director, Travel and Hospitality bei Amazon Web Services. ÃÂÃÂStar Alliance ist ein Paradebeispiel fÃÂÃÂ¼r eine globale Organisation, die die Cloud erfolgreich genutzt hat, um durch Zeiten der Unsicherheit zu steuern. Da die Welt erwartet, dass sie sich wieder ÃÂÃÂ¶ffnet, freuen wir uns auf die Zusammenarbeit mit Star Alliance, da sie die umfassenden Dienstleistungen von AWS nutzt, um neue Angebote in groÃÂÃÂem MaÃÂÃÂstab zu entwickeln und gleichzeitig die Messlatte fÃÂÃÂ¼r das, was fÃÂÃÂ¼r die nÃÂÃÂ¤chste ÃÂÃÂra des globalen Luftverkehrs mÃÂÃÂ¶glich ist, hÃÂÃÂ¶her zu legen.ÃÂÃÂ ÃÂÃÂDie globale Pandemie hat die Notwendigkeit fÃÂÃÂ¼r die Reisebranche verstÃÂÃÂ¤rkt, neue Technologien einzusetzen, die ihren Betriebsablauf, ihre geschÃÂÃÂ¤ftliche FlexibilitÃÂÃÂ¤t und ihre ReaktionsfÃÂÃÂ¤higkeit auf sich entwickelnde KundenbedÃÂÃÂ¼rfnisse und lokale Vorschriften verbessernÃÂÃÂ, sagte Arun Pradeep, Head, Travel, Transportation and Hospitality, Europa, TCS. ÃÂÃÂNachdem wir die IT-Umstellung von Star Alliance im Bereich AWS beschleunigt haben, helfen wir ihnen nun dabei, ihren Wert zu maximieren, indem wir FÃÂÃÂ¤higkeiten rund um fortschrittliche Analytik und Maschinelles Lernen nutzen, um ein hÃÂÃÂ¶heres MaÃÂÃÂ an Personalisierung und ÃÂÃÂ¼berlegene Kundenerlebnisse zu ermÃÂÃÂ¶glichen.ÃÂÃÂ ÃÂÃÂber Amazon Web Services Seit 14 Jahren ist Amazon Web Services die umfassendste und am weitesten verbreitete Cloud-Plattform der Welt. AWS bietet ÃÂÃÂ¼ber 175 voll ausgestattete Dienste fÃÂÃÂ¼r Computing, Speicher, Datenbanken, Networking, Analytik, Robotertechnik, maschinelles Lernen und kÃÂÃÂ¼nstliche Intelligenz (KI), das Internet der Dinge (Internet of Things, IoT), mobile Technologien, Sicherheit, Hybrid, Virtual und Augmented Reality (VR und AR), Medien und Anwendungsentwicklung, Bereitstellung sowie Management aus 77 VerfÃÂÃÂ¼gbarkeitszonen (Availability Zones, AZs) in 24 geografischen Regionen, mit angekÃÂÃÂ¼ndigten PlÃÂÃÂ¤nen fÃÂÃÂ¼r 18 weitere VerfÃÂÃÂ¼gbarkeitszonen und fÃÂÃÂ¼nf weitere AWS-Regionen in Australien, Indien, Indonesien, Japan, Spanien und der Schweiz. Millionen von Kunden ÃÂÃÂ darunter die am schnellsten wachsenden Start-ups, grÃÂÃÂ¶ÃÂÃÂten Unternehmen und fÃÂÃÂ¼hrenden RegierungsbehÃÂÃÂ¶rden ÃÂÃÂ vertrauen AWS, um ihre Infrastruktur mit Strom zu versorgen, agiler zu werden und Kosten zu senken. Mehr Informationen zu AWS erhalten Sie unter aws.amazon.com. ÃÂÃÂber Amazon Amazon orientiert sich an vier GrundsÃÂÃÂ¤tzen: Orientierung am Kunden statt an der Konkurrenz, Leidenschaft fÃÂÃÂ¼r Neuerungen, Einsatz fÃÂÃÂ¼r betriebliche Optimierung sowie langfristiges Denken. Kundenrezensionen, 1-Klick-EinkÃÂÃÂ¤ufe, persÃÂÃÂ¶nliche Empfehlungen, Prime, Versand durch Amazon, AWS, Kindle Direct Publishing, Kindle, Fire-Tablets, Fire TV, Amazon Echo und Alexa sind nur einige der von Amazon angebotenen Produkte und Dienstleistungen. Weitere Informationen finden Sie unter www.amazon.com/about und folgen Sie @AmazonNews. ÃÂÃÂber die Star Alliance Das Netzwerk der Star Alliance wurde 1997 als erste wirklich globale Airline-Allianz gegrÃÂÃÂ¼ndet, basierend auf dem Kundennutzenversprechen einer globalen Reichweite, weltweiter Anerkennung und nahtloser Dienstleistung. Seit der GrÃÂÃÂ¼ndung bietet sie das grÃÂÃÂ¶ÃÂÃÂte und umfassendste Flugliniennetz an, wobei der Schwerpunkt auf der Verbesserung des Kundenerlebnisses wÃÂÃÂ¤hrend der gesamten Alliance-Reise liegt. Folgende Fluggesellschaften sind Mitglieder von Star Alliance: Aegean Airlines, Air Canada, Air China, Air India, Air New Zealand, ANA, Asiana Airlines, Austrian, Avianca, Brussels Airlines, Copa Airlines, Croatia Airlines, EGYPTAIR, Ethiopian Airlines, EVA Air, LOT Polish Airlines, Lufthansa, Scandinavian Airlines, Shenzhen Airlines, Singapore Airlines, South African Airways, SWISS, TAP Air Portugal, THAI, Turkish Airlines und United. Insgesamt bietet das Netzwerk der Star Alliance derzeit mehr als 12.000 tÃÂÃÂ¤gliche FlÃÂÃÂ¼ge zu fast 1.300 FlughÃÂÃÂ¤fen in 197 LÃÂÃÂ¤ndern an. Weitere AnschlussflÃÂÃÂ¼ge werden von den Star-Alliance-Verbindungspartnern Juneyao Airlines und THAI Smile Airways angeboten. www.staralliance.com Die Ausgangssprache, in der der Originaltext verÃÂÃÂ¶ffentlicht wird, ist die offizielle und autorisierte Version. ÃÂÃÂbersetzungen werden zur besseren VerstÃÂÃÂ¤ndigung mitgeliefert. Nur die Sprachversion, die im Original verÃÂÃÂ¶ffentlicht wurde, ist rechtsgÃÂÃÂ¼ltig. Gleichen Sie deshalb ÃÂÃÂbersetzungen mit der originalen Sprachversion der VerÃÂÃÂ¶ffentlichung ab.",https://www.businesswire.com/news/home/20201214005829/de/,businesswire.com,5,seattlebusiness wireheute gab amazon web service aws ein unternehmen von amazoncom inc nasdaq amzn bekannt das die star alliance die weltweit grte airlineallianz allin auf aws setzt und ihre gesamte itinfrastruktur die weltweit fhrende cloud verlagert um kosten zu senken die leistung zu verbessern und ein agileres unternehmen der cloud zu werden star alliance arbeitet mit tata consultancy service tc einem premier consulting partner de aws partnernetzwerks zusammen um alle ihre daten plattformen und geschftskritischen anwendungen auf aws zu migrieren und ihre rechenzentren zu schlieen wodurch die gesamtbetriebskosten der infrastruktur um gesenkt werden die airlineallianz nutzt die unbertroffenen fhigkeiten von aws darunter analytik sicherheit verwaltete datenbanken speicherung und maschinelles lernen um ihren mitgliedsfluggesellschaften echtzeiteinblicke zu verschaffen die dazu beitragen werden da globale reiseerlebnis fr ihre passagiere zu verbessern selbst mit der durch die covidpandemie verursachten unsicherheit durch den umstieg auf aws hat die star alliance die flexibilitt gewonnen ihre bestehende infrastrukturnutzung und kosten sofort zu optimieren um den sich ndernden anforderungen im weltweiten flugverkehr insbesondere im hinblick auf covid gerecht zu werden al die quarantneanweisungen und reisebeschrnkungen kraft traten reduzierte da unternehmen sofort seinen infrastrukturbedarf und seine ausgaben um und verringerte die nutzung von aws anstatt fr berschssige kapazitten vor ort zu bezahlen mit der nutzung von aws rstet sich die star alliance fr die zukunft wenn die weltweiten reisebeschrnkungen nachlassen und die kunden wieder regelmig fliegen die organisation ist nun der lage anwendungen der hlfte der zeit einzufhren indem sie den amazon elastic container service mit aws fargate eine serverlose rechenmaschine fr container die die erstellung von anwendungen erleichtert nutzt um dienstleistungen zu betreiben die da reisen fr die passagiere einfacher und sicherer machen beispielsweise hat die star alliance eine anwendung zur gepckverfolgung entwickelt die amazon aurora die relationale datenbank von aws die fr die cloud entwickelt wurde nutzt um daten von verschiedenen gepcksystemen von fluggesellschaften zu verarbeiten und betriebsablufe und zentralisierte berichte bereitzustellen sodass die kundendienstmitarbeiter der fluggesellschaften gepck flughfen auf der ganzen welt verfolgen knnen darber hinaus macht die anwendung star alliance inter airline checkin hub eine anwendung die spitzenzeiten mehr al millionen transaktionen pro monat verarbeitet und analysiert und auf aws luft den checkinprozess fr reisende nahtlos indem sie e den passagieren ermglicht einzuchecken und bordkarten fr reisen mit mehreren zwischenstopps bei allen staralliancemitgliedsgesellschaften zu erhalten durch die entwicklung zu einer datengesteuerten organisation der cloud nutzt die star alliance analysen und datenbanken von aws darunter amazon relational database service amazon rds amazon athena der serverlose interaktive abfragedienst von aws der standardsql verwendet und amazon quicksight der business intelligencedienst von aws um die zuknftige nachfrage nach reisen und trend zu ermitteln und da erlebnis fr die kunden zu verbessern da transfer decision tool der alliance hilft ihren mitgliedsfluggesellschaften bei der verwaltung risikobehafteter flugverbindungen echtzeit sodass sie proaktive manahmen ergreifen knnen wie z b die schnelle verfolgung eines passagiers durch den zoll und die einwanderungsbehrde um kunden und ihr gepck schnell auf einen anschlussflug umzubuchen diesis tool ergnzt den neuen connection service der alliance eine mobile app die reisende auf dem schnellsten weg zu ihrem abfluggate fhrt und bei engpssen die fast track lane de flughafens freischaltet und bietet ein schnelleres kontaktloses erlebnis flughafen darber hinaus ermglicht die star alliance durch die migration ihrer altdatenbanken auf amazon aurora den kundenserviceteams ihrer mitglieder schnelle fundierte entscheidungen zu treffen die ihnen helfen vielfliegerprmienanfragen schneller zu bearbeiten und die prferenzen der passagiere zu bercksichtigen um personalisierte reiseerlebnisse zu ermglichen fr die zukunft plant die star alliance die schaffung eines datensees auf amazon simple storage service amazon der den datenzugriff fr die mitgliedsfluggesellschaften zentralisieren wird um die entwicklung von unternehmensanwendungen und kundenfunktionen zu beschleunigen die star alliance wird dann der lage sein awsdienste fr maschinelles lernen wie amazon sagemaker die dienstleistung von aws die e datenwissenschaftlern und entwicklern ermglicht maschinelle lernmodelle schnell zu erstellen zu trainieren und einzusetzen auf die konsolidierten daten anzuwenden um einen mehrwert wie die verhinderung von betrug im zusammenhang mit loyalitt den vielfliegernetzwerken der mitglieder zu erzielen wir haben un fr aws entschieden um die zuverlssigkeit und skalierbarkeit zu erreichen die wir brauchten um die steigende zahl der reisenden zu untersttzen die jedes jahr der alliance beitreten aber die pandemie hat auch gezeigt wie wertvoll eine flexible und agile infrastruktur der cloud ist niemand htte vorhersagen knnen im jahr bisher passiert ist aber dank unserer zusammenarbeit mit aws konnten wir unsere ziele schnell anpassen und unsere ausgaben senken sagte jeremy drury head digital technology bei star alliance neben kosteneinsparungen und elastizitt bietet un aws da umfassendste angebot clouddiensten mit denen wir schnell innovativ sein neue dienste zur sicherheit der reisenden einfhren und da globale reiseerlebnis immer wieder neu erfinden knnen mit dem einstieg bei aws nutzt die star alliance die elastizitt der cloud um von branchentrends zu profitieren und ihre betriebsablufe zu gestalt das sie auf die sich drastisch verndernde marktdynamik reagieren knnen sagte david peller managing director travel hospitality bei amazon web service star alliance ist ein paradebeispiel fr eine globale organisation die die cloud erfolgreich genutzt hat um durch zeiten der unsicherheit zu steuern da die welt erwartet das sie sich wieder ffnet freuen wir un auf die zusammenarbeit mit star alliance da sie die umfassenden dienstleistungen von aws nutzt um neue angebote groem mastab zu entwickeln und gleichzeitig die messlatte fr da fr die nchste ra de globalen luftverkehrs mglich ist hher zu legen die globale pandemie hat die notwendigkeit fr die reisebranche verstrkt neue technologien einzusetzen die ihren betriebsablauf ihre geschftliche flexibilitt und ihre reaktionsfhigkeit auf sich entwickelnde kundenbedrfnisse und lokale vorschriften verbessern sagte arun pradeep head travel transportation hospitality europa tc nachdem wir die itumstellung von star alliance im bereich aws beschleunigt haben helfen wir ihnen nun dabei ihren wert zu maximieren indem wir fhigkeiten rund um fortschrittliche analytik und maschinelles lernen nutzen um ein hheres personalisierung und berlegene kundenerlebnisse zu ermglichen ber amazon web service seit jahren ist amazon web service die umfassendste und weitesten verbreitete cloudplattform der welt aws bietet ber voll ausgestattete dienste fr computing speicher datenbanken networking analytik robotertechnik maschinelles lernen und knstliche intelligenz ki da internet der dinge internet thing iot mobile technologien sicherheit hybrid virtual und augmented reality vr und ar medien und anwendungsentwicklung bereitstellung sowie management au verfgbarkeitszonen availability zone az geografischen regionen mit angekndigten plnen fr weitere verfgbarkeitszonen und fnf weitere awsregionen australien indien indonesien japan spanien und der schweiz millionen von kunden darunter die schnellsten wachsenden startup grten unternehmen und fhrenden regierungsbehrden vertrauen aws um ihre infrastruktur mit strom zu versorgen agiler zu werden und kosten zu senken mehr informationen zu aws erhalten sie unter awsamazoncom ber amazon amazon orientiert sich vier grundstzen orientierung kunden statt der konkurrenz leidenschaft fr neuerungen einsatz fr betriebliche optimierung sowie langfristiges denken kundenrezensionen klickeinkufe persnliche empfehlungen prime versand durch amazon aws kindle direct publishing kindle firetablets fire tv amazon echo und alexa sind nur einige der von amazon angebotenen produkte und dienstleistungen weitere informationen finden sie unter und folgen sie amazonnews ber die star alliance da netzwerk der star alliance wurde al erste wirklich globale airlineallianz gegrndet basierend auf dem kundennutzenversprechen einer globalen reichweite weltweiter anerkennung und nahtloser dienstleistung seit der grndung bietet sie da grte und umfassendste flugliniennetz wobei der schwerpunkt auf der verbesserung de kundenerlebnisses whrend der gesamten alliancereise liegt folgende fluggesellschaften sind mitglieder von star alliance aegean airline air canada air china air india air new zealand ana asiana airline austrian avianca brussels airline copa airline croatia airline egyptair ethiopian airline eva air lot polish airline lufthansa scandinavian airline shenzhen airline singapore airline south african airway swiss tap air portugal thai turkish airline und united insgesamt bietet da netzwerk der star alliance derzeit mehr al tgliche flge zu fast flughfen lndern weitere anschlussflge werden von den starallianceverbindungspartnern juneyao airline und thai smile airway angeboten die ausgangssprache der der originaltext verffentlicht wird ist die offizielle und autorisierte version bersetzungen werden zur besseren verstndigung mitgeliefert nur die sprachversion die im original verffentlicht wurde ist rechtsgltig gleichen sie deshalb bersetzungen mit der originalen sprachversion der verffentlichung ab,-0.9998,-0.4999,0.1519902273,-0.651890227,Negative Impact
15/12/2020,159.0505,159.43,156.52,158.26,158.26,66390000,2.13,76.34428766,1.192,0,9.3404,0.9034837908,0.2283735172,0.09,260.474,12595.05957,14402.32031,6513.299805,5530.310059,3367.22998,46263.17188,17506.5,159.1163199,139.9922469,157.8793736,142.3881265,157.4371231,161.3472383,153.5270079,56.23441457,-0.274154021,-0.26751725,-0.006636771,3.170248849,165.8786386,9838746000,52.40443426,42.6514206,22.88999939,Amazon urges judge to set aside $10 billion cloud contract award to Microsoft,Amazon.com urged a U.S. judge to toss out the Pentagon's $10 billion JEDI cloud computing contract award after the Defense Department in September said a court-ordered re-evaluation had determined Microsoft Corp's proposal still represented the best value for the government.,https://www.reuters.com/article/us-amazon-com-pentagon/amazon-urges-judge-to-set-aside-10-billion-cloud-contract-award-to-microsoft-idUSKBN28P31I,reuters.com,10,amazoncom urged u judge toss pentagon billion jedi cloud computing contract award defense department september said courtordered reevaluation determined microsoft corp proposal still represented best value government,0.9186,0.9186,0.2140797059,0.7045202941,Positive Impact
16/12/2020,158.8005,162.35,158.18,162.05,162.05,88552000,2.13,76.34428766,1.192,0,9.3404,0.9034837908,0.2283735172,0.09,260.474,12658.19043,14408.94043,6570.899902,5547.680176,3366.98291,46666.46094,17567.40039,159.2573199,140.3085295,158.0428494,142.5837471,157.7003731,162.1029823,153.2977639,57.23495991,0.1120764209,-0.191598516,0.3036749369,3.182320731,165.1443807,9927298000,95.46368138,65.2150886,22.5,"Factbox-U.S. government, state lawsuits pile up against Big Tech market dominance","Texas, backed by nine other states, filed a lawsuit against Alphabet Inc's Google on Wednesday, accusing the internet search company of breaking antitrust law in how it runs its online advertising business.",https://www.reuters.com/article/us-tech-antitrust-google-states-factbox/factbox-u-s-government-state-lawsuits-pile-up-against-big-tech-market-dominance-idUSKBN28Q34X,reuters.com,10,texas backed nine state filed lawsuit alphabet inc google wednesday accusing internet search company breaking antitrust law run online advertising business,-0.3612,-0.3612,0.1383385,-0.4995385,Negative Impact
17/12/2020,162.5,163.18,161.05,161.80,161.80,69486000,2.13,76.34428766,1.192,0,9.3404,0.9034837908,0.2283735172,0.09,260.474,12764.75,14516.73047,6551.100098,5549.459961,3404.873047,46890.33984,17652.90039,159.29771,140.636542,158.1903455,142.7749934,158.0269234,162.6354736,153.4183731,55.34841607,0.3939367446,-0.074491464,0.4684282085,3.222999573,164.4541782,9857812000,85.61533673,77.82781746,21.93000031,NLRB investigation finds Amazon illegally discharged warehouse worker,"A National Labor Relations Board (NLRB) investigation has found merit to a complaint that said Amazon.com Inc illegally discharged a protesting warehouse worker in New York City, according to an NLRB spokesperson.",https://www.reuters.com/article/us-amazon-com-nlrb/nlrb-investigation-finds-amazon-illegally-discharged-warehouse-worker-idUSKBN28R319,reuters.com,10,national labor relation board nlrb investigation found merit complaint said amazoncom inc illegally discharged protesting warehouse worker new york city according nlrb spokesperson,-0.296,-0.296,0.281736087,-0.577736087,Negative Impact
18/12/2020,162.1995,162.47,158.58,160.08,160.08,119914000,2.13,76.34428766,1.192,0,9.3404,0.9034837908,0.2283735172,0.09,260.474,12755.63965,14467.82031,6529.200195,5527.839844,3394.899902,46960.69141,17534.59961,159.3088101,140.961682,158.2645478,142.9472075,158.2384987,162.814856,153.6621413,54.33131871,0.4729508123,0.03499699135,0.4379538209,3.133641924,163.8053879,9737898000,67.55989009,82.87963607,21.56999969,3 Stocks That Cut You a Check Each Month,You don't have to wait three months for your dividend payments.,https://www.fool.com/investing/2020/12/18/3-stocks-that-cut-you-a-check-each-month/,fool.com,7,dont wait three month dividend payment,0,0,0.3003428571,-0.300342857,Negative Impact
21/12/2020,160.0005,161.35,158.30,160.31,160.31,76736000,2.13,76.34428766,1.192,0,9.3404,0.9034837908,0.2283735172,0.09,260.474,12742.51953,14378.84961,6416.299805,5393.339844,3420.569092,45553.96094,17500.90039,159.2283401,141.3130745,158.3447226,143.1199617,158.5054489,162.8982216,154.1126762,47.95879131,0.5475351609,0.1375046253,0.4100305356,3.023641314,163.195525,9814634000,69.93548883,74.37023855,25.15999985,Make This Move as Washington's War Against Big Tech Heats Up,"If you are considering investing in one company, hoping for a big payday, the FAANG stocks shouldn't be at the top of your list. The post Make This Move as Washington's War Against Big Tech Heats Up appeared first on InvestorPlace.",https://investorplace.com/2020/12/make-this-move-as-washingtons-war-against-big-tech-heats-up/,investorplace.com,6,considering investing one company hoping big payday faang stock shouldnt top list post make move washington war big tech heat appeared first investorplace,-0.4003,-0.24018,0.3498466667,-0.590026667,Negative Impact
22/12/2020,160.142,161.10,159.00,160.33,160.33,47388000,2.13,76.34428766,1.192,0,9.3404,0.9034837908,0.2283735172,0.09,260.474,12807.91992,14321.33984,6416.299805,5466.859863,3356.781982,46006.69141,17552.5,158.9919302,141.6417495,158.4224199,143.2911661,158.7757744,162.8963769,154.6551719,50.46105198,0.601086464,0.230220993,0.370865471,2.963569641,162.6222539,9862022000,70.11377076,69.20304989,24.22999954,U.S. FDA warns Amazon's Whole Foods Market for misbranding food products,"The U.S. Food and Drug Administration (FDA) said on Tuesday it has issued a warning letter to Amazon.com Inc's Whole Foods Market for not labeling some products for the presence of food allergens, which led to a series of product recalls.",https://www.reuters.com/article/us-amazon-com-fda-whole-foods-market/u-s-fda-warns-amazons-whole-foods-market-for-misbranding-food-products-idUSKBN28W2GK,reuters.com,10,u food drug administration fda said tuesday issued warning letter amazoncom inc whole food market labeling product presence food allergen led series product recall,-0.34,-0.34,0.2899775,-0.6299775,Negative Impact
23/12/2020,160.25,160.51,159.21,159.26,159.26,41876000,2.13,76.34428766,1.192,0,9.3404,0.9034837908,0.2283735172,0.09,260.474,12771.11035,14398.62012,6495.799805,5527.589844,3382.320068,46444.17969,17593.59961,158.7335703,141.9828521,158.4554036,143.4500948,158.9437996,162.8390701,155.0485291,49.77793292,0.5514347901,0.2944637524,0.2569710377,2.887248448,162.0833791,9820146000,58.97002975,66.33976311,23.30999947,Economic Predictions: Will 2021 be a Boom or a Bust?,Common Wall Street belief is that the vaccine will lead to an economic recovery by next summer and there will be a boom. But there are still risks that all stock investors should know heading into 2021.,https://www.zacks.com/stock/news/1201758/economic-predictions-will-2021-be-a-boom-or-a-bust,zacks.com,8,common wall street belief vaccine lead economic recovery next summer boom still risk stock investor know heading,-0.2732,-0.21856,0.29786,-0.51642,Negative Impact
24/12/2020,159.695,160.10,158.45,158.63,158.63,29038000,2.13,76.34428766,1.192,0,9.3404,0.9034837908,0.2283735172,0.09,260.474,12804.73047,14382.5,6502.100098,5522.009766,3363.113037,46973.53906,17623.90039,158.5425504,142.3568721,158.4624272,143.6011835,158.9128502,162.8075963,155.0181041,51.5939067,0.456073286,0.3267856591,0.1292876269,2.864213126,161.5768367,9791108000,52.37295812,60.48558621,21.53000069,Tech Profits: Looking Beyond the FANG Stocks,FANG stocks tend to steal all the oxygen in the room. Brian will help broaden your tech horizons and diversify your portfolio by finding under-the-radar names with tons of potential.,https://www.zacks.com/stock/news/1206626/tech-profits-looking-beyond-the-fang-stocks,zacks.com,8,fang stock tend steal oxygen room brian help broaden tech horizon diversify portfolio finding undertheradar name ton potential,-0.128,-0.1024,0.2038425,-0.3062425,Negative Impact
28/12/2020,159.7,165.20,158.63,164.20,164.20,113736000,2.13,76.34428766,1.192,0,9.3404,0.9034837908,0.2283735172,0.09,260.474,12899.41992,14405.76953,6502.100098,5588.379883,3397.284912,47353.75,17623.90039,158.4878604,142.7316121,158.6873516,143.8061269,159.1344002,163.682957,154.5858433,64.85937905,0.8199737539,0.4254232781,0.3945504758,3.193641663,153.6410065,9904844000,91.33143242,67.5581401,21.70000076,The Top Streaming Stocks to Buy in 2021,Roku and two other stocks are great long-term plays on the secular growth of streaming services.,https://www.fool.com/investing/2020/12/28/the-top-streaming-stocks-to-buy-in-2021/,fool.com,7,roku two stock great longterm play secular growth streaming service,0.8442,0.59094,0.2715925,0.3193475,Positive Impact
29/12/2020,165.497,167.53,164.06,166.10,166.10,97458000,2.13,76.34428766,1.192,0,9.3404,0.9034837908,0.2283735172,0.09,260.474,12850.21973,14397.91992,6602.700195,5611.790039,3379.035889,47613.07813,17543.40039,158.5371506,143.1398246,158.9780439,144.0279566,159.5193008,165.0117795,154.0268222,66.34808451,1.247463666,0.5898313557,0.6576323105,3.212642125,153.8721863,10002302000,89.68796992,77.79745349,23.07999992,3 Surefire Stocks to Buy if the Market Crashes,"Some stock drops are the result of a stock market selling frenzy, not any problem with the company itself.",https://www.fool.com/investing/2020/12/29/3-surefire-stocks-to-buy-if-the-market-crashes/,fool.com,7,stock drop result stock market selling frenzy problem company,-0.7269,-0.50883,0.2160836364,-0.724913636,Negative Impact
30/12/2020,167.05,167.11,164.12,164.29,164.29,64186000,2.13,76.34428766,1.192,0,9.3404,0.9034837908,0.2283735172,0.09,260.474,12870,14477.48047,6555.799805,5599.410156,3414.452881,47746.21875,17545.80078,158.6157904,143.5093271,159.1864538,144.2295938,159.6837257,165.5476769,153.8197746,72.38992925,1.423986688,0.7566624222,0.667324266,3.106712341,154.4185989,9938116000,76.67633648,85.89857961,22.77000046,3 Blue Chip Tech Stocks to Buy and Hold for 2021,"One of the best ways for longer-term investors to build a stronger portfolio is with proven, large-cap companies that provide exposure to growth industries.",https://www.zacks.com/stock/news/1237048/3-blue-chip-tech-stocks-to-buy-and-hold-for-2021,zacks.com,8,one best way longerterm investor build stronger portfolio proven largecap company provide exposure growth industry,0.8555,0.6844,0.2432282609,0.4411717391,Positive Impact
31/12/2020,163.75,164.15,162.06,162.85,162.85,59144000,2.13,76.34428766,1.192,0,9.3404,0.9034837908,0.2283735172,0.09,260.474,12888.28027,14524.7998,6460.5,5551.410156,3473.069092,47751.32813,17433.40039,158.6557104,143.8660596,159.3299849,144.4148366,159.8172256,165.847622,153.7868293,67.99656566,1.430710073,0.8914719525,0.539238121,3.030105591,154.943155,9878972000,66.26709564,77.54380068,22.75,Bitcoin's Biggest Problem: Its Value Will Never Change,Bitcoin doesn't create value for buyers. The only thing that changes is the price people are willing to pay for it.,https://investorplace.com/2020/12/bitcoins-biggest-problem-its-value-will-never-change/,investorplace.com,6,bitcoin doesnt create value buyer thing change price people willing pay,-0.5023,-0.30138,0.2796226667,-0.581002667,Negative Impact
04/01/2021,163.5,163.60,157.20,159.33,159.33,88228000,3.3,50.56966791,1.192,0,13.66057312,0.8419472675,0.2413396506,0.09,261.582,12698.4502,14376.7002,6571.899902,5588.959961,3502.958008,48176.80078,17527.80078,158.6574005,144.1924846,159.3300442,144.5632611,159.8169754,165.8474562,153.7864946,57.20500878,1.139274483,0.9410324586,0.1982420244,3.323427473,155.4467288,9790744000,26.98860124,56.64401112,26.96999931,Big Tech kicks off 2021 with a slump amid broader sell-off,"Shares of the largest technology companies dipped in the first trading day of 2021, a rough start for the sector that posted big gains in 2020.",https://www.cnbc.com/2021/01/04/big-tech-stocks-kick-off-2021-with-a-slump-amid-broader-sell-off.html,cnbc.com,9,share largest technology company dipped first trading day rough start sector posted big gain,0.6808,0.61272,0.2784711538,0.3342488462,Positive Impact
05/01/2021,158.3005,161.17,158.25,160.93,160.93,53110000,3.3,50.56966791,1.192,0,13.66057312,0.8419472675,0.2413396506,0.09,261.582,12818.95996,14536.53027,6612.299805,5564.600098,3528.677002,48437.78125,17682.5,158.6995105,144.5355896,159.3926113,144.7260695,159.9568008,165.9520686,153.9615331,56.42972247,1.025116015,0.9578491699,0.06726684538,3.267248971,155.9301597,9843854000,39.98003937,44.41191208,25.34000015,Amazon buys 11 Boeing 767-300 aircraft from Delta and WestJet to expand cargo fleet,"Amazon.com Inc. said Tuesday it is buying 11 Boeing 767-300 aircraft from Delta and WestJet, as it moves to expand its cargo fleet in 2021 and 2022. ""Having a mix of both leased and owned aircraft in our growing fleet allows us to better manage our operations, which in turn helps us to keep pace in meeting our customer promises,' said Sarah Rhoads, Vice President of Amazon Global Air.",https://www.marketwatch.com/story/amazon-buys-11-boeing-767-300-aircraft-from-delta-and-westjet-to-expand-cargo-fleet-2021-01-05,marketwatch.com,8,amazoncom inc said tuesday buying boeing aircraft delta westjet move expand cargo fleet mix leased owned aircraft growing fleet allows u better manage operation turn help u keep pace meeting customer promise said sarah rhoads vice president amazon global air,0.891,0.7128,0.1458719231,0.5669280769,Positive Impact
06/01/2021,157.324,159.88,156.56,156.92,156.92,87896000,3.3,50.56966791,1.192,0,13.66057312,0.8419472675,0.2413396506,0.09,261.582,12740.79004,14788.83984,6841.899902,5630.600098,3550.876953,48174.05859,17828.09961,158.6334906,144.8444772,159.2956072,144.8473922,159.9077515,165.9893024,153.8262005,47.57149485,0.6043865295,0.8871566418,-0.282770112,3.372035435,156.3942534,9755958000,3.289513017,23.41938454,25.06999969,The Best Way to Invest in Chinese E-Commerce Without Jack Ma,Following the enigmatic co-founder of Alibaba isn't the only way to profit from e-commerce in China.,https://www.fool.com/investing/2021/01/06/the-best-way-to-invest-in-chinese-e-commerce-witho/,fool.com,7,following enigmatic cofounder alibaba isnt way profit ecommerce china,-0.3412,-0.23884,0.2409704762,-0.479810476,Negative Impact
07/01/2021,157.85,160.43,157.75,158.11,158.11,70290000,3.3,50.56966791,1.192,0,13.66057312,0.8419472675,0.2413396506,0.09,261.582,13067.48047,14928.75,6857,5669.850098,3576.205078,48093.32031,18027.59961,158.5886105,145.1499922,159.2490345,144.9793386,159.8699265,165.988098,153.7517549,42.09597042,0.3627162031,0.7822685541,-0.419552351,3.325035095,156.5579987,9826248000,14.12367479,19.13107572,22.37000084,Elon Musk overtakes Amazon's Bezos to become world's richest person - Bloomberg News,"Tesla Inc chief and billionaire entrepreneur Elon Musk surpassed Amazon.com Inc's top boss Jeff Bezos to become the world's richest man, Bloomberg News reported on Thursday.",https://www.reuters.com/article/us-tesla-musk/elon-musk-overtakes-amazons-bezos-to-become-worlds-richest-person-bloomberg-news-idUSKBN29C25A,reuters.com,10,tesla inc chief billionaire entrepreneur elon musk surpassed amazoncom inc top bos jeff bezos become world richest man bloomberg news reported thursday,0.6369,0.6369,0.2299428571,0.4069571429,Positive Impact
08/01/2021,159,159.53,157.11,159.14,159.13,70754000,3.3,50.56966791,1.192,0,13.66057312,0.8419472675,0.2413396506,0.09,261.582,13201.98047,14966.83008,6873.299805,5706.879883,3570.110107,48782.51172,18042.09961,158.4849805,145.4742072,159.2445623,145.1201909,160.0661758,165.7943537,154.337998,44.80879474,0.2511651882,0.6760478809,-0.424882693,3.346213205,156.5579987,9897002000,23.48166429,13.63161737,21.55999947,Should Spotify Be Worried About New Podcast Competitor Amazon?,The company is reportedly buying Wondery for $300 million.,https://www.fool.com/investing/2021/01/08/should-spotify-be-worried-about-new-podcast-compet/,fool.com,7,company reportedly buying wondery million,0,0,0.34519,-0.34519,Negative Impact
11/01/2021,157.4005,157.82,155.50,155.71,155.71,73668000,3.3,50.56966791,1.192,0,13.66057312,0.8419472675,0.2413396506,0.09,261.582,13036.42969,14937.95996,6798.5,5662.430176,3531.498047,49269.32031,17934.5,158.4364102,145.7638871,159.1059714,145.2255671,160.0979759,165.7154663,154.4804855,42.02479261,-0.11227406,0.5183834927,-0.630657553,3.327927726,167.5325012,9823334000,1.749386859,13.11824198,24.07999992,"Parler is suing Amazon, alleging antitrust violations after the e-commerce giant banned the far-right social media app from AWS (AMZN)","Parler, the far-right social media service, is suing Amazon over antitrust violations, according to a court filing submitted on Monday. The move comes after Amazon knocked Parler off its cloud-hosting service after it said it failed to moderate threats of violence.",https://www.businessinsider.com/parler-sues-amazon-claiming-it-violated-antitrust-laws-2021-1,businessinsider.com,7,parler farright social medium service suing amazon antitrust violation according court filing submitted monday move come amazon knocked parler cloudhosting service said failed moderate threat violence,-0.9287,-0.65009,0.1649443478,-0.815034348,Negative Impact
12/01/2021,156,157.11,154.30,156.04,156.04,70292000,3.3,50.56966791,1.192,0,13.66057312,0.8419472675,0.2413396506,0.09,261.582,13072.42969,15010.29004,6754.100098,5650.970215,3608.340088,49517.10938,17985.80078,158.3462302,146.0690697,158.9857962,145.3331883,160.1090012,165.6919064,154.526096,42.2449979,-0.369335164,0.3408397613,-0.710174926,3.310677665,167.2918512,9893626000,13.16078667,12.79727927,23.32999992,Better Buy: Amazon vs. Netflix,It's hard to find a loser in this battle of digital titans.,https://www.fool.com/investing/2021/01/12/better-buy-amazon-vs-netflix/,fool.com,7,hard find loser battle digital titan,-0.7506,-0.52542,0.1353126667,-0.660732667,Negative Impact
13/01/2021,156.422,159.50,156.10,158.29,158.29,66424000,3.3,50.56966791,1.192,0,13.66057312,0.8419472675,0.2413396506,0.09,261.582,13128.9502,14983.61035,6745.5,5662.669922,3598.6521,49492.32031,17934.69922,158.4759702,146.3695546,158.9586864,145.4621566,160.1313011,165.6796446,154.5829576,46.58575628,-0.386801611,0.1953114868,-0.582113098,3.407819475,166.7721773,9960050000,30.18698001,15.03238451,22.20999908,Amazon says violent posts forced it to drop Parler from its web hosting service,"Amazon said it ""notified Parler repeatedly"" over the past few months that the social media app was hosting violent content in violation of its terms of service.",https://www.cnbc.com/2021/01/13/amazon-says-violent-posts-forced-it-to-drop-parler-from-its-web-hosting-service.html,cnbc.com,9,amazon said notified parler repeatedly past month social medium app hosting violent content violation term service,-0.7506,-0.67554,0.2585057143,-0.934045714,Negative Impact
14/01/2021,158.376,158.90,156.03,156.37,156.37,61418000,3.3,50.56966791,1.192,0,13.66057312,0.8419472675,0.2413396506,0.09,261.582,13112.63965,15044.37988,6802,5681.140137,3565.905029,49584.16016,17958.09961,158.5989603,146.6639922,158.8573067,145.5707272,160.0371765,165.7799363,154.2944167,45.27916626,-0.54931952,0.04638528543,-0.595704806,3.520140512,166.2732903,9898632000,15.66976666,19.67251111,23.25,Amazon faces class-action lawsuit over eBook pricing,Amazon.com Inc was slapped with a class-action lawsuit on Thursday accusing the e-commerce giant of inflating the prices of ebooks in collusion with some publishers.,https://www.reuters.com/article/us-tech-antitrust-amazon/amazon-faces-class-action-lawsuit-over-ebook-pricing-idUSKBN29K06P,reuters.com,10,amazoncom inc slapped classaction lawsuit thursday accusing ecommerce giant inflating price ebooks collusion publisher,-0.3818,-0.3818,0.09940833333,-0.481208333,Negative Impact
15/01/2021,156.151,157.13,154.76,155.21,155.21,84880000,3.3,50.56966791,1.192,0,13.66057312,0.8419472675,0.2413396506,0.09,261.582,12998.5,14894.16992,6735.700195,5611.689941,3566.37793,49034.67188,17909,158.6548001,146.9631296,158.7143729,145.6666652,159.695401,165.7399645,153.6508375,44.505617,-0.763004556,-0.115492683,-0.647511873,3.571497236,165.7943588,9813752000,6.895832012,17.5841929,24.34000015,Foreign Amazon sites named in U.S. list of notorious markets for counterfeit goods,"Amazon sites in the U.K., Germany, Spain, France and Italy were named in the U.S. government's annual ""notorious markets"" report.",https://www.cnbc.com/2021/01/15/foreign-amazon-sites-named-in-us-notorious-markets-list-for-counterfeit-goods.html,cnbc.com,9,amazon site uk germany spain france italy named u government annual notorious market report,-0.296,-0.2664,0.206373,-0.472773,Negative Impact
19/01/2021,155.35,157.25,154.80,156.04,156.04,66102000,3.3,50.56966791,1.192,0,13.66057312,0.8419472675,0.2413396506,0.09,261.582,13197.17969,14987.33984,6713,5598.609863,3566.379883,49398.28906,17957.40039,158.5344,147.2636121,158.6094168,145.7698625,159.4071007,165.5769363,153.2372651,34.54721247,-0.855874508,-0.263569048,-0.59230546,3.277533395,165.3345846,9879854000,13.13426468,11.89995445,23.23999977,Amazon Rains on Netflix's Parade in This Key Market,A new pricing tier and a smart partnership can help Amazon eat into Netflix's share.,https://www.fool.com/investing/2021/01/19/amazon-rains-on-netflix-parade-in-this-key-market/,fool.com,7,new pricing tier smart partnership help amazon eat netflixs share,0.8074,0.56518,0.1670363158,0.3981436842,Positive Impact
20/01/2021,159.0995,163.99,158.75,163.17,163.17,106196000,3.3,50.56966791,1.192,0,13.66057312,0.8419472675,0.2413396506,0.09,261.582,13457.25,15097.28027,6740.399902,5628.439941,3583.092041,49792.12109,18014.90039,158.47578,147.6028096,158.7882243,145.9429883,159.5614258,165.9528193,153.1700322,45.36703656,-0.350026655,-0.280860569,-0.069166086,3.597570147,164.8932013,9986050000,69.26207238,29.76405636,21.57999992,Amazon sues EU antitrust regulators for letting Italian case go ahead,"Amazon is suing EU antitrust regulators for allowing the Italian competition watchdog to pursue its own case against the U.S. online retail giant over the way it selects sellers, arguing that this should be wrapped into an EU investigation.",https://www.reuters.com/article/us-eu-amazon-com-antitrust/amazon-sues-eu-antitrust-regulators-for-letting-italian-case-go-ahead-idUSKBN29P2CE,reuters.com,10,amazon suing eu antitrust regulator allowing italian competition watchdog pursue case u online retail giant way selects seller arguing wrapped eu investigation,-0.5267,-0.5267,0.2696472727,-0.796347273,Negative Impact
21/01/2021,164.65,167.43,164.48,165.35,165.35,98722000,3.3,50.56966791,1.192,0,13.66057312,0.8419472675,0.2413396506,0.09,261.582,13530.91016,15019.0498,6715.399902,5590.790039,3621.263916,49624.76172,17916.19922,158.4714001,147.9301596,159.0455293,146.1360879,159.8134506,166.7067686,152.9201326,51.65131491,0.2242245131,-0.179843553,0.404068066,3.688785008,154.3000031,10084772000,84.17061479,55.52231728,21.31999969,First Eagle Global Value Team's 2020 Annual Letter,"Those who think it's possible to predict the future of economies and markets with any sort of accuracy would have a hard time explaining 2020ÃÂÃÂa year dominated by a black swan event that descended upon the world with little warning and even less indication of the breadth and depth of its impact. In December 2019, no serious economist or public health official was predicting the emergence of a novel coronavirus that would cause nearly two million deaths worldwide and provoke a deep and widespread recession.",https://www.gurufocus.com/news/1337820/first-eagle-global-value-teams-2020-annual-letter,gurufocus.com,5,think possible predict future economy market sort accuracy would hard time explaining year dominated black swan event descended upon world little warning even less indication breadth depth impact december serious economist public health official predicting emergence novel coronavirus would cause nearly two million death worldwide provoke deep widespread recession,-0.8722,-0.4361,0.1826327778,-0.618732778,Negative Impact
22/01/2021,165.2155,166.10,164.16,164.61,164.61,56438000,3.3,50.56966791,1.192,0,13.66057312,0.8419472675,0.2413396506,0.09,261.582,13543.05957,14951.83984,6695.100098,5559.569824,3606.75,48878.53906,17845.90039,158.6198901,148.2503171,159.2638025,146.3199228,160.0277252,167.2468513,152.8085991,52.819757,0.6127088114,-0.02133308,0.6340418915,3.66771371,154.5625531,10028334000,78.5487793,77.32715549,21.90999985,FUBO Stock Is a Great Bet on the Future Today,"FUBO stock is making all the right moves and executing strongly and with a correction under its belt, a longshot looks more like a sure thing The post FUBO Stock Is a Great Bet on the Future Today appeared first on InvestorPlace. More From InvestorPlace Why Everyone Is Investing in 5G All WRONG Top Stock Picker Reveals His Next 1,000% Winner It doesn't matter if you have $500 in savings or $5 million.",https://investorplace.com/2021/01/fubo-stock-is-a-great-bet-on-the-future-today/,investorplace.com,6,fubo stock making right move executing strongly correction belt longshot look like sure thing post fubo stock great bet future today appeared first investorplace investorplace everyone investing g wrong top stock picker reveals next winner doesnt matter saving million,0.9086,0.54516,0.23026,0.3149,Positive Impact
25/01/2021,166.425,168.19,162.16,164.70,164.70,74996000,3.3,50.56966791,1.192,0,13.66057312,0.8419472675,0.2413396506,0.09,261.582,13635.99023,14935.29004,6638.899902,5472.359863,3624.238037,48347.58984,17906,158.8788699,148.5630671,159.4769866,146.5028091,160.2995499,167.8013851,152.7977146,59.63114597,0.9171543218,0.1663644003,0.7507899215,3.641856602,154.8198521,10103330000,74.84971282,79.1897023,23.19000053,"Leaders of Amazon, Mastercard, and Ford Urge Biden to Be ""Climate President"" in New Letter",The corporate titans join notables from the political and entertainment spheres to push for a greener future.,https://www.fool.com/investing/2021/01/25/amazon-mastercard-and-ford-leaders-send-letter-to/,fool.com,7,corporate titan join notable political entertainment sphere push greener future,0.6124,0.42868,0.1957666667,0.2329133333,Positive Impact
26/01/2021,164.818,166.90,164.14,166.31,166.31,59104000,3.3,50.56966791,1.192,0,13.66057312,0.8419472675,0.2413396506,0.09,261.582,13626.05957,14867.37012,6654,5523.52002,3569.428955,48347.58984,17779.40039,159.0676099,148.8839096,159.7448108,146.6998608,160.6831497,168.5996404,152.766659,59.64923898,1.273382458,0.3877680118,0.8856144461,3.630463736,155.3548382,10162434000,86.4118868,79.93679297,23.02000046,Is Unionization Coming to Amazon and Google?,Technology companies have avoided (and discouraged) unionization since the days of Fairchild Semiconductor.,https://247wallst.com/technology-3/2021/01/26/is-unionization-coming-to-amazon-and-google/,247wallst.com,5,technology company avoided discouraged unionization since day fairchild semiconductor,-0.6249,-0.31245,0.1343130435,-0.446763043,Negative Impact
27/01/2021,167.0745,167.33,160.35,161.63,161.63,93204000,3.3,50.56966791,1.192,0,13.66057312,0.8419472675,0.2413396506,0.09,261.582,13270.59961,14487.73047,6567.399902,5459.620117,3573.340088,47409.92969,17424.40039,159.1899097,149.1498371,159.8187005,146.8484094,160.5546997,168.3128452,152.7965542,58.24751138,1.164832754,0.5431809602,0.6216517935,3.816498893,155.8684248,10069230000,52.74744946,71.33634969,37.20999908,Dick's: Time For A Pause,Dick's: Time For A Pause,https://seekingalpha.com/article/4401470-dicks-time-for-pause,seekingalpha.com,6,dick time pause,-0.5106,-0.30636,0.240372,-0.546732,Negative Impact
28/01/2021,161.752,165.08,161.43,161.88,161.88,62984000,3.3,50.56966791,1.192,0,13.66057312,0.8419472675,0.2413396506,0.09,261.582,13337.16016,14669.51953,6526.200195,5510.52002,3505.176025,46874.35938,17657.19922,159.2987195,149.3884121,159.8995748,146.9979874,160.3437492,167.6852755,153.0022229,56.83092354,1.086614718,0.6518677118,0.4347470064,3.82660675,156.361468,10132214000,54.56110873,64.57348166,30.20999908,Walmart plans big push to challenge Amazon on advertising,"Walmart Inc plans to expand its advertising business, adding space for ads at its U.S. stores and sharing its vast trove of shopper data with brands, the world's largest retailer said on Thursday, looking to challenge rival Amazon.com Inc as a media powerhouse.",https://www.reuters.com/article/us-walmart-advertising/walmart-plans-big-push-to-challenge-amazon-on-advertising-idUSKBN29X1QA,reuters.com,10,walmart inc plan expand advertising business adding space ad u store sharing vast trove shopper data brand world largest retailer said thursday looking challenge rival amazoncom inc medium powerhouse,0.6597,0.6597,0.1975375,0.4621625,Positive Impact
29/01/2021,161.5,161.85,159.23,160.31,160.31,85872000,3.3,50.56966791,1.192,0,13.66057312,0.8419472675,0.2413396506,0.09,261.582,13070.69043,14397.2002,6407.5,5399.209961,3483.069092,46285.76953,17337,159.3738596,149.6130421,159.9156698,147.1304452,160.1446243,167.2473453,153.0419033,52.08622202,0.8876278387,0.6990197372,0.1886081015,3.843142918,156.8347894,10046342000,43.25448336,50.18768051,33.09000015,Will Growing AWS Clientele Aid Amazon's (AMZN) Q4 Earnings?,"Amazon's (AMZN) fourth-quarter results are likely to reflect benefits from AWS's dominance in cloud, driven by strengthening services portfolio.",https://www.zacks.com/stock/news/1254380/will-growing-aws-clientele-aid-amazons-amzn-q4-earnings,zacks.com,8,amazon amzn fourthquarter result likely reflect benefit awss dominance cloud driven strengthening service portfolio,0.8271,0.66168,0.1754,0.48628,Positive Impact
01/02/2021,162.118,167.51,161.75,167.14,167.14,83204000,3.3,50.56966791,1.192,0,13.66057312,0.8419472675,0.2413396506,0.08,263.014,13403.38965,14596.17969,6466.399902,5461.680176,3505.283936,48600.60938,17692.5,159.5810794,149.8467146,160.1991337,147.3295851,160.3594994,168.0426833,152.6763154,68.10787402,1.266773384,0.8125704666,0.4542029178,4.098000663,157.289178,10129546000,92.43940742,63.41833317,30.23999977,Is a Surprise Coming for Amazon (AMZN) This Earnings Season?,Amazon (AMZN) is seeing favorable earnings estimate revision activity and has a positive Zacks Earnings ESP heading into earnings season.,https://www.zacks.com/stock/news/1255095/is-a-surprise-coming-for-amazon-amzn-this-earnings-season,zacks.com,8,amazon amzn seeing favorable earnings estimate revision activity positive zacks earnings esp heading earnings season,0.8126,0.65008,0.2337322727,0.4163477273,Positive Impact
02/02/2021,169,171.39,168.06,169.00,169.00,141972000,3.3,50.56966791,1.192,0,13.66057312,0.8419472675,0.2413396506,0.08,263.014,13612.78027,14768.58008,6516.700195,5563.109863,3533.685059,49797.71875,17874.5,159.8556195,150.0979646,160.5442657,147.5452111,160.8429245,169.4186088,152.2672402,69.57741725,1.697445778,0.9895455289,0.7079002491,4.200572423,157.725391,10271518000,85.64516203,73.77968427,25.55999947,"Wall St. opens higher ahead of Amazon, Alphabet earnings; stimulus in focus","Wall Street's main indexes opened higher on Tuesday, building on the previous session's momentum, as investors anticipated strong results from Amazon and Google-parent Alphabet while also looking for signs of progress on a pandemic-relief package.",https://www.reuters.com/article/us-usa-stocks/wall-st-opens-higher-ahead-of-amazon-alphabet-earnings-stimulus-in-focus-idUSKBN2A21FW,reuters.com,10,wall street main index opened higher tuesday building previous session momentum investor anticipated strong result amazon googleparent alphabet also looking sign progress pandemicrelief package,0.7783,0.7783,0.2237464179,0.5545535821,Positive Impact
03/02/2021,171.2505,171.70,165.43,165.63,165.63,141776000,3.3,50.56966791,1.192,0,13.66057312,0.8419472675,0.2413396506,0.08,263.014,13610.54004,14839.05957,6507.799805,5563.049805,3517.308105,50255.75,17915.90039,160.0511295,150.3276945,160.7435688,147.7251244,161.0779739,169.9168472,152.2391007,60.71427616,1.746411576,1.140918738,0.605492838,4.401501247,158.5450872,10129742000,64.15014978,80.74490641,22.90999985,"With Bezos out as Amazon CEO, is this the end of his ominous question-mark emails?","For staff at Amazon.com Inc, the departure of CEO Jeff Bezos may spell the end of one of the company's unusual and, for some managers, frightening practices: the ""question-mark"" email.",https://www.reuters.com/article/us-amazon-com-bezos/with-bezos-out-as-amazon-ceo-is-this-the-end-of-his-ominous-question-mark-emails-idUSKBN2A32Z8,reuters.com,10,staff amazoncom inc departure ceo jeff bezos may spell end one company unusual manager frightening practice questionmark email,-0.4939,-0.4939,0.2666308,-0.7605308,Negative Impact
04/02/2021,166.5,167.35,163.89,166.55,166.55,73414000,3.3,50.56966791,1.192,0,13.66057312,0.8419472675,0.2413396506,0.08,263.014,13777.74023,14975.42969,6503.700195,5608.540039,3501.858887,50614.28906,18042,160.2827295,150.5784146,160.9712721,147.9124366,161.5595238,170.4932595,152.625788,65.31749265,1.838543097,1.28044361,0.5580994865,4.443787711,159.59748,10203156000,69.60130706,73.13220629,21.77000046,Is It Time For The Markets To Sober Up?,"Market fundamentals and valuations have seemingly been thrown out the window, but I don???t think this market euphoria can last much longer",https://www.zacks.com/stock/news/1257785/is-it-time-for-the-markets-to-sober-up,zacks.com,8,market fundamental valuation seemingly thrown window dont think market euphoria last much longer,-0.5334,-0.42672,0.207665625,-0.634385625,Negative Impact
05/02/2021,165.95,168.85,165.14,167.61,167.61,72416000,3.3,50.56966791,1.192,0,13.66057312,0.8419472675,0.2413396506,0.08,263.014,13856.2998,15069.59961,6489.299805,5659.259766,3496.330078,50731.62891,18135.90039,160.5364896,150.8255796,161.2315163,148.1084073,162.0344986,171.2026154,152.8663818,68.7150699,1.974132438,1.419181376,0.5549510626,4.539895194,160.5656813,10275572000,75.78402215,69.84515966,20.87000084,U.S. labor board denies Amazon's request to halt Alabama union election,"The U.S. National Labor Relations Board on Friday denied Amazon.com Inc's motion to halt the union election at the company's Bessemer, Alabama warehouse and its request to review the decision to hold the election by mail.",https://www.reuters.com/article/us-amazon-com-labor/u-s-labor-board-denies-amazons-request-to-halt-alabama-union-election-idUSKBN2A51ZX,reuters.com,10,u national labor relation board friday denied amazoncom inc motion halt union election company bessemer alabama warehouse request review decision hold election mail,-0.4404,-0.4404,0.2322115789,-0.672611579,Negative Impact
08/02/2021,167.925,168.25,165.20,166.15,166.15,65148000,3.3,50.56966791,1.192,0,13.66057312,0.8419472675,0.2413396506,0.08,263.014,13987.63965,15226.61035,6523.5,5686.029785,3532.447021,51348.76953,18330.30078,160.7413696,151.0564521,161.4242805,148.2878959,162.385099,171.6223849,153.1478131,64.97629578,1.941359445,1.52361699,0.4177424554,4.582752773,161.4564266,10210424000,57.11972909,67.5016861,21.23999977,4 Stocks to Watch as Adoption of AI Looks Poised for Growth,"Artificial Intelligence looks poised to continue disrupting technology as it increases efficiency and convenience, making it prudent to look at names like Microsoft (MSFT) and Micron Technology (MU)",https://www.zacks.com/stock/news/1258932/4-stocks-to-watch-as-adoption-of-ai-looks-poised-for-growth,zacks.com,8,artificial intelligence look poised continue disrupting technology increase efficiency convenience making prudent look name like microsoft msft micron technology mu,0.886,0.7088,0.4129185714,0.2958814286,Positive Impact
09/02/2021,165.6245,166.90,164.89,165.25,165.25,44070000,3.3,50.56966791,1.192,0,13.66057312,0.8419472675,0.2413396506,0.08,263.014,14007.7002,15244.40039,6531.600098,5691.540039,3603.489014,51329.07813,18408.59961,160.8612997,151.2801471,161.5743087,148.456673,162.8620743,171.6209807,154.1031678,53.78142173,1.822003035,1.583294199,0.2387088366,4.158180237,162.2759122,10166354000,48.28626936,60.39667353,21.62999916,3 Stocks Set to Grow In Tune With Demand for Music Streaming,"Music streaming seems poised to witness further growth due to the convenience it provides, making it wise to watch out for names like Apple (AAPL), Amazon (AMZN) and Alphabet (GOOGL)",https://www.zacks.com/stock/news/1259708/3-stocks-set-to-grow-in-tune-with-demand-for-music-streaming,zacks.com,8,music streaming seems poised witness growth due convenience provides making wise watch name like apple aapl amazon amzn alphabet googl,0.872,0.6976,0.3137722222,0.3838277778,Positive Impact
10/02/2021,165.7,165.90,162.70,164.33,164.33,63032000,3.3,50.56966791,1.192,0,13.66057312,0.8419472675,0.2413396506,0.08,263.014,13972.53027,15273.90039,6524.399902,5670.799805,3655.087891,51309.39063,18457.80078,160.9525397,151.507792,161.6823356,148.6146066,163.2764488,171.440686,155.1122117,48.05665908,1.634256107,1.59348658,0.04076952676,4.082395281,171.6999969,10103322000,40.9019841,48.76932752,21.98999977,Amazon and Dutch Blitz File Joint Lawsuit against Counterfeiters,"SEATTLE--(BUSINESS WIRE)--Today, Amazon's (NASDAQ: AMZN) Counterfeit Crimes Unit filed four federal lawsuits on behalf of Dutch Blitz Acquisition Corporation (Dutch Blitz), a family-owned card game maker. The lawsuits seek recovery of the profits the owners of Dutch Blitz have lost from counterfeit versions of its card game, which was born in the Pennsylvania Dutch country. Amazon and Dutch Blitz filed four lawsuits collectively against four individuals and two entities (the ÃÂÃÂdefendantsÃÂÃÂ) for c",https://www.businesswire.com/news/home/20210210005579/en/Amazon-and-Dutch-Blitz-File-Joint-Lawsuit-against-Counterfeiters/,businesswire.com,5,seattlebusiness wiretoday amazon nasdaq amzn counterfeit crime unit filed four federal lawsuit behalf dutch blitz acquisition corporation dutch blitz familyowned card game maker lawsuit seek recovery profit owner dutch blitz lost counterfeit version card game born pennsylvania dutch country amazon dutch blitz filed four lawsuit collectively four individual two entity defendant c,-0.6369,-0.31845,0.2702377778,-0.588687778,Negative Impact
11/02/2021,164.6,164.60,162.40,163.11,163.11,46028000,3.3,50.56966791,1.192,0,13.66057312,0.8419472675,0.2413396506,0.08,263.014,14025.76953,15297.08984,6528.700195,5669.819824,3655.087891,51531.51953,18393,161.0466299,151.7448045,161.7381854,148.7588046,163.5170494,171.3395728,155.694526,47.18598984,1.371016492,1.548992563,-0.177976071,4.10093144,171.5199969,10057294000,31.10051652,40.09625666,21.25,Amazon seller blasts the company's forced arbitration policy in congressional hearing on antitrust,House Democrats identified forced arbitration clauses as one aspect harming competition in digital markets in a report last fall.,https://www.cnbc.com/2021/02/11/amazon-seller-blasts-the-companys-forced-arbitration-policy-in-congress.html,cnbc.com,9,house democrat identified forced arbitration clause one aspect harming competition digital market report last fall,-0.765,-0.6885,0.2290253846,-0.917525385,Negative Impact
12/02/2021,162.5,164.01,161.67,163.89,163.89,46706000,3.3,50.56966791,1.192,0,13.66057312,0.8419472675,0.2413396506,0.08,263.014,14095.46973,15369.59961,6589.799805,5703.669922,3655.087891,51544.30078,18460.19922,161.1042599,151.9710545,161.8223938,148.9093189,163.8926491,170.9554562,156.829842,48.51539507,1.211292296,1.481452509,-0.270160213,3.837359837,171.1553171,10104000000,37.34618876,36.44956313,19.96999931,AWS und die Bundesliga verbessern mit neuen leistungsbezogenen Statistiken fÃÂÃÂ¼r die Saison 2021 die Echtzeit-Spielanalyse,"SEATTLE, USA--(BUSINESS WIRE)--Amazon Web Services (AWS), ein Amazon.com, Inc.-Unternehmen (NASDAQ: AMZN), und die Deutsche Bundesliga, Deutschlands fÃÂÃÂ¼hrende nationale FuÃÂÃÂballliga, haben heute drei neue Bundesliga Match Facts auf Basis von AWS angekÃÂÃÂ¼ndigt, um den Fans tiefere Einblicke in das Geschehen auf dem Spielfeld zu ermÃÂÃÂ¶glichen. Die neuen Match Facts werden am 21. Spieltag am 12. Februar 2021 mit dem Spiel RB Leipzig gegen FC Augsburg eingefÃÂÃÂ¼hrt. ÃÂÃÂ Hierbei handelt es sich um folgende Analysen: ÃÂÃÂMost Pressed PlayerÃÂÃÂ, zeigt auf, wie oft ein Spieler in Ballbesitz wÃÂÃÂ¤hrend eines Spiels in eine wesentliche Drucksituation gerÃÂÃÂ¤t; ÃÂÃÂAttacking ZonesÃÂÃÂ, zeigt den Fans auf, wo ihr Lieblingsteam angreift und von welcher Seite des Spielfelds aus am wahrscheinlichsten ein Tor erzielt wird; und ÃÂÃÂAverage Positions ÃÂÃÂ TrendsÃÂÃÂ, zeigt auf, wie sich ÃÂÃÂnderungen in der taktischen Formation eines Teams auf den Ausgang eines Spiels auswirken kÃÂÃÂ¶nnen. Fans kÃÂÃÂ¶nnen hier Videos zu den einzelnen Statistiken sehen, Blogs lesen und mehr erfahren. Die Bundesliga Match Facts werden durch das Erfassen und Analysieren von Daten aus Live-VideoÃÂÃÂ¼bertragungen von Spielen generiert, die in AWS gestreamt werden. Die Fans werden diese Einblicke als Grafiken wÃÂÃÂ¤hrend der ÃÂÃÂbertragungen sowie in der offiziellen Bundesliga-App wÃÂÃÂ¤hrend der gesamten Saison 2020/2021 und auch danach sehen. Die Daten werden dann in Echtzeit als Statistiken an die Fernsehzuschauer in aller Welt zurÃÂÃÂ¼ckgespielt. Diese erweiterten Statistiken helfen den Zuschauern dabei, Dinge wie die Entscheidungsfindung auf dem Spielfeld und die Torwahrscheinlichkeit fÃÂÃÂ¼r jeden Schuss besser zu verstehen. Die drei neuen Match Facts werden das Geschehen auf dem Spielfeld noch besser in Szene setzen und den Fans, Trainern, Spielern und Kommentatoren visuelle UnterstÃÂÃÂ¼tzung bei der Analyse der Entscheidungsfindung einer Mannschaft bieten. ErlÃÂÃÂ¤uterungen zu den neuen Bundesliga Match Facts auf Basis von AWS Most Pressed Player: FuÃÂÃÂballmannschaften setzen Druck als Spieltechnik ein, sowohl offensiv als auch defensiv, um den Spielrhythmus eines Spielers zu stÃÂÃÂ¶ren. Bislang war es nicht mÃÂÃÂ¶glich, den Druck, der auf einen einzelnen Spieler ausgeÃÂÃÂ¼bt wurde, zu quantifizieren. ÃÂÃÂMost Pressed PlayerÃÂÃÂ zeigt an, wie oft ein Spieler in Ballbesitz in eine erhebliche Drucksituation gerÃÂÃÂ¤t, indem die Anzahl der beteiligten gegnerischen Spieler, deren Abstand zum Spieler sowie die Bewegungsrichtung jedes Spielers gemessen wird. Diese fortschrittliche Statistik vergleicht auÃÂÃÂerdem die Anzahl der Drucksituationen, denen ein Spieler bei Ballbesitz ausgesetzt ist, mit der durchschnittlichen Anzahl der Drucksituationen, denen seine Mannschaftskameraden ausgesetzt sind. So lÃÂÃÂ¤sst sich feststellen, welche Spieler am meisten unter Druck stehen. Attacking Zones: Wenn Teams versuchen, SchwÃÂÃÂ¤chen in der Defensive auszunutzen, sich dem gegnerischen Tor zu nÃÂÃÂ¤hern und schlieÃÂÃÂlich ein Tor zu erzielen, kÃÂÃÂ¶nnen die Fans anhand von ÃÂÃÂAttacking ZonesÃÂÃÂ sehen, wo die Teams ihre Offensive konzentrieren, um diese Torchancen zu schaffen. Dieser neue Match Fact unterteilt das letzte Drittel des Spielfelds in vier gleich groÃÂÃÂe Angriffszonen. Jedes Mal, wenn das angreifende Team eine dieser Zonen erreicht, entweder per Dribbling oder mit einem Pass, zÃÂÃÂ¤hlt der Ballbesitz-Algorithmus einen Angriff und zeigt ihn in der Grafik an. Das Ziel dieser erweiterten Statistik ist es, den Fans zu zeigen, wo ihr Lieblingsteam angreift und welche Seite des Spielfelds am wahrscheinlichsten zu einem Tor fÃÂÃÂ¼hrt. Average Positions ÃÂÃÂ Trends: Diese neue Statistik hilft Fans, Trainern und Kommentatoren beim Erkennen von Teamstrategien. Sie zeigt, wie sich die durchschnittlichen Positionen der Spieler auf dem Spielfeld wÃÂÃÂ¤hrend eines beliebigen Zeitraums im Spiel verÃÂÃÂ¤ndern. Sie baut auf einem bestehenden Match Fact, Average Positions (Mittlere Positionen) (der seit der Saison 2019ÃÂÃÂ2020 verfÃÂÃÂ¼gbar ist), auf und bietet die FlexibilitÃÂÃÂ¤t, jeden Abschnitt des Spiels zu analysieren, anstatt nur die Halbzeit oder das Ende des Spiels. Medienpartner und Kommentatoren kÃÂÃÂ¶nnen nun wÃÂÃÂ¤hlen, welche Zeitspannen analysiert werden sollen, und dann diese Abschnitte des Spiels vergleichen. Dies macht es einfacher, taktische Trends zu erkennen, z. B. ob eine Mannschaft nach einem bedeutenden Ereignis wie einem Tor, einer roten Karte oder einer Auswechslung erkennbar reagiert oder eine Phase mit erhÃÂÃÂ¶htem Druck beginnt. ÃÂÃÂJedes Bundesligaspiel generiert Daten, die zur Verbesserung des Spiels beitragen kÃÂÃÂ¶nnen und den Fans helfen, die Strategien der Teams besser zu verstehen. Wir machen enorme Fortschritte bei der Nutzung der riesigen Datenmengen in unseren Archiven und von den aktuellen Spielen unserer Liga, um neue Match Facts zu entwickeln und einzufÃÂÃÂ¼hren. Die erweiterten Statistiken, die wir mit AWS erstellen, geben den Fans ein noch umfassenderes VerstÃÂÃÂ¤ndnis dafÃÂÃÂ¼r, wie das Spiel gespielt wirdÃÂÃÂ, sagte Andreas Heyden, Executive Vice President fÃÂÃÂ¼r digitale Innovationen der DFL Deutsche FuÃÂÃÂball Liga GmbH. ÃÂÃÂGemeinsam mit AWS bieten wir eine neue Perspektive auf die Geschehnisse auf dem Spielfeld und bieten den Fans eine neue und faszinierende MÃÂÃÂ¶glichkeit, ihre Lieblingsteams zu begleiten.ÃÂÃÂ ÃÂÃÂDie Ausweitung unserer Zusammenarbeit mit der Bundesliga bedeutet, dass mehr Fans ein VerstÃÂÃÂ¤ndnis fÃÂÃÂ¼r die unglaublichen Talente auf dem Feld und die Entscheidungen der Teams bekommen. Gleichzeitig differenziert sich die Liga durch den Einsatz von fortschrittlichen Analysen, um die QualitÃÂÃÂ¤t des Spiels zu verbessernÃÂÃÂ, sagte Klaus Buerg, General Manager fÃÂÃÂ¼r AWS Deutschland, ÃÂÃÂsterreich und die Schweiz bei Amazon Web Services EMEA SARL. ÃÂÃÂIn nur einem Jahr seit der EinfÃÂÃÂ¼hrung von Match Facts haben AWS und die Bundesliga Statistiken erstellt, die den Fans auf der ganzen Welt eine vÃÂÃÂ¶llig neue Art und Weise des Spielerlebnisses bieten. Das Innovationstempo, das wir bei der EinfÃÂÃÂ¼hrung dieser fortschrittlichen Statistiken erreicht haben, wird selbst die leidenschaftlichsten Fans begeistern und den Teams helfen, ihre Strategien weiterzuentwickeln sowie einer ganz neuen Generation die Feinheiten des FuÃÂÃÂballs nÃÂÃÂ¤her zu bringen.ÃÂÃÂ Das Wachstum der erweiterten Statistiken im Sport hat zu einem besseren VerstÃÂÃÂ¤ndnis der Spielstrategien und der Leistung der Athleten gefÃÂÃÂ¼hrt. Um den Fans noch mehr Einblicke in diese erweiterten Statistiken und den damit verbundenen Spielverlauf zu geben, wird der ehemalige Bundesligaspieler Simon Rolfes sein Fachwissen ÃÂÃÂ¼ber die neuen Match Facts in einer Reihe von BlogbeitrÃÂÃÂ¤gen verÃÂÃÂ¶ffentlichen, von denen der erste jetzt verfÃÂÃÂ¼gbar ist. Diese drei neuen Match Facts gesellen sich zu Speed Alert (Schnelligkeits-Alarm), Average Positions (Mittlere Positionen) und xGoals und erhÃÂÃÂ¶hen die Gesamtzahl der fÃÂÃÂ¼r Bundesliga-Fans verfÃÂÃÂ¼gbaren Einblicke auf sechs. Informationen zu all diesen Statistiken finden Sie auf aws.amazon.com/sports/bundesliga. FuÃÂÃÂballfans kÃÂÃÂ¶nnen das aktuelle Bundesliga-Geschehen auch auf Bundesliga.com und ÃÂÃÂ¼ber die offiziellen Facebook-, Twitter- und Instagram-KanÃÂÃÂ¤le verfolgen. ÃÂÃÂber Amazon Web Services Seit fast 15 Jahren ist Amazon Web Services die umfassendste und am weitesten verbreitete Cloud-Plattform der Welt. AWS hat seine Services kontinuierlich erweitert, um nahezu jeden Cloud-Workload zu unterstÃÂÃÂ¼tzen, und verfÃÂÃÂ¼gt jetzt ÃÂÃÂ¼ber mehr als 200 voll ausgestattete Services fÃÂÃÂ¼r Computing, Speicher, Datenbanken, Networking, Analytik, maschinelles Lernen und kÃÂÃÂ¼nstliche Intelligenz (artificial intelligence, AI), Internet der Dinge (Internet of Things, IoT), mobile Technologien, Sicherheit, Hybrid, Virtual und Augmented Reality (VR und AR), Medien sowie Anwendungsentwicklung, Bereitstellung und Management in 77 VerfÃÂÃÂ¼gbarkeitszonen (Availability Zones, AZs) innerhalb von 24 geografischen Regionen, mit angekÃÂÃÂ¼ndigten PlÃÂÃÂ¤nen fÃÂÃÂ¼r 18 weitere VerfÃÂÃÂ¼gbarkeitszonen und sechs weitere AWS-Regionen in Australien, Indien, Indonesien, Japan, Spanien und der Schweiz. Millionen von Kunden ÃÂÃÂ darunter die am schnellsten wachsenden Start-ups, grÃÂÃÂ¶ÃÂÃÂten Unternehmen und fÃÂÃÂ¼hrenden RegierungsbehÃÂÃÂ¶rden ÃÂÃÂ vertrauen AWS, um ihre Infrastruktur mit Strom zu versorgen, agiler zu werden und Kosten zu senken. Mehr Informationen zu AWS erhalten Sie unter aws.amazon.com. ÃÂÃÂber Amazon Amazon orientiert sich an vier GrundsÃÂÃÂ¤tzen: Orientierung am Kunden statt an der Konkurrenz, Leidenschaft fÃÂÃÂ¼r Neuerungen, Einsatz fÃÂÃÂ¼r betriebliche Optimierung sowie langfristiges Denken. Kundenrezensionen, 1-Klick-EinkÃÂÃÂ¤ufe, persÃÂÃÂ¶nliche Empfehlungen, Prime, Versand durch Amazon, AWS, Kindle Direct Publishing, Kindle, Fire-Tablets, Fire TV, Amazon Echo und Alexa sind nur einige der von Amazon angebotenen Produkte und Dienstleistungen. FÃÂÃÂ¼r weitere Informationen besuchen Sie amazon.com/about und folgen Sie @AmazonNews. ÃÂÃÂber die Bundesliga Die Bundesliga ist die hÃÂÃÂ¶chste professionelle VerbandsfuÃÂÃÂballliga in Deutschland. Die Liga wurde 1963 gegrÃÂÃÂ¼ndet und besteht aus 18 Mannschaften, die zusammen mit der 2. Bundesliga nach einem Abstiegs- bzw. Aufstiegssystem organisiert sind. Die Spiele der Bundesliga, die der DFL (Deutsche FuÃÂÃÂball Liga) angehÃÂÃÂ¶rt, werden in ÃÂÃÂ¼ber 200 LÃÂÃÂ¤ndern im Fernsehen ÃÂÃÂ¼bertragen. Die Ausgangssprache, in der der Originaltext verÃÂÃÂ¶ffentlicht wird, ist die offizielle und autorisierte Version. ÃÂÃÂbersetzungen werden zur besseren VerstÃÂÃÂ¤ndigung mitgeliefert. Nur die Sprachversion, die im Original verÃÂÃÂ¶ffentlicht wurde, ist rechtsgÃÂÃÂ¼ltig. Gleichen Sie deshalb ÃÂÃÂbersetzungen mit der originalen Sprachversion der VerÃÂÃÂ¶ffentlichung ab.",https://www.businesswire.com/news/home/20210212005385/de/,businesswire.com,5,seattle usabusiness wireamazon web service aws ein amazoncom incunternehmen nasdaq amzn und die deutsche bundesliga deutschland fhrende nationale fuballliga haben heute drei neue bundesliga match fact auf basis von aws angekndigt um den fan tiefere einblicke da geschehen auf dem spielfeld zu ermglichen die neuen match fact werden spieltag februar mit dem spiel rb leipzig gegen fc augsburg eingefhrt hierbei handelt e sich um folgende analysen pressed player zeigt auf wie oft ein spieler ballbesitz whrend eines spiel eine wesentliche drucksituation gert attacking zone zeigt den fan auf wo ihr lieblingsteam angreift und von welcher seite de spielfelds au wahrscheinlichsten ein tor erzielt wird und average position trend zeigt auf wie sich nderungen der taktischen formation eines team auf den ausgang eines spiel auswirken knnen fan knnen hier video zu den einzelnen statistiken sehen blog lesen und mehr erfahren die bundesliga match fact werden durch da erfassen und analysieren von daten au livevideobertragungen von spielen generiert die aws gestreamt werden die fan werden diese einblicke al grafiken whrend der bertragungen sowie der offiziellen bundesligaapp whrend der gesamten saison und auch danach sehen die daten werden dann echtzeit al statistiken die fernsehzuschauer aller welt zurckgespielt diese erweiterten statistiken helfen den zuschauern dabei dinge wie die entscheidungsfindung auf dem spielfeld und die torwahrscheinlichkeit fr jeden schuss besser zu verstehen die drei neuen match fact werden da geschehen auf dem spielfeld noch besser szene setzen und den fan trainern spielern und kommentatoren visuelle untersttzung bei der analyse der entscheidungsfindung einer mannschaft bieten erluterungen zu den neuen bundesliga match fact auf basis von aws pressed player fuballmannschaften setzen druck al spieltechnik ein sowohl offensiv al auch defensiv um den spielrhythmus eines spielers zu stren bislang war e nicht mglich den druck der auf einen einzelnen spieler ausgebt wurde zu quantifizieren pressed player zeigt wie oft ein spieler ballbesitz eine erhebliche drucksituation gert indem die anzahl der beteiligten gegnerischen spieler deren abstand zum spieler sowie die bewegungsrichtung jedes spielers gemessen wird diese fortschrittliche statistik vergleicht auerdem die anzahl der drucksituationen denen ein spieler bei ballbesitz ausgesetzt ist mit der durchschnittlichen anzahl der drucksituationen denen seine mannschaftskameraden ausgesetzt sind lsst sich feststellen welche spieler meisten unter druck stehen attacking zone wenn team versuchen schwchen der defensive auszunutzen sich dem gegnerischen tor zu nhern und schlielich ein tor zu erzielen knnen die fan anhand von attacking zone sehen wo die team ihre offensive konzentrieren um diese torchancen zu schaffen dieser neue match fact unterteilt da letzte drittel de spielfelds vier gleich groe angriffszonen jedes mal wenn da angreifende team eine dieser zonen erreicht entweder per dribbling oder mit einem pas zhlt der ballbesitzalgorithmus einen angriff und zeigt ihn der grafik da ziel dieser erweiterten statistik ist e den fan zu zeigen wo ihr lieblingsteam angreift und welche seite de spielfelds wahrscheinlichsten zu einem tor fhrt average position trend diese neue statistik hilft fan trainern und kommentatoren beim erkennen von teamstrategien sie zeigt wie sich die durchschnittlichen positionen der spieler auf dem spielfeld whrend eines beliebigen zeitraums im spiel verndern sie baut auf einem bestehenden match fact average position mittlere positionen der seit der saison verfgbar ist auf und bietet die flexibilitt jeden abschnitt de spiel zu analysieren anstatt nur die halbzeit oder da ende de spiel medienpartner und kommentatoren knnen nun whlen welche zeitspannen analysiert werden sollen und dann diese abschnitte de spiel vergleichen dy macht e einfacher taktische trend zu erkennen z b ob eine mannschaft nach einem bedeutenden ereignis wie einem tor einer roten karte oder einer auswechslung erkennbar reagiert oder eine phase mit erhhtem druck beginnt jedes bundesligaspiel generiert daten die zur verbesserung de spiel beitragen knnen und den fan helfen die strategien der team besser zu verstehen wir machen enorme fortschritte bei der nutzung der riesigen datenmengen unseren archiven und von den aktuellen spielen unserer liga um neue match fact zu entwickeln und einzufhren die erweiterten statistiken die wir mit aws erstellen geben den fan ein noch umfassenderes verstndnis dafr wie da spiel gespielt wird sagte andreas heyden executive vice president fr digitale innovationen der dfl deutsche fuball liga gmbh gemeinsam mit aws bieten wir eine neue perspektive auf die geschehnisse auf dem spielfeld und bieten den fan eine neue und faszinierende mglichkeit ihre lieblingsteams zu begleiten die ausweitung unserer zusammenarbeit mit der bundesliga bedeutet das mehr fan ein verstndnis fr die unglaublichen talente auf dem feld und die entscheidungen der team bekommen gleichzeitig differenziert sich die liga durch den einsatz von fortschrittlichen analysen um die qualitt de spiel zu verbessern sagte klaus buerg general manager fr aws deutschland sterreich und die schweiz bei amazon web service emea sarl nur einem jahr seit der einfhrung von match fact haben aws und die bundesliga statistiken erstellt die den fan auf der ganzen welt eine vllig neue art und weise de spielerlebnisses bieten da innovationstempo da wir bei der einfhrung dieser fortschrittlichen statistiken erreicht haben wird selbst die leidenschaftlichsten fan begeistern und den team helfen ihre strategien weiterzuentwickeln sowie einer ganz neuen generation die feinheiten de fuballs nher zu bringen da wachstum der erweiterten statistiken im sport hat zu einem besseren verstndnis der spielstrategien und der leistung der athleten gefhrt um den fan noch mehr einblicke diese erweiterten statistiken und den damit verbundenen spielverlauf zu geben wird der ehemalige bundesligaspieler simon rolfes sein fachwissen ber die neuen match fact einer reihe von blogbeitrgen verffentlichen von denen der erste jetzt verfgbar ist diese drei neuen match fact gesellen sich zu speed alert schnelligkeitsalarm average position mittlere positionen und xgoals und erhhen die gesamtzahl der fr bundesligafans verfgbaren einblicke auf sechs informationen zu diesen statistiken finden sie auf awsamazoncomsportsbundesliga fuballfans knnen da aktuelle bundesligageschehen auch auf bundesligacom und ber die offiziellen facebook twitter und instagramkanle verfolgen ber amazon web service seit fast jahren ist amazon web service die umfassendste und weitesten verbreitete cloudplattform der welt aws hat seine service kontinuierlich erweitert um nahezu jeden cloudworkload zu untersttzen und verfgt jetzt ber mehr al voll ausgestattete service fr computing speicher datenbanken networking analytik maschinelles lernen und knstliche intelligenz artificial intelligence ai internet der dinge internet thing iot mobile technologien sicherheit hybrid virtual und augmented reality vr und ar medien sowie anwendungsentwicklung bereitstellung und management verfgbarkeitszonen availability zone az innerhalb von geografischen regionen mit angekndigten plnen fr weitere verfgbarkeitszonen und sechs weitere awsregionen australien indien indonesien japan spanien und der schweiz millionen von kunden darunter die schnellsten wachsenden startup grten unternehmen und fhrenden regierungsbehrden vertrauen aws um ihre infrastruktur mit strom zu versorgen agiler zu werden und kosten zu senken mehr informationen zu aws erhalten sie unter awsamazoncom ber amazon amazon orientiert sich vier grundstzen orientierung kunden statt der konkurrenz leidenschaft fr neuerungen einsatz fr betriebliche optimierung sowie langfristiges denken kundenrezensionen klickeinkufe persnliche empfehlungen prime versand durch amazon aws kindle direct publishing kindle firetablets fire tv amazon echo und alexa sind nur einige der von amazon angebotenen produkte und dienstleistungen fr weitere informationen besuchen sie amazoncomabout und folgen sie amazonnews ber die bundesliga die bundesliga ist die hchste professionelle verbandsfuballliga deutschland die liga wurde gegrndet und besteht au mannschaften die zusammen mit der bundesliga nach einem abstiegs bzw aufstiegssystem organisiert sind die spiele der bundesliga die der dfl deutsche fuball liga angehrt werden ber lndern im fernsehen bertragen die ausgangssprache der der originaltext verffentlicht wird ist die offizielle und autorisierte version bersetzungen werden zur besseren verstndigung mitgeliefert nur die sprachversion die im original verffentlicht wurde ist rechtsgltig gleichen sie deshalb bersetzungen mit der originalen sprachversion der verffentlichung ab,-0.9995,-0.49975,0.003336,-0.503086,Negative Impact
16/02/2021,162.7025,165.42,162.68,163.45,163.45,51494000,3.3,50.56966791,1.192,0,13.66057312,0.8419472675,0.2413396506,0.08,263.014,14047.5,15423.01953,6748.899902,5786.529785,3655.087891,52104.17188,18492.5,161.1696799,152.169792,161.8861232,149.0539774,164.3043991,170.0792578,158.5295404,44.55696467,1.037407903,1.392643588,-0.355235685,3.835859026,170.5859279,10052506000,33.83443561,34.09371363,21.45999908,New York attorney general sues Amazon over COVID-19 shortfalls,"New York Attorney General Letitia James sued Amazon.com Inc on Tuesday over its handling of worker safety issues around the COVID-19 pandemic at two warehouses, just days after the retailer filed its own lawsuit seeking to block her case.",https://www.reuters.com/article/us-amazon-com-complaint/new-york-attorney-general-sues-amazon-over-covid-19-shortfalls-idUSKBN2AH0C2,reuters.com,10,new york attorney general letitia james sued amazoncom inc tuesday handling worker safety issue around covid pandemic two warehouse day retailer filed lawsuit seeking block case,-0.25,-0.25,0.1551818182,-0.405181818,Negative Impact
17/02/2021,163.18,166.05,162.98,165.43,165.43,65950000,3.3,50.56966791,1.192,0,13.66057312,0.8419472675,0.2413396506,0.08,263.014,13965.49023,15402.58984,6710.899902,5765.839844,3655.087891,51703.82813,18374.80078,161.29159,152.425442,162.0251775,149.2169429,164.7740997,169.0521563,160.4960432,58.06747529,1.047660055,1.323646882,-0.275986826,3.557180132,170.050702,10118456000,49.745534,40.30871946,21.5,Exclusive: Big Tech's Democratic critics discuss ways to strike back with White House,Congressional Democrats have begun discussions with the White House on ways to crack down on Big Tech including making social media companies accountable for the spread of disinformation on matters such as the U.S. Capitol riot and addressing the abuse of market power to harm corporate rivals.,https://www.reuters.com/article/us-usa-tech-white-house-exclusive/exclusive-big-techs-democratic-critics-discuss-ways-to-strike-back-with-white-house-idUSKBN2AH1A4,reuters.com,10,congressional democrat begun discussion white house way crack big tech including making social medium company accountable spread disinformation matter u capitol riot addressing abuse market power harm corporate rival,-0.9042,-0.9042,0.1967031818,-1.100903182,Negative Impact
18/02/2021,164.121,166.90,163.70,166.41,166.41,60548000,3.3,50.56966791,1.192,0,13.66057312,0.8419472675,0.2413396506,0.08,263.014,13865.36035,15290.63965,6617.200195,5728.330078,3675.356934,51324.69141,18274.09961,161.45724,152.678502,162.1971901,149.388033,164.9362244,169.203911,160.6685377,59.32298015,1.121889351,1.283295376,-0.161406024,3.525285993,169.5475897,10179004000,57.59874627,47.05957196,22.48999977,Amazon Buying AMC Isn't as Crazy as You Think,The world's leading online retailer has done a lot of things that don't make sense at first glance. Let's look at the latest rumor mill chatter about Amazon eyeing the struggling multiplex operator.,https://www.fool.com/investing/2021/02/18/amazon-buying-amc-isnt-as-crazy-as-you-think/,fool.com,7,world leading online retailer done lot thing dont make sense first glance let look latest rumor mill chatter amazon eyeing struggling multiplex operator,-0.2732,-0.19124,0.3342045455,-0.525444545,Negative Impact
19/02/2021,166.4115,166.68,162.29,162.50,162.49,86104000,3.3,50.56966791,1.192,0,13.66057312,0.8419472675,0.2413396506,0.08,263.014,13874.45996,15362.69043,6624,5773.549805,3696.167969,50889.76172,18384.30078,161.54914,152.911527,162.2088687,149.5184505,164.793499,169.1919162,160.3950818,54.1005088,0.8548334814,1.197602997,-0.342769515,3.649142674,169.0746641,10092900000,8.26646351,38.53691459,22.04999924,"Despite Risks, Star Peak Energy Looks Poised to Be a Long-Term Winner","At this point, Stem's large opportunity and its impressive customer list outweigh the meaningful risks facing STPK stock. The post Despite Risks, Star Peak Energy Looks Poised to Be a Long-Term Winner appeared first on InvestorPlace.",https://investorplace.com/2021/02/despite-risks-stpk-stock-looks-poised-to-be-a-long-term-winner/,investorplace.com,6,point stem large opportunity impressive customer list outweigh meaningful risk facing stpk stock post despite risk star peak energy look poised longterm winner appeared first investorplace,0.9022,0.54132,0.1733381818,0.3679818182,Positive Impact
22/02/2021,160.4065,161.62,158.61,159.04,159.04,70314000,3.3,50.56966791,1.192,0,13.66057312,0.8419472675,0.2413396506,0.08,263.014,13533.0498,15340.46973,6612.200195,5767.439941,3642.439941,49744.32031,18416.69922,161.55259,153.118897,162.0844818,149.6131625,164.5147743,169.6126424,159.4169063,32.57834009,0.3600087245,1.030084142,-0.670075418,3.411927359,168.6301141,10022586000,3.239827952,23.03501258,23.45000076,Better Buy: Activision Blizzard vs. Amazon,Both of these tech companies posted strong growth despite the pandemic.,https://www.fool.com/investing/2021/02/22/better-buy-activision-blizzard-vs-amazon/,fool.com,7,tech company posted strong growth despite pandemic,0.7096,0.49672,0.110526,0.386194,Positive Impact
23/02/2021,156.3515,160.24,154.68,159.73,159.73,93544000,3.3,50.56966791,1.192,0,13.66057312,0.8419472675,0.2413396506,0.08,263.014,13465.2002,15359.12988,6625.899902,5779.839844,3636.360107,49751.41016,18330.09961,161.64289,153.3256195,161.9919533,149.7137778,164.2660248,169.793264,158.7387856,29.01490043,0.02310632012,0.8286885779,-0.805582258,3.505749294,167.8287455,10116130000,29.64166957,13.71598701,23.11000061,Amazon Steps Up Its Rivalry With Shopify,"Amazon stock is roughly flat so far this year, but that won't stop Jeff Bezos & Co. Amazon is making a move against competitor Shopify. The post Amazon Steps Up Its Rivalry With Shopify appeared first on InvestorPlace.",https://investorplace.com/2021/02/amazon-stock-amzn-steps-up-rivalry-with-shopify/,investorplace.com,6,amazon stock roughly flat far year wont stop jeff bezos co amazon making move competitor shopify post amazon step rivalry shopify appeared first investorplace,0.6108,0.36648,0.296176,0.070304,Positive Impact
24/02/2021,158.3375,158.56,156.27,157.98,157.98,60226000,3.3,50.56966791,1.192,0,13.66057312,0.8419472675,0.2413396506,0.08,263.014,13597.96973,15539.41992,6659,5797.97998,3564.080078,50781.69141,18484.5,161.7009302,153.5205996,161.8344846,149.795994,163.8495247,169.9545593,157.74449,31.31778289,-0.380593727,0.586832117,-0.967425843,3.304821559,166.5138702,10055904000,23.26397788,18.71515847,21.34000015,Dividend Growth Investing: Share Price Really Doesn't Matter,I recently broke my own rules and speculated on stocks that do not pay dividends.,https://seekingalpha.com/article/4408733-dividend-growth-investing-share-price-really-doesnt-matter,seekingalpha.com,6,recently broke rule speculated stock pay dividend,-0.4939,-0.29634,0.2717816667,-0.568121667,Negative Impact
25/02/2021,156.837,158.91,152.39,152.86,152.86,90676000,3.3,50.56966791,1.192,0,13.66057312,0.8419472675,0.2413396506,0.08,263.014,13119.42969,15206.66992,6652,5783.890137,3585.050049,51039.30859,18223.5,161.6416702,153.6826396,161.4824657,149.8264617,163.4109749,171.2121313,155.6098185,22.24855833,-1.100859057,0.2492938821,-1.350152939,3.523570469,165.3304824,9965228000,2.85506658,18.58690468,28.88999939,Should Amazon Buy AMC Theatres?,The potential for a takeover is adding fuel to the fire under the besieged cinema operator.,https://www.fool.com/investing/2021/02/25/should-amazon-buy-amc-theatres/,fool.com,7,potential takeover adding fuel fire besieged cinema operator,-0.34,-0.238,0.1713691667,-0.409369167,Negative Impact
26/02/2021,154.76,156.12,151.84,154.65,154.65,85518000,3.3,50.56966791,1.192,0,13.66057312,0.8419472675,0.2413396506,0.08,263.014,13192.34961,15010.46973,6483.399902,5703.220215,3509.080078,49099.98828,18060.30078,161.5776303,153.8666346,161.2143886,149.8744223,163.04925,171.7662509,154.3322492,24.48621723,-1.5099519,-0.102555274,-1.407396626,3.564461844,163.7773846,10050746000,17.12759104,14.41554517,27.95000076,Amazon Gains A Big Advantage Over Walmart,Walmart showed 69% year-on-year growth in its e-commerce segment in the recent quarter on top of 79% in the previous quarter. Walmart's growth rate far outpaces Amazon's e-commerce growth of close to 40%.,https://seekingalpha.com/article/4409400-amazon-gains-big-advantage-over-walmart,seekingalpha.com,6,walmart showed yearonyear growth ecommerce segment recent quarter top previous quarter walmarts growth rate far outpaces amazon ecommerce growth close,0.8519,0.51114,0.255527,0.255613,Positive Impact
01/03/2021,156.3945,157.48,154.90,157.31,157.31,54582000,3.3,50.56966791,1.192,0,13.66057312,0.8419472675,0.2413396506,0.07,264.877,13588.83008,15327.76953,6588.5,5792.790039,3551.399902,49849.83984,18299.59961,161.5586505,154.0611896,161.0611579,149.9483784,162.8991005,171.9131591,153.8850419,33.38346934,-1.601024614,-0.402249142,-1.198775472,3.548854283,162.1054517,10105328000,36.32263377,18.76843047,23.35000038,Lawsuit accuses Amazon of 'systemic' racism in corporate offices,"A manager at Amazon.com Inc sued the online retailer for discrimination on Monday, saying it hires Black people for lower positions and promotes them more slowly than white workers, and that she was subjected to harassment.",https://www.reuters.com/article/us-amazon-com-lawsuit-racism/lawsuit-accuses-amazon-of-systemic-racism-in-corporate-offices-idUSKCN2AT3RE,reuters.com,10,manager amazoncom inc sued online retailer discrimination monday saying hire black people lower position promotes slowly white worker subjected harassment,-0.5106,-0.5106,0.07408941176,-0.584689412,Negative Impact
02/03/2021,157.1735,158.18,154.36,154.73,154.73,51916000,3.3,50.56966791,1.192,0,13.66057312,0.8419472675,0.2413396506,0.07,264.877,13358.79004,15277.01953,6613.799805,5809.72998,3508.591064,50296.89063,18421.59961,161.4122205,154.2376096,160.81274,149.9959219,162.2782257,171.7596809,152.7967705,31.39640524,-1.859984865,-0.693796287,-1.166188578,3.678282601,160.6675894,10053412000,19.19347634,24.21456705,24.10000038,"Kohl's says it added 2 million new customers in 2020, thanks to Amazon","Kohl's said it added at least 2 million new customers last year, thanks to an unlikely friend that it has found in Amazon.",https://www.cnbc.com/2021/03/02/kohls-says-it-added-2-million-new-customers-in-2020-thanks-to-amazon.html,cnbc.com,9,kohl said added least million new customer last year thanks unlikely friend found amazon,0.7783,0.70047,0.2618969231,0.4385730769,Positive Impact
03/03/2021,154.059,155.39,149.75,150.25,150.25,79774000,3.3,50.56966791,1.192,0,13.66057312,0.8419472675,0.2413396506,0.07,264.877,12997.75,15199.19043,6675.5,5830.060059,3576.899902,51444.64844,18320.69922,161.1811404,154.3864146,160.3985149,149.99845,161.3407257,171.6917572,150.9896942,27.89033457,-2.398777374,-1.034792504,-1.36398487,3.852675302,159.4310278,9973638000,2.915452933,19.47718768,26.67000008,Parler Sues Amazon Again In Wake Of Deplatforming,The new lawsuit claims Amazon damaged its reputation and banned it because it did not want Parler to be able to provide a platform for conservative voices like Donald Trump.,https://www.forbes.com/sites/roberthart/2021/03/03/parler-sues-amazon-again-in-wake-of-deplatforming/,forbes.com,8,new lawsuit claim amazon damaged reputation banned want parler able provide platform conservative voice like donald trump,-0.5106,-0.40848,0.2040246154,-0.612504615,Negative Impact
04/03/2021,150.6,152.91,147.27,148.88,148.88,109632000,3.3,50.56966791,1.192,0,13.66057312,0.8419472675,0.2413396506,0.07,264.877,12723.46973,14959.41016,6650.899902,5830.649902,3503.48999,50846.07813,18125.69922,160.9570602,154.5242421,159.9467494,149.9873062,160.5033257,172.036782,148.9698693,27.76040646,-2.902979628,-1.408429929,-1.494549699,4.098245893,158.1759949,9864006000,8.187049946,10.09865974,28.56999969,Is Amazon a Great Dividend Stock?,The answer may shock you.,https://www.fool.com/investing/2021/03/04/is-amazon-a-great-dividend-stock/,fool.com,7,answer may shock,-0.3818,-0.26726,0.20584,-0.4731,Negative Impact
05/03/2021,150.25,150.45,144.05,150.02,150.02,107772000,3.3,50.56966791,1.192,0,13.66057312,0.8419472675,0.2413396506,0.07,264.877,12920.15039,15251.83008,6630.5,5782.649902,3501.987061,50405.32031,18381,160.75134,154.6620245,159.5575826,149.9876613,159.6769753,171.7422874,147.6116631,28.57652214,-3.173628291,-1.761469601,-1.41215869,4.387745449,156.2131857,9971778000,26.14001898,12.41417395,24.65999985,Legal Tussle With Amazon Puts Microsoft's $10B JEDI Contract In Jeopardy: Bloomberg,"Microsoft Corp (NASDAQ: MSFT) could lose the $10 billion contract to provide cloud computing services to the Pentagon, a deal the government has threatened to discard altogether after years of legal tussle, Bloomberg reports. What Happened: The U.S. Defense Department intended to reconsider the controversial procurement subject to a federal judge's decline to dismiss Amazon.Com Inc's (NASDAQ: AMZN) allegations regarding former President Donald Trump's involvement and influence in the contract.",https://www.benzinga.com/government/21/03/20032924/legal-tussle-with-amazon-puts-microsofts-10b-jedi-contract-in-jeopardy-bloomberg,benzinga.com,5,microsoft corp nasdaq msft could lose billion contract provide cloud computing service pentagon deal government threatened discard altogether year legal tussle bloomberg report happened u defense department intended reconsider controversial procurement subject federal judge decline dismiss amazoncom inc nasdaq amzn allegation regarding former president donald trump involvement influence contract,-0.7579,-0.37895,0.1703169231,-0.549266923,Negative Impact
08/03/2021,150.75,153.23,147.57,147.60,147.60,83700000,3.3,50.56966791,1.192,0,13.66057312,0.8419472675,0.2413396506,0.07,264.877,12609.16016,15288.37988,6719.100098,5902.990234,3421.409912,50441.07031,18457.80078,160.49677,154.775527,159.0885599,149.9638786,158.6764755,171.2794517,146.0734994,26.92265481,-3.542994749,-2.117774631,-1.425220118,4.596924918,153.7805492,9888078000,15.52517301,16.61741398,25.46999931,Amazon-backed Deliveroo reveals it lost $309 million in 2020 ahead of IPO,"Deliveroo, the Amazon-backed food delivery service, has revealed that it recorded a loss of ÃÂÃÂ£223.7 million ($309 million) last year in plans to IPO in London.",https://www.cnbc.com/2021/03/08/deliveroo-reveals-it-lost-309-million-in-2020-ahead-of-london-ipo.html,cnbc.com,9,deliveroo amazonbacked food delivery service revealed recorded loss million million last year plan ipo london,-0.3182,-0.28638,0.1998558333,-0.486235833,Negative Impact
09/03/2021,150.8995,154.55,150.26,153.14,153.14,80600000,3.3,50.56966791,1.192,0,13.66057312,0.8419472675,0.2413396506,0.07,264.877,13073.82031,15375.62988,6730.299805,5924.970215,3359.290039,51025.48047,18599.19922,160.37435,154.9295546,158.8553811,149.9955067,158.0262505,170.3450552,145.7074457,33.7875763,-3.349672378,-2.36415418,-0.985518198,4.874068124,144.0500031,9968678000,39.79213314,27.15244171,24.03000069,7 Tech Stocks Still Keeping an Eye on Australia,"A regulatory fight over news content in Australia could reverberate worldwide, and have a significant effect on the outlook for these seven tech stocks. The post 7 Tech Stocks Still Keeping an Eye on Australia appeared first on InvestorPlace.",https://investorplace.com/2021/03/7-tech-stocks-still-keeping-an-eye-on-australia/,investorplace.com,6,regulatory fight news content australia could reverberate worldwide significant effect outlook seven tech stock post tech stock still keeping eye australia appeared first investorplace,-0.2023,-0.12138,0.2373685714,-0.358748571,Negative Impact
10/03/2021,154.9225,155.82,151.50,152.88,152.88,60250000,3.3,50.56966791,1.192,0,13.66057312,0.8419472675,0.2413396506,0.07,264.877,13068.83008,15521.83984,6725.600098,5990.549805,3357.73999,51279.51172,18690,160.2592999,155.0847446,158.621131,150.0242281,157.4078506,169.4381533,145.377548,31.80664094,-3.180816549,-2.527486654,-0.653329895,4.953890119,144.2599631,9908428000,39.03646733,31.45125782,22.55999947,"Amazon Music Launches New Shopping Experience, Making It Easier for Fans to Find Merch from Their Favorite Artists","SEATTLE--(BUSINESS WIRE)--(NASDAQ: AMZN) Amazon Music today announced the integration of artist merchandise within its mobile app, combining the convenience customers have come to know and love from Amazon, with a new way for artists to engage with their audience and enrich the fan experience. Artist merchandise will now appear in the Amazon Music app on participating artistsÃÂÃÂ pages, side-by-side with their songs, albums, live streams, and music videos. By seamlessly tying artist merch and music together in the app, fans in the U.S. can now easily shop a genre-spanning selection of merchandise, a majority of which is available with Prime shipping for Prime members, from artists including Billie Eilish, Jack Harlow, King Princess, Lady Gaga, and Gucci Mane while listening to their favorite music, uninterrupted. To coincide with todayÃÂÃÂs announcement, Amazon Music is debuting exclusive merchandise collections from an exciting array of artists, including a new line of apparel developed by Selena Gomez to celebrate her upcoming Spanish-language EP, REVELACIÃÂÃÂN, and an exclusive collection celebrating legendary rock band, Weezer. Amazon MusicÃÂÃÂs exclusive offerings feature new merch from Gwen Stefani, Metallica, Queen Naija, Pentatonix, and Florida Georgia Line, and Queen. In addition, Wale has made Amazon Music the exclusive online retail partner for his merchandise collection. ÃÂÃÂFashion is an inseparable part of music and culture, and with the addition of merchandise to the Amazon Music app, weÃÂÃÂre making it easier for artists to connect with their fans through our app,ÃÂÃÂ said Sean McMullan, Amazon MusicÃÂÃÂs Director of Artist Product and Services. ÃÂÃÂItÃÂÃÂs long been Amazon MusicÃÂÃÂs mission to strengthen the connection between artists and fans, and todayÃÂÃÂs launch furthers that goal by uniting streaming audio, music videos, live streams, podcasts, and now merch under one roof for the first time.ÃÂÃÂ Inspired by a Mexico City mural created to commemorate her single ÃÂÃÂBaila Conmigo,ÃÂÃÂ Selena GomezÃÂÃÂs REVELACIÃÂÃÂN collection includes a variety of apparel from the pop star, including a colorful hoodie, graphic T-shirts, and a hat. On sale now, the collection is only available from Amazon. ÃÂÃÂI wanted to offer my fans something special for the release of REVELACIÃÂÃÂN,ÃÂÃÂ said Selena Gomez. ÃÂÃÂThatÃÂÃÂs why I worked to develop a beautiful, new collection of exclusive merch for Amazon Music. I hope you enjoy what IÃÂÃÂve put together.ÃÂÃÂ Weezer will also debut a new collection of merchandise for the launch of Amazon MusicÃÂÃÂs merch integration. Featuring hoodies, T-shirts, and hats adorned with WeezerÃÂÃÂs iconic ÃÂÃÂFlying WÃÂÃÂ logo, classic Blue Album colorways, and the bandÃÂÃÂs trademark earnest tribute to the undeniable power of rock music, the collection is a celebration of all-things Weezer. ÃÂÃÂSince the pandemic has temporarily eradicated the merch table, weÃÂÃÂre really excited to have developed an exclusive collection of offerings with Amazon Music to bring the merch table directly to our fans,ÃÂÃÂ says Weezer. ÃÂÃÂWe canÃÂÃÂt wait to see everyone back on the road when itÃÂÃÂs safe again to tour!ÃÂÃÂ Fans can shop the exclusive merchandise in the Amazon Music app or online or on the Amazon Music Merch Shop, a comprehensive shopping experience on Amazon.com, developed and curated by the Amazon Music team. Additional exclusive merchandise includes: Just in time for the release of her new single, ÃÂÃÂSlow Clap,ÃÂÃÂ this Friday, Gwen StefaniÃÂÃÂs new merchandise line pays tribute to the artistÃÂÃÂs extensive career, featuring hoodies and T-shirts that juxtapose StefaniÃÂÃÂs iconic, SoCal ska-inspired look from the ÃÂÃÂJust A GirlÃÂÃÂ music video with her new look introduced in her recent single ÃÂÃÂLet Me Reintroduce Myself.ÃÂÃÂ Queen Naija is now offering Amazon Music customers a new collection of T-shirts, sweatshirts, and hoodies sporting her crown logo, as well as designs tied to her song ÃÂÃÂButterflies Pt. 2ÃÂÃÂ and her recent album Misunderstood. Pentatonix is offering an exclusive collection of merch celebrating the groupÃÂÃÂs newest album The Lucky Ones. The selection includes a coffee mug themed to the bandÃÂÃÂs single ÃÂÃÂCoffee in Bed,ÃÂÃÂ a ÃÂÃÂHappy NowÃÂÃÂ sweatshirt to commemorate the albumÃÂÃÂs opening track, and a notebook themed to the groupÃÂÃÂs song, ÃÂÃÂA Little Space.ÃÂÃÂ Metallica is offering a set of exclusive throwback T-shirts. Amazon Music is the exclusive online retail partner for Wale, offering a selection of the rapperÃÂÃÂs merchandise, including hoodies, T-shirts, and more tied to his most recent album, Wow... That's Crazy. Florida Georgia Line has also developed exclusive merch for Amazon Music. Featuring T-shirts, phone cases, totes, and more, the new collection pays tribute to the groupÃÂÃÂs love of fishing, Florida, and the great outdoors. Queen is offering a merchandise collection that features designs inspired by the ÃÂÃÂQueen Crest,ÃÂÃÂ which Freddie Mercury originally designed in 1973 for the bandÃÂÃÂs debut album. About Amazon Music Amazon Music reimagines music listening by enabling customers to unlock millions of songs and thousands of curated playlists and stations with their voice. Amazon Music provides unlimited access to new releases and classic hits across iOS and Android mobile devices, PC, Mac, Echo, and Alexa-enabled devices including Fire TV and more. With Amazon Music, Prime members have access to ad-free listening of 2 million songs at no additional cost to their membership. Listeners can also enjoy the premium subscription service, Amazon Music Unlimited, which provides access to more than 70 million songs and the latest new releases. And with Amazon Music HD, customers have access to the highest-quality listening experience available, with more than 70 million songs available in High Definition (HD), millions of songs in Ultra HD, and a growing catalog of 3D Audio. Customers also have free access to an ad-supported selection of top playlists and stations on Amazon Music. All Amazon Music tiers now offer a wide selection of podcasts at no additional cost, and live streaming in partnership with Twitch. Engaging with music and culture has never been more natural, simple, and fun. For more information, visit amazonmusic.com or download the Amazon Music app. About Amazon Amazon is guided by four principles: customer obsession rather than competitor focus, passion for invention, commitment to operational excellence, and long-term thinking. Customer reviews, 1-Click shopping, personalized recommendations, Prime, Fulfillment by Amazon, AWS, Kindle Direct Publishing, Kindle, Fire tablets, Fire TV, Amazon Echo, and Alexa are some of the products and services pioneered by Amazon. For more information, visit amazon.com/about and follow @AmazonNews.",https://www.businesswire.com/news/home/20210310005579/en/Amazon-Music-Launches-New-Shopping-Experience-Making-It-Easier-for-Fans-to-Find-Merch-from-Their-Favorite-Artists,businesswire.com,5,seattlebusiness wirenasdaq amzn amazon music today announced integration artist merchandise within mobile app combining convenience customer come know love amazon new way artist engage audience enrich fan experience artist merchandise appear amazon music app participating artist page sidebyside song album live stream music video seamlessly tying artist merch music together app fan u easily shop genrespanning selection merchandise majority available prime shipping prime member artist including billie eilish jack harlow king princess lady gaga gucci mane listening favorite music uninterrupted coincide today announcement amazon music debuting exclusive merchandise collection exciting array artist including new line apparel developed selena gomez celebrate upcoming spanishlanguage ep revelacin exclusive collection celebrating legendary rock band weezer amazon music exclusive offering feature new merch gwen stefani metallica queen naija pentatonix florida georgia line queen addition wale made amazon music exclusive online retail partner merchandise collection fashion inseparable part music culture addition merchandise amazon music app making easier artist connect fan app said sean mcmullan amazon music director artist product service long amazon music mission strengthen connection artist fan today launch furthers goal uniting streaming audio music video live stream podcasts merch one roof first time inspired mexico city mural created commemorate single baila conmigo selena gomezs revelacin collection includes variety apparel pop star including colorful hoodie graphic tshirts hat sale collection available amazon wanted offer fan something special release revelacin said selena gomez thats worked develop beautiful new collection exclusive merch amazon music hope enjoy ive put together weezer also debut new collection merchandise launch amazon music merch integration featuring hoodies tshirts hat adorned weezers iconic flying w logo classic blue album colorways band trademark earnest tribute undeniable power rock music collection celebration allthings weezer since pandemic temporarily eradicated merch table really excited developed exclusive collection offering amazon music bring merch table directly fan say weezer cant wait see everyone back road safe tour fan shop exclusive merchandise amazon music app online amazon music merch shop comprehensive shopping experience amazoncom developed curated amazon music team additional exclusive merchandise includes time release new single slow clap friday gwen stefanis new merchandise line pay tribute artist extensive career featuring hoodies tshirts juxtapose stefanis iconic socal skainspired look girl music video new look introduced recent single let reintroduce queen naija offering amazon music customer new collection tshirts sweatshirt hoodies sporting crown logo well design tied song butterfly pt recent album misunderstood pentatonix offering exclusive collection merch celebrating group newest album lucky one selection includes coffee mug themed band single coffee bed happy sweatshirt commemorate album opening track notebook themed group song little space metallica offering set exclusive throwback tshirts amazon music exclusive online retail partner wale offering selection rapper merchandise including hoodies tshirts tied recent album wow thats crazy florida georgia line also developed exclusive merch amazon music featuring tshirts phone case tote new collection pay tribute group love fishing florida great outdoors queen offering merchandise collection feature design inspired queen crest freddie mercury originally designed band debut album amazon music amazon music reimagines music listening enabling customer unlock million song thousand curated playlist station voice amazon music provides unlimited access new release classic hit across io android mobile device pc mac echo alexaenabled device including fire tv amazon music prime member access adfree listening million song additional cost membership listener also enjoy premium subscription service amazon music unlimited provides access million song latest new release amazon music hd customer access highestquality listening experience available million song available high definition hd million song ultra hd growing catalog audio customer also free access adsupported selection top playlist station amazon music amazon music tier offer wide selection podcasts additional cost live streaming partnership twitch engaging music culture never natural simple fun information visit amazonmusiccom download amazon music app amazon amazon guided four principle customer obsession rather competitor focus passion invention commitment operational excellence longterm thinking customer review click shopping personalized recommendation prime fulfillment amazon aws kindle direct publishing kindle fire tablet fire tv amazon echo alexa product service pioneered amazon information visit amazoncomabout follow amazonnews,0.9992,0.4996,0.2240258333,0.2755741667,Positive Impact
11/03/2021,155.2005,156.59,154.15,155.68,155.68,55528000,3.3,50.56966791,1.192,0,13.66057312,0.8419472675,0.2413396506,0.07,264.877,13398.66992,15648,6737,6033.759766,3436.830078,51279.51172,18844.59961,160.0889301,155.2576771,158.5057731,150.0804995,156.9753761,168.5721373,145.378615,40.55071002,-2.789111033,-2.57981153,-0.209299503,4.905283247,144.7224845,9963956000,66.20462906,48.34440984,21.90999985,Better Buy: Amazon vs. Disney,"When two industry leaders go head-to-head, resiliency in business is almost always the differentiating factor.",https://www.fool.com/investing/2021/03/11/better-buy-amazon-vs-disney/,fool.com,7,two industry leader go headtohead resiliency business almost always differentiating factor,0,0,0.2516133333,-0.251613333,Negative Impact
12/03/2021,153.75,154.95,152.28,154.47,154.47,48438000,3.3,50.56966791,1.192,0,13.66057312,0.8419472675,0.2413396506,0.07,264.877,13319.86035,15715.20996,6761.5,6046.549805,3453.080078,50792.07813,18851.30078,159.85642,155.4274521,158.3476841,150.1242209,156.5437759,167.8177904,145.2697614,43.25283892,-2.546560008,-2.573161225,0.02660121785,4.871177673,145.4344757,9915518000,64.40245928,56.54785189,20.69000053,"Coupang Is the Amazon.com of South Korea, but Maybe Even Better","Its IPO had a spectacular debt on the U.S. market, and the stock is not cheap",https://www.barrons.com/articles/coupang-is-the-amazon-com-of-south-korea-but-maybe-even-better-51615590150,barrons.com,9,ipo spectacular debt u market stock cheap,-0.3612,-0.32508,0.231464,-0.556544,Negative Impact
15/03/2021,153.7285,154.11,151.60,154.08,154.08,58272000,3.3,50.56966791,1.192,0,13.66057312,0.8419472675,0.2413396506,0.07,264.877,13459.70996,15775.5,6749.700195,6035.970215,3419.949951,50395.07813,18954.80078,159.6522501,155.5975971,158.1804808,150.1636217,156.053701,166.8248839,145.2825181,41.58385728,-2.358657757,-2.530260532,0.1716027748,4.679284232,146.1037474,9857246000,67.50994034,66.03900956,20.03000069,DigitalOcean emphasizes simplicity in IPO filing as it prepares to battle cloud giants like Amazon,"Cloud provider DigitalOcean faces deep-pocketed competitors like Amazon, Microsoft and Google, but it has a sweet spot: Simplicity for smaller businesses.",https://www.cnbc.com/2021/03/15/digitalocean-ipo-filing-plays-up-ease-of-use-vs-amazon-microsoft.html,cnbc.com,9,cloud provider digitalocean face deeppocketed competitor like amazon microsoft google sweet spot simplicity smaller business,0.7351,0.66159,0.1992376923,0.4623523077,Positive Impact
16/03/2021,155.2485,156.45,153.79,154.59,154.59,50776000,3.3,50.56966791,1.192,0,13.66057312,0.8419472675,0.2413396506,0.07,264.877,13471.57031,15669.2998,6803.600098,6055.430176,3446.73291,50363.96094,18874,159.4871802,155.7599696,158.0397953,150.2076951,155.6109764,165.8155437,145.4064091,44.75808682,-2.1439574,-2.452999906,0.309042505,4.621890477,146.7328628,9908022000,70.93457186,67.61565716,19.79000092,"Rhode Island Man Sentenced to 30 Months on Multiple Fraud Charges, Including Amazon Return Scheme","SEATTLE--(BUSINESS WIRE)--Amazon.com, Inc. (NASDAQ: AMZN): What: On Friday, March 12, The U.S. District Court of Rhode Island sentenced Michael Chaves to 30 months in federal prison for operating a fraudulent product return scheme and defrauding Amazon of more than $50,000, as well as other charges including bank fraud, wire fraud, falsification of records, aggravated identity theft, and tax evasion. Amazon supported the investigation, prosecution, and sentencing. You can see the press release issued by the US Attorney here, and the press release following his arrest in June 2020 here. Statement from Amazon: We work hard to build a great shopping experience and that includes a seamless, customer-friendly returns policy. Mr. Chaves abused our policy, and we took action to protect our selling partners, our store, and the experience for all customers. We are grateful to the United States AttorneyÃÂÃÂs Office for the District of Rhode Island in their thorough pursuit of this case. Amazon has teams and systems in place to proactively detect, investigate, and stop suspicious behavior and prohibited activity. Amazon has an extensive history of protecting its customers from fraud and abuse: https://press.aboutamazon.com/news-releases/news-release-details/amazon-supports-investigation-and-prosecution-four-new-york https://press.aboutamazon.com/news-releases/news-release-details/amazon-establishes-counterfeit-crimes-unit-bring-counterfeiters https://press.aboutamazon.com/news-releases/news-release-details/amazon-stops-multiple-fraudulent-affiliate-marketing-schemes",https://www.businesswire.com/news/home/20210316006003/en/Rhode-Island-Man-Sentenced-to-30-Months-on-Multiple-Fraud-Charges-Including-Amazon-Return-Scheme,businesswire.com,5,seattlebusiness wireamazoncom inc nasdaq amzn friday march u district court rhode island sentenced michael chaves month federal prison operating fraudulent product return scheme defrauding amazon well charge including bank fraud wire fraud falsification record aggravated identity theft tax evasion amazon supported investigation prosecution sentencing see press release issued u attorney press release following arrest june statement amazon work hard build great shopping experience includes seamless customerfriendly return policy mr chaves abused policy took action protect selling partner store experience customer grateful united state attorney office district rhode island thorough pursuit case amazon team system place proactively detect investigate stop suspicious behavior prohibited activity amazon extensive history protecting customer fraud abuse,-0.9601,-0.48005,0.1926492857,-0.672699286,Negative Impact
17/03/2021,153.661,158.65,153.51,156.79,156.79,62372000,3.3,50.56966791,1.192,0,13.66057312,0.8419472675,0.2413396506,0.07,264.877,13525.2002,15731.15039,6762.700195,6054.819824,3445.551025,49801.62109,18983.09961,159.4362802,155.9261421,157.9906465,150.2731559,155.178701,164.3073101,146.0500919,56.69283929,-1.776332513,-2.317666427,0.5413339137,4.523069109,147.3242313,9970394000,87.22137872,75.22196364,19.22999954,Lordstown To Report For First Time Amid Short-Seller Battle,Lordstown reports for the first time as a public company after a short seller accused the electric truck startup of fake orders. The post Lordstown To Report For First Time Amid Short-Seller Battle appeared first on Investor's Business Daily.,https://www.investors.com/news/ride-stock-lordstown-earnings-q4-2020-short-seller-battle/,investors.com,5,lordstown report first time public company short seller accused electric truck startup fake order post lordstown report first time amid shortseller battle appeared first investor business daily,-0.7845,-0.39225,0.369612,-0.761862,Negative Impact
18/03/2021,155.05,155.83,151.25,151.40,151.40,72992000,3.3,50.56966791,1.192,0,13.66057312,0.8419472675,0.2413396506,0.07,264.877,13116.16992,15589.08984,6779.700195,6062.790039,3463.068115,49216.51953,18836.5,159.2457602,156.0650371,157.7321704,150.2843633,154.4281013,162.0045637,146.851639,45.072399,-1.897795879,-2.233692318,0.3358964382,4.612319946,148.2304925,9897402000,50.33046357,69.49547138,21.57999992,FTC Obtains Permanent Ban and $2M Judgment for Work-From-Home Scammer Falsely Using Amazon Name,"SEATTLE--(BUSINESS WIRE)--Amazon.com, Inc. (NASDAQ: AMZN): What: On Friday, March 12, the U.S. District Court of Utah entered the Federal Trade CommissionÃÂÃÂs filed order against Randon Morris and four companies he controls for operating a telemarketing scheme that fraudulently used Amazon Associates name. The defendants leveraged pandemic fears to offer fake work-from-home opportunities, falsely representing AmazonÃÂÃÂs Associates Program. The defendants are prevented from ever selling similar services in the future and will be responsible for a more than $2 million settlement. You can read the FTCÃÂÃÂs press release on the case here. Statement from Amazon: Amazon works hard to delight our customers, and we appreciate the Federal Trade CommissionÃÂÃÂs thorough pursuit of these criminals who deceptively used our name to dupe customers. We will continue to work with the Federal Trade Commission and other law enforcement organizations to stop these scams and protect customers. Amazon has an extensive history of protecting its customers from fraud and abuse: https://press.aboutamazon.com/news-releases/news-release-details/rhode-island-man-sentenced-30-months-multiple-fraud-charges https://press.aboutamazon.com/news-releases/news-release-details/amazon-stops-multiple-fraudulent-affiliate-marketing-schemes https://press.aboutamazon.com/news-releases/news-release-details/amazon-supports-investigation-and-prosecution-four-new-york https://press.aboutamazon.com/news-releases/news-release-details/amazon-establishes-counterfeit-crimes-unit-bring-counterfeiters",https://www.businesswire.com/news/home/20210318006017/en/FTC-Obtains-Permanent-Ban-and-2M-Judgment-for-Work-From-Home-Scammer-Falsely-Using-Amazon-Name,businesswire.com,5,seattlebusiness wireamazoncom inc nasdaq amzn friday march u district court utah entered federal trade commission filed order randon morris four company control operating telemarketing scheme fraudulently used amazon associate name defendant leveraged pandemic fear offer fake workfromhome opportunity falsely representing amazon associate program defendant prevented ever selling similar service future responsible million settlement read ftc press release case statement amazon amazon work hard delight customer appreciate federal trade commission thorough pursuit criminal deceptively used name dupe customer continue work federal trade commission law enforcement organization stop scam protect customer amazon extensive history protecting customer fraud abuse,-0.8225,-0.41125,0.17526,-0.58651,Negative Impact
19/03/2021,151.4615,153.86,150.83,153.75,153.75,92508000,3.3,50.56966791,1.192,0,13.66057312,0.8419472675,0.2413396506,0.07,264.877,13215.24023,15562.25977,6708.700195,5997.959961,3404.659912,49858.23828,18854,159.1823401,156.2141771,157.5759284,150.3188274,153.9907516,160.5477965,147.4337068,44.5472555,-1.783987813,-2.143751417,0.359763604,4.626713344,149.0642528,9989910000,66.41330256,67.98838161,20.95000076,WhatsApp hires Amazon Pay's Mahatme to lead India payments: sources,"WhatsApp has hired a top Amazon executive to head its payments business in India, two sources told Reuters, as the messenger service gears up to expand in the booming sector.",https://www.reuters.com/article/us-whatsapp-india/whatsapp-hires-amazon-pays-mahatme-to-lead-india-payments-sources-idUSKBN2BB0UD,reuters.com,10,whatsapp hired top amazon executive head payment business india two source told reuters messenger service gear expand booming sector,0.5859,0.5859,0.221645625,0.364254375,Positive Impact
22/03/2021,153.3925,156.33,153.00,155.54,155.54,58044000,3.3,50.56966791,1.192,0,13.66057312,0.8419472675,0.2413396506,0.07,264.877,13377.54004,15551.55957,6726.100098,5968.47998,3443.439941,49771.28906,18815.09961,159.1310501,156.3767447,157.4962255,150.3708142,153.8160767,159.9815431,147.6506102,51.28257704,-1.531260697,-2.021253273,0.4899925754,4.591463361,149.8313123,10047954000,78.70915967,65.15097526,18.87999916,Amazon workers go on strike in Italy over labor conditions,"Amazon workers and three trade unions in Italy are calling on the company to make changes to employee workloads, shifts and benefits.",https://www.cnbc.com/2021/03/22/amazon-workers-go-on-strike-in-italy-over-labor-conditions-.html,cnbc.com,9,amazon worker three trade union italy calling company make change employee workload shift benefit,0.5719,0.51471,0.194135,0.320575,Positive Impact
23/03/2021,156.35,159.10,156.04,156.88,156.88,76346000,3.3,50.56966791,1.192,0,13.66057312,0.8419472675,0.2413396506,0.07,264.877,13227.7002,15346.53027,6699.200195,5945.299805,3411.51001,50051.44141,18669.80078,159.0858502,156.5403696,157.4718637,150.4355325,153.6735764,159.3785525,147.9686002,61.53980683,-1.209588558,-1.85892033,0.6493317717,4.442713056,150.537007,10124300000,85.21590929,76.77945717,20.29999924,"Cramer says Costco, Amazon, Shopify and Walmart could trade higher on an 'Easter rally'","""If you're worried about the rotation, you might want to use the rally in the essential retailers to ring the register,"" ""Mad Money"" host Jim Cramer said.",https://www.cnbc.com/2021/03/23/cramer-says-easter-rally-could-mean-upside-in-these-retail-stocks.html,cnbc.com,9,youre worried rotation might want use rally essential retailer ring register mad money host jim cramer said,-0.6249,-0.56241,0.1792683333,-0.741678333,Negative Impact
24/03/2021,157.552,158.02,154.26,154.35,154.35,59180000,3.3,50.56966791,1.192,0,13.66057312,0.8419472675,0.2413396506,0.07,264.877,12961.88965,15276.55957,6712.899902,5947.290039,3367.060059,49180.30859,18628.30078,159.0587103,156.6811221,157.3495749,150.4745172,153.4924263,158.8410691,148.1437835,59.16933459,-1.144927012,-1.716121666,0.5711946545,4.308641706,151.3933069,10065120000,68.46176229,77.46227708,21.20000076,Amazon Vs. Alibaba: Comparing The Risks,The potential return is largely beyond our control. But the risk that we take can be assessed and compared more or less objectively. Amazon's higher average return comes with relatively low risk.,https://seekingalpha.com/article/4415811-amazon-vs-alibaba-which-is-riskier,seekingalpha.com,6,potential return largely beyond control risk take assessed compared less objectively amazon higher average return come relatively low risk,-0.5965,-0.3579,0.1357563636,-0.493656364,Negative Impact
25/03/2021,153.6495,155.49,151.86,152.31,152.31,71270000,3.3,50.56966791,1.192,0,13.66057312,0.8419472675,0.2413396506,0.07,264.877,12977.67969,15410.37012,6674.799805,5952.410156,3363.590088,48440.12109,18651.09961,158.9841403,156.7924722,157.1520623,150.4928106,153.4651764,158.8329476,148.0974052,53.72347288,-1.24399333,-1.621695999,0.3777026687,4.110928127,159.1000061,9993850000,41.1591097,64.94559376,19.80999947,The Margin: Amazon claps back at congressman who says its workers pee in bottles,"The retail giant has fielded criticism on Twitter as Bernie Sanders, Mark Pocan back Alabama workers voting to unionize",https://www.marketwatch.com/story/amazon-claps-back-at-congressman-who-says-its-workers-pee-in-bottles-11616690129,marketwatch.com,8,retail giant fielded criticism twitter bernie sander mark pocan back alabama worker voting unionize,-0.4404,-0.35232,0.1106164706,-0.462936471,Negative Impact
26/03/2021,152.203,152.83,149.80,152.60,152.60,66258000,3.3,50.56966791,1.192,0,13.66057312,0.8419472675,0.2413396506,0.07,264.877,13138.73047,15682.54004,6740.600098,5988.810059,3418.326904,49008.5,18752.59961,158.8702805,156.8936172,156.9736089,150.5137926,153.3629265,158.713832,148.0120209,58.74397279,-1.28441875,-1.554240549,0.269821799,3.922998701,158.9551459,10060108000,30.12362897,46.58150032,18.86000061,Amazon's social media team bares its teeth in Washington,Amazon.com's social media team bared its teeth this week to go after two big critics in Congress: Senators Bernie Sanders and Elizabeth Warren.,https://www.reuters.com/article/us-tech-usa-amazon/amazons-social-media-team-bares-its-teeth-in-washington-idUSKBN2BI36K,reuters.com,10,amazoncoms social medium team bared teeth week go two big critic congress senator bernie sander elizabeth warren,-0.2732,-0.2732,0.09942666667,-0.372626667,Negative Impact
29/03/2021,152.772,154.56,151.42,153.79,153.79,54920000,3.3,50.56966791,1.192,0,13.66057312,0.8419472675,0.2413396506,0.07,264.877,13059.65039,15611.87988,6736.200195,6015.509766,3435.300049,49008.5,18719.19922,158.8185403,157.0230597,156.8486242,150.5463569,153.1869011,158.2132914,148.1605108,51.32761123,-1.206924117,-1.484777263,0.2778531455,3.650820051,158.5889402,10115028000,42.86553402,38.04942423,20.73999977,Amazon's aggressive PR campaign ahead of union vote shows how worried it is,Amazon has ratcheted up attacks against critics on Twitter just as workers at an Alabama warehouse are set to vote on whether to unionize.,https://www.cnbc.com/2021/03/29/amazons-pr-campaign-ahead-of-union-vote-shows-how-worried-it-is.html,cnbc.com,9,amazon ratcheted attack critic twitter worker alabama warehouse set vote whether unionize,-0.5423,-0.48807,0.05991,-0.54798,Negative Impact
30/03/2021,153.5005,153.65,151.70,152.76,152.76,46752000,3.3,50.56966791,1.192,0,13.66057312,0.8419472675,0.2413396506,0.07,264.877,13045.38965,15626.11035,6772.100098,6088.040039,3456.679932,50136.57813,18705.59961,158.7695804,157.1506271,156.6884623,150.5684279,153.0888008,158.0650059,148.1125957,49.76512963,-1.213982147,-1.43061824,0.2166360928,3.491249084,158.2373827,10068276000,31.87625618,34.95513972,19.61000061,3 Stocks to Watch Amid Rising Demand for Smart Speakers,"Smart speakers seem poised to witness growth thanks to their conveniences like providing information and entertainment, making it wise to look at names like Apple (AAPL), Amazon (AMZN) and Alphabet (GOOGL)",https://www.zacks.com/stock/news/1317739/3-stocks-to-watch-amid-rising-demand-for-smart-speakers,zacks.com,8,smart speaker seem poised witness growth thanks convenience like providing information entertainment making wise look name like apple aapl amazon amzn alphabet googl,0.9628,0.77024,0.2319158824,0.5383241176,Positive Impact
31/03/2021,153.203,155.97,153.13,154.70,154.70,61878000,3.3,50.56966791,1.192,0,13.66057312,0.8419472675,0.2413396506,0.07,264.877,13246.87012,15601.74023,6713.600098,6067.22998,3441.909912,49509.14844,18700.69922,158.7429004,157.2809771,156.6106401,150.6095778,153.3115005,158.1495208,148.4734803,47.98093716,-1.050959527,-1.354686497,0.3037269705,3.455178397,157.8998875,10130154000,52.73107624,42.49095548,19.39999962,Biden singles out Amazon for not paying federal taxes,"President Joe Biden on Wednesday singled out Amazon.com Inc for not paying federal taxes during his address in Pittsburgh, Pennsylvania, as he spoke about raising the burden of taxes on multinational companies and hiking the corporate tax rate.",https://www.reuters.com/article/us-usa-biden-amazon-taxes/biden-singles-out-amazon-for-not-paying-federal-taxes-idUSKBN2BN3LL,reuters.com,10,president joe biden wednesday singled amazoncom inc paying federal tax address pittsburgh pennsylvania spoke raising burden tax multinational company hiking corporate tax rate,-0.4404,-0.4404,0.1616627273,-0.602062727,Negative Impact
01/04/2021,155.897,158.12,155.78,158.05,158.05,58806000,3.3,50.56966791,1.192,0,13.66057312,0.8419472675,0.2413396506,0.07,267.054,13480.11035,15751.7002,6737.299805,6102.959961,3466.330078,50029.82813,18990.30078,158.6405203,157.4174096,156.6670857,150.6836119,153.770076,158.5774524,148.9626996,56.79791912,-0.644340464,-1.21261729,0.5682768268,3.456141881,149.8000031,10188960000,88.70964831,57.77232691,17.32999992,Amazon has reportedly looked into opening its own discount stores for electronics and home goods,"Amazon looked into creating discount stores that could sell leftover warehouse goods that were collecting dust, Bloomberg reported on Thursday, citing two sources familiar with the matter. The sources told the news publication Amazon was investigating the idea of brick-and-mortar discount stores that could sell home goods and electronics before the pandemic started, but the internal talks were paused.",https://www.businessinsider.com/amazon-discussed-discount-electronics-home-goods-stores-report-2021-4,businessinsider.com,7,amazon looked creating discount store could sell leftover warehouse good collecting dust bloomberg reported thursday citing two source familiar matter source told news publication amazon investigating idea brickandmortar discount store could sell home good electronics pandemic started internal talk paused,0.8591,0.60137,0.1502041667,0.4511658333,Positive Impact
05/04/2021,158.65,161.80,158.06,161.34,161.34,66698000,3.3,50.56966791,1.192,0,13.66057312,0.8419472675,0.2413396506,0.07,267.054,13705.58984,15870.33984,6737.299805,6102.959961,3466.330078,49159.32031,19026.80078,158.5602603,157.5638471,156.8502001,150.7896108,154.3357513,159.8909677,148.780535,62.42101302,-0.056250501,-0.981343932,0.9250934314,3.518856594,149.9664429,10255658000,96.15350864,79.19807773,17.90999985,"Amazon stock surges toward a 6-week high, and best 3-day performance in nearly 3 months","Shares of Amazon.com Inc. surged 2.0% toward a six-week high in afternoon trading Monday, to put them on track for a third-straight gain, despite growing public criticism over the ecommerce giant's treatment of employees. The stock has rallied 5.6% over the past three days, which would mark the best three-day performance since it rose 6.5% over three-day period ending Jan. 21.",https://www.marketwatch.com/story/amazon-stock-surges-toward-a-6-week-high-and-best-3-day-performance-in-nearly-3-months-2021-04-05,marketwatch.com,8,share amazoncom inc surged toward sixweek high afternoon trading monday put track thirdstraight gain despite growing public criticism ecommerce giant treatment employee stock rallied past three day would mark best threeday performance since rose threeday period ending jan,0.8931,0.71448,-0.0875725,0.8020525,Positive Impact
06/04/2021,161.1875,162.37,160.85,161.19,161.19,50756000,3.3,50.56966791,1.192,0,13.66057312,0.8419472675,0.2413396506,0.07,267.054,13698.37988,15877.95996,6823.600098,6131.339844,3482.969971,49201.39063,19104.09961,158.4918503,157.7063071,157.0204273,150.8931072,155.0154259,160.4237676,149.6070841,61.44253303,0.3935373136,-0.706367683,1.099904997,3.43749891,150.4397053,10204902000,90.65297538,91.83871078,18.12000084,Bezos says Amazon backs increase in corporate tax rate,"Amazon Chief Executive Jeff Bezos on Tuesday said the company supports an increase in the U.S. corporate tax rate, as it backs the Biden administration's focus on improving American infrastructure. President Joe Biden has proposed tax increases on corporations as part of a $2.3 trillion infrastructure plan, including raising the corporate rate to 28% from 21%.",https://www.marketwatch.com/story/bezos-says-amazon-backs-increase-in-corporate-tax-rate-2021-04-06,marketwatch.com,8,amazon chief executive jeff bezos tuesday said company support increase u corporate tax rate back biden administration focus improving american infrastructure president joe biden proposed tax increase corporation part trillion infrastructure plan including raising corporate rate,0.8689,0.69512,0.2309923077,0.4641276923,Positive Impact
07/04/2021,161.69,165.18,161.18,163.97,163.97,66924000,3.3,50.56966791,1.192,0,13.66057312,0.8419472675,0.2413396506,0.07,267.054,13688.83984,15838.84961,6885.299805,6130.660156,3479.629883,49661.76172,19129.09961,158.4772403,157.857402,157.2929399,151.0232205,155.5567757,162.2018313,148.9117201,62.20933942,0.9630974147,-0.372474664,1.335572078,3.355820792,151.1552526,10271826000,92.12639983,92.97762795,17.15999985,Easterseals Southern California and IMDbPro Collaborate to Support and Create Visibility for Entertainment Professionals in the Disability Community,"LOS ANGELES--(BUSINESS WIRE)--Today, nonprofit disability services provider and resource Easterseals Southern California and IMDbPro, the essential resource for entertainment industry professionals, announced the latest phase of their ongoing work to support and create visibility and employment and collaboration opportunities for entertainment professionals in the disability community. This is the second consecutive year IMDbPro is sponsoring the Easterseals Disability Film Challenge. Currently underway, the weeklong filmmaking contest gives filmmakers ÃÂÃÂ with and without disabilities ÃÂÃÂ the opportunity to collaborate to tell unique stories that showcase disability in its many forms, inviting aspiring storytellers to creatively write, produce and complete short films. The challenge will be judged by a wide selection of influential voices within the entertainment industry, including IMDb Founder and CEO Col Needham. Finalists will be announced on Thursday, April 29, with the virtual Awards Ceremony set to take place on Thursday, May 6. IMDbPro provides winners with a one-year membership and the opportunity for their film to be featured in a video playlist on the homepage of IMDb, the world's most popular and authoritative source for information on movies, TV shows and celebrities. As in previous years, the winning and finalist films and creators will have the Easterseals Disability Film Challenge listed as an ÃÂÃÂAwardÃÂÃÂ on their IMDb and IMDbPro name and title pages. IMDbPro and Easterseals have hosted sessions with entertainment professionals in the disability community to be sure they are optimizing their IMDb profiles and taking advantage of all available features. For example, IMDbPro empowers entertainment industry professionals with the option to self-identify as a member of the disability community, as part of a suite of tools to manage and showcase their IMDb profile, including selecting their primary images and the credits they are best ÃÂÃÂknown for.ÃÂÃÂ Additionally, using the new IMDbPro Discover tool (currently available in beta mode), members can find other professionals to hire and collaborate with, including talent who have self-identified as a member of the disability community as well as those who were finalists and winners of the Easterseals Disability Film Challenge. IMDbPro Discover will continue to be optimized based on feedback provided by Easterseals and other professionals in the disability community. ÃÂÃÂWe are so thrilled to continue our work with the IMDbPro team,ÃÂÃÂ said Nic Novicki, founder of the Easterseals Disability Film Challenge. ÃÂÃÂIt is so important to have collaborators like IMDbPro who understand the importance of visibility for underrepresented communities and are taking the necessary steps to highlight those who have not been seen or heard as often as they should. We hope that by utilizing the new IMDbPro Discover tool and other powerful IMDbPro features, creators will be able to more authentically portray the disabled community by hiring the incredibly talented wealth of actors, writers, directors and others who know the experience firsthand.ÃÂÃÂ ÃÂÃÂBy making it easier for decision-makers to find talent from the disability community and other under-represented groups, IMDbPro provides opportunities to accelerate the entertainment industryÃÂÃÂs push for greater diversity, equity and inclusion,ÃÂÃÂ said Matt Kumin, Head of IMDbPro. ÃÂÃÂWe are pleased to continue collaborating with Easterseals Southern California and are grateful for their ongoing commitment and leadership in supporting entertainment professionals in the disability community.ÃÂÃÂ IMDbPro Discover is a new service that empowers members to find people based on a variety of key IMDb data, experience and expertise. It is an ideal information resource for decision-makers such as casting directors, producers, directors, showrunners, department heads, execs and others hiring a team or building talent and crew lists, and much more. It includes advanced features to customize, export and share your lists. IMDbPro Discover is now available in beta mode to all members at www.imdbpro.com/discover. To become an IMDbPro member today, visit www.imdbpro.com. To stay in the know on all things related to Disability Inclusion, follow: Facebook: @EastersealsSoCal @DisabilityFilmChallenge @MediaAccessAwards Twitter: @EastersealsSoCal @DisabilityChall @MediaAccess4All Instagram: @EastersealsSoCal @DisabilityFilmChallenge @MediaAccessAwards About Easterseals Southern California For more than 100 years, Easterseals has been an indispensable resource for individuals with developmental disabilities and their families. The services provided by Easterseals Southern California (ESSC) ÃÂÃÂ in Los Angeles, Orange, San Diego, Imperial, Kern, San Bernardino, Riverside and Ventura counties ÃÂÃÂ make profound and positive differences in people's lives every day, helping them address lifeÃÂÃÂs challenges and achieve personal goals so that they can live, learn, work and play in our communities. With 2,800+ employees, 60+ service sites and hundreds of community partnership locations, ESSC assists more than 14,000 people, providing adult/senior day services; autism therapy; child development/early education; employment services, veteran employment support; independent living options; and more. Join us in changing the way the world defines and views disabilities at www.easterseals.com/southerncal. About IMDbPro IMDbPro (http://www.imdbpro.com) is the essential resource for entertainment industry professionals. This membership-based service includes comprehensive information and tools that are designed to help entertainment industry professionals achieve success throughout all stages of their career. IMDbPro offers members the following: detailed contact and representation information; tools to manage and showcase their IMDb profile, including the ability to select their primary images and the credits they are best ÃÂÃÂknown forÃÂÃÂ; exclusive STARmeter rankings that are determined by page views on IMDb; the IMDbPro app for iPhone, iPad and Android; IMDbPro Track, which empowers members to receive personalized entertainment industry news and notifications on the people and film and TV projects they want to follow; a convenient tool that generates custom digital assets to promote their work on social media and other platforms; and free access to premium and secure video and voice meetings and chat messaging via Amazon Chime. Additional IMDbPro services include Box Office Mojo (http://www.boxofficemojo.com), the leading online source of box-office data. IMDbPro is a division of IMDb (www.imdb.com), the #1 movie website in the world with a combined web and mobile audience of more than 200 million monthly visitors. Follow IMDbPro on Facebook (https://www.facebook.com/imdbpro/), Instagram (https://www.instagram.com/imdbpro/) and Twitter (https://twitter.com/imdbpro).",https://www.businesswire.com/news/home/20210407005160/en/Easterseals-Southern-California-and-IMDbPro-Collaborate-to-Support-and-Create-Visibility-for-Entertainment-Professionals-in-the-Disability-Community,businesswire.com,5,los angelesbusiness wiretoday nonprofit disability service provider resource easterseals southern california imdbpro essential resource entertainment industry professional announced latest phase ongoing work support create visibility employment collaboration opportunity entertainment professional disability community second consecutive year imdbpro sponsoring easterseals disability film challenge currently underway weeklong filmmaking contest give filmmaker without disability opportunity collaborate tell unique story showcase disability many form inviting aspiring storyteller creatively write produce complete short film challenge judged wide selection influential voice within entertainment industry including imdb founder ceo col needham finalist announced thursday april virtual award ceremony set take place thursday may imdbpro provides winner oneyear membership opportunity film featured video playlist homepage imdb world popular authoritative source information movie tv show celebrity previous year winning finalist film creator easterseals disability film challenge listed award imdb imdbpro name title page imdbpro easterseals hosted session entertainment professional disability community sure optimizing imdb profile taking advantage available feature example imdbpro empowers entertainment industry professional option selfidentify member disability community part suite tool manage showcase imdb profile including selecting primary image credit best known additionally using new imdbpro discover tool currently available beta mode member find professional hire collaborate including talent selfidentified member disability community well finalist winner easterseals disability film challenge imdbpro discover continue optimized based feedback provided easterseals professional disability community thrilled continue work imdbpro team said nic novicki founder easterseals disability film challenge important collaborator like imdbpro understand importance visibility underrepresented community taking necessary step highlight seen heard often hope utilizing new imdbpro discover tool powerful imdbpro feature creator able authentically portray disabled community hiring incredibly talented wealth actor writer director others know experience firsthand making easier decisionmakers find talent disability community underrepresented group imdbpro provides opportunity accelerate entertainment industry push greater diversity equity inclusion said matt kumin head imdbpro pleased continue collaborating easterseals southern california grateful ongoing commitment leadership supporting entertainment professional disability community imdbpro discover new service empowers member find people based variety key imdb data experience expertise ideal information resource decisionmakers casting director producer director showrunners department head exec others hiring team building talent crew list much includes advanced feature customize export share list imdbpro discover available beta mode member become imdbpro member today visit stay know thing related disability inclusion follow facebook eastersealssocal disabilityfilmchallenge mediaaccessawards twitter eastersealssocal disabilitychall mediaaccessall instagram eastersealssocal disabilityfilmchallenge mediaaccessawards easterseals southern california year easterseals indispensable resource individual developmental disability family service provided easterseals southern california essc los angeles orange san diego imperial kern san bernardino riverside ventura county make profound positive difference people life every day helping address life challenge achieve personal goal live learn work play community employee service site hundred community partnership location essc assist people providing adultsenior day service autism therapy child developmentearly education employment service veteran employment support independent living option join u changing way world defines view disability imdbpro imdbpro essential resource entertainment industry professional membershipbased service includes comprehensive information tool designed help entertainment industry professional achieve success throughout stage career imdbpro offer member following detailed contact representation information tool manage showcase imdb profile including ability select primary image credit best known exclusive starmeter ranking determined page view imdb imdbpro app iphone ipad android imdbpro track empowers member receive personalized entertainment industry news notification people film tv project want follow convenient tool generates custom digital asset promote work social medium platform free access premium secure video voice meeting chat messaging via amazon chime additional imdbpro service include box office mojo leading online source boxoffice data imdbpro division imdb movie website world combined web mobile audience million monthly visitor follow imdbpro facebook instagram twitter,0.9995,0.49975,-0.026713333,0.5264633333,Positive Impact
08/04/2021,165.545,166.23,164.60,164.97,164.96,56242000,3.3,50.56966791,1.192,0,13.66057312,0.8419472675,0.2413396506,0.07,267.054,13829.30957,15886.55957,6942.200195,6165.720215,3482.550049,49746.21094,19228.90039,158.4504102,158.003772,157.5938048,151.1619446,156.1609253,163.8906343,148.4312163,77.10441303,1.47777149,-0.002425433,1.480196923,3.121464321,152.2772721,10328068000,92.32870909,91.70269477,16.95000076,AWS Announces General Availability of Amazon Lookout for Equipment,"SEATTLE--(BUSINESS WIRE)--Today, Amazon Web Services, Inc. (AWS), an Amazon.com, Inc. company (NASDAQ: AMZN), announced the general availability of Amazon Lookout for Equipment, a new service that uses AWS-developed machine learning models to help customers perform predictive maintenance on the equipment in their facilities. Amazon Lookout for Equipment ingests sensor data from a customerÃÂÃÂs industrial equipment (e.g. pressure, flow rate, RPMs, temperature, and power), and then it trains a unique machine learning model to accurately predict early warning signs of machine failure or suboptimal performance using real-time data streams from the customerÃÂÃÂs equipment. With Amazon Lookout for Equipment, customers can detect equipment abnormalities with speed and precision, quickly diagnose issues, reduce false alerts, and avoid expensive downtime by taking action before machine failures occur. There are no up-front commitments or minimum fees with Amazon Lookout for Equipment, and customers pay for the amount of data ingested, the compute hours used to train a custom model, and the number of inference-hours used. To get started with Amazon Lookout for Equipment, visit: https://aws.amazon.com/lookout-for-equipment. Industrial companies are constantly working to improve operational efficiency by avoiding unplanned downtime due to equipment failure. Over time, many of these companies have invested heavily in physical sensors, data connectivity, data storage, and dashboards to monitor their equipment health and performance. To analyze the data from their equipment, most companies typically use simple rules or modeling approaches to identify issues based on past performance. However, the rudimentary nature of these approaches often leads customers to identify issues after it is too late to take action, or receive false alarms based on misdiagnosed issues that require unnecessary and timely inspection. Instead, customers want to detect general operating conditions or failure types (e.g. high temperature due to friction) along with complex equipment failures (e.g. a failing pump indicated by high vibration and RPMs but low flow rates) that can only be derived by modeling the unique relationships between sensors. Today, advances in machine learning techniques have made it possible to quickly identify anomalies and learn the unique relationships between each piece of equipmentÃÂÃÂs historical data. However, most companies lack the expertise to build and scale custom machine learning models across their different industrial equipment. As a result, companies often fail to fully leverage their investment in sensors and data infrastructure, causing them to miss out on key actionable insights that could help them better manage their critical equipmentÃÂÃÂs health and performance. With Amazon Lookout for Equipment, industrial and manufacturing customers can now quickly and easily build a predictive maintenance solution for an entire facility or across multiple locations. To get started, customers upload their sensor data (e.g. pressure, flow rate, RPMs, temperature, and power) to Amazon Simple Storage Service (S3) and provide the relevant S3 bucket location to Amazon Lookout for Equipment. The service will automatically analyze the data, assess normal or healthy patterns, and build a machine learning model that is tailored to the customerÃÂÃÂs environment. Amazon Lookout for Equipment will then use the custom-built machine learning model to analyze incoming sensor data and identify early warning signs of machine failure or malfunction. For each alert, the service will specify which sensors are indicating an issue and measure the magnitude of its impact on the detected event. For example, if Amazon Lookout for Equipment detected an issue on a pump with 50 sensors, the service could show which five sensors indicate an issue on a specific motor, and relate that issue to the motor power current and temperature. This allows customers to identify the issue, diagnose the problem, prioritize needed actions, and perform precision maintenance before issues happenÃÂÃÂsaving them money and improving productivity by preventing down time. Amazon Lookout for Equipment allows customers to get more value from their existing sensors, and it helps them make timely decisions that can materially improve operational efficiency. Amazon Lookout for Equipment is available directly via the AWS console as well through supporting partners in the AWS Partner Network. The service is available today in US East (N. Virginia), EU (Ireland), and Asia Pacific (Seoul), with availability in additional regions in the coming months. In addition to Amazon Lookout for Equipment, AWS offers industrial and manufacturing customers the broadest range of cloud-to-edge industrial machine learning services, including Amazon Monitron (for predictive maintenance using an end-to-end solution comprised of sensors, gateways, and a machine learning service), Amazon Lookout for Vision (for visual anomaly detection using computer vision models in the cloud), and AWS Panorama (for visual inspection using an Appliance and Software Development Kit that brings computer vision models to on-premises cameras). ÃÂÃÂMany industrial and manufacturing companies have heavily invested in physical sensors and other technology with the aim of improving the maintenance of their equipment. But even with this gear in place, companies are not in a position to deploy machine learning models on top of the reams of data due to a lack of resources and the scarcity of data scientists. As a result, they miss out on critical insights and actionable findings that would help them better manage their operations,ÃÂÃÂ said Swami Sivasubramanian, VP Amazon Machine Learning, AWS. ÃÂÃÂToday, weÃÂÃÂre excited to announce the general availability of Amazon Lookout for Equipment, a new service that enables customers to benefit from custom machine learning models that are built for their specific environment to quickly and easily identify abnormal machine behaviorÃÂÃÂso that they can take action to avoid the impact and expense of equipment downtime.ÃÂÃÂ Siemens Energy offers products, solutions, and services across the entire energy value chain to support its customers on their way to a more sustainable future ÃÂÃÂ no matter how far along the journey they are. ÃÂÃÂSiemens Energy works with our customers to improve performance, reliability, and safety through our existing business lines enhanced with digital service solutions. Digitalization is a key driver for a sustainable energy future,ÃÂÃÂ said Amogh Bhonde, senior vice president digital solutions at Siemens Energy. ÃÂÃÂWith Amazon Lookout for Equipment, we see an opportunity to combine AWS machine learning with Siemens Energy subject matter expertise to give improved visibility into the systems and equipment across the entirety of a customerÃÂÃÂs operation. Amazon Lookout for Equipment's automated machine learning workflow makes it easy to build and deploy models across a variety of assets types with no data science knowledge required. Siemens Energy values AWS as a trusted partner accelerating our continued development of the Omnivise suite of digital solutions.ÃÂÃÂ Cepsa is a global energy and chemical company operating end-to-end in every stage of the oil and gas value chain. Cepsa also manufactures products from raw materials of plant origin and is driving a new strategy to become a reference in the energy transition. ""At Cepsa, digital transformation is focused on people. In that regard, our professionals are the engine behind our transformation. With Amazon Lookout for Equipment, we are bringing machine learning insights to the experts that know the equipment bestÃÂÃÂreliability and maintenance engineersÃÂÃÂallowing them to make more informed decisions to drive higher uptime and lower operational costs,ÃÂÃÂ said Alberto GascÃÂÃÂ³n, head of advanced analytics at Cepsa. ÃÂÃÂSolutions like predictive maintenance for equipment traditionally involve manual and complex data science such as choosing the right algorithms and parameters, but Amazon Lookout for Equipment automates these processes so that engineers can focus on solving the most critical challenges that impact their business."" Embassy of Things (EOT) is the creator of Twin Talk, a secure and scalable ETL++ Data Delivery System designed to tap into the unrealized value hidden within operational data from SCADA systems and historians and enable industrial operating companies to leverage the power of cloud-based data analytics, machine learning, and AI. ""Using predictive analytics and anomaly detection for not just one, but across all production sites is the key that enables our customers to achieve the highest level of production optimizations as well as cost and emission reductions. Our Twin Talk System liberates operational data to enable cloud-based, event-driven real-time architectures for Amazon Cloud Services like IoT SiteWise and S3,ÃÂÃÂ said Matt Oberdorfer, CEO of Embassy of Things. ÃÂÃÂWe are leveraging Amazon Lookout for Equipment to our suite of solutions which enables an automated machine learning process that improves the accuracy of detecting the most meaningful insights and enables insights to action faster. Lookout for Equipment is a true game-changer because it puts AI in the hands of maintenance engineers by abstracting away traditionally data-science-heavy steps being scalable effectively across assets."" RoviSys is a Global Operational Technology systems integrator, and a leading independent provider of comprehensive process automation solutions and services. ""Machine learning is one of the most promising technologies for industrial customers, and has the potential to provide major value by decreasing maintenance and operational costs,ÃÂÃÂ said Bryan DeBois, director of industrial AI at Rovisys. ÃÂÃÂRoviSys is working with AWS to integrate Amazon Lookout for Equipment with data from on-premises equipment and infrastructure using AWS IoT services, in order to enable advanced machine learning maintenance solutions at scale. This technology lets our customers leverage existing infrastructure, but unlock even more value from that data quickly and easily."" Seeq is an advanced analytics solution that enables engineers and subject matter experts in process manufacturing organizations to rapidly investigate and share insights from data in historians, IIoT platforms, AWS services, and manufacturing and business systems. ÃÂÃÂWe are pleased to be announcing our work with AWS to develop solutions that deliver diagnostic, monitoring, and predictive analytics powered by big data and machine learning innovations,ÃÂÃÂ said Megan Buntain, director of cloud partnerships at Seeq Corporation. ÃÂÃÂUsing Seeq with Amazon Lookout for Equipment will help organizations turn data into insights that deliver continuous improvement and sustainability objectives.ÃÂÃÂ TensorIoT is an AWS Advanced Consulting Partner delivering complete end-to-end products and solutions in IoT, data engineering, machine learning, and artificial intelligence. ÃÂÃÂTensorIOT builds solutions with AWS services to accelerate integration of machine learning in products and processes across industrial operations,ÃÂÃÂ said Charles Burden, vice president of consulting at TensorIoT. ÃÂÃÂLeveraging Amazon Lookout for Equipment can help reduce the heavy lift of leveraging machine learning by automatically developing, managing, and supporting the continuous improvement of anomaly detection models. This greatly reduces the number of manual touchpoints needed, and allows engineers to turn insights into operational improvements. Simply put, Lookout for Equipment allows companies to innovate faster.ÃÂÃÂ About Amazon Web Services For 15 years, Amazon Web Services has been the worldÃÂÃÂs most comprehensive and broadly adopted cloud platform. AWS has been continually expanding its services to support virtually any cloud workload, and it now has more than 200 fully featured services for compute, storage, databases, networking, analytics, machine learning and artificial intelligence (AI), Internet of Things (IoT), mobile, security, hybrid, virtual and augmented reality (VR and AR), media, and application development, deployment, and management from 80 Availability Zones (AZs) within 25 geographic regions, with announced plans for 15 more Availability Zones and five more AWS Regions in Australia, India, Indonesia, Spain, and Switzerland. Millions of customersÃÂÃÂincluding the fastest-growing startups, largest enterprises, and leading government agenciesÃÂÃÂtrust AWS to power their infrastructure, become more agile, and lower costs. To learn more about AWS, visit aws.amazon.com. About Amazon Amazon is guided by four principles: customer obsession rather than competitor focus, passion for invention, commitment to operational excellence, and long-term thinking. Customer reviews, 1-Click shopping, personalized recommendations, Prime, Fulfillment by Amazon, AWS, Kindle Direct Publishing, Kindle, Fire tablets, Fire TV, Amazon Echo, and Alexa are some of the products and services pioneered by Amazon. For more information, visit www.amazon.com/about and follow @AmazonNews.",https://www.businesswire.com/news/home/20210408005793/en/AWS-Announces-General-Availability-of-Amazon-Lookout-for-Equipment,businesswire.com,5,seattlebusiness wiretoday amazon web service inc aws amazoncom inc company nasdaq amzn announced general availability amazon lookout equipment new service us awsdeveloped machine learning model help customer perform predictive maintenance equipment facility amazon lookout equipment ingests sensor data customer industrial equipment eg pressure flow rate rpm temperature power train unique machine learning model accurately predict early warning sign machine failure suboptimal performance using realtime data stream customer equipment amazon lookout equipment customer detect equipment abnormality speed precision quickly diagnose issue reduce false alert avoid expensive downtime taking action machine failure occur upfront commitment minimum fee amazon lookout equipment customer pay amount data ingested compute hour used train custom model number inferencehours used get started amazon lookout equipment visit industrial company constantly working improve operational efficiency avoiding unplanned downtime due equipment failure time many company invested heavily physical sensor data connectivity data storage dashboard monitor equipment health performance analyze data equipment company typically use simple rule modeling approach identify issue based past performance however rudimentary nature approach often lead customer identify issue late take action receive false alarm based misdiagnosed issue require unnecessary timely inspection instead customer want detect general operating condition failure type eg high temperature due friction along complex equipment failure eg failing pump indicated high vibration rpm low flow rate derived modeling unique relationship sensor today advance machine learning technique made possible quickly identify anomaly learn unique relationship piece equipment historical data however company lack expertise build scale custom machine learning model across different industrial equipment result company often fail fully leverage investment sensor data infrastructure causing miss key actionable insight could help better manage critical equipment health performance amazon lookout equipment industrial manufacturing customer quickly easily build predictive maintenance solution entire facility across multiple location get started customer upload sensor data eg pressure flow rate rpm temperature power amazon simple storage service provide relevant bucket location amazon lookout equipment service automatically analyze data assess normal healthy pattern build machine learning model tailored customer environment amazon lookout equipment use custombuilt machine learning model analyze incoming sensor data identify early warning sign machine failure malfunction alert service specify sensor indicating issue measure magnitude impact detected event example amazon lookout equipment detected issue pump sensor service could show five sensor indicate issue specific motor relate issue motor power current temperature allows customer identify issue diagnose problem prioritize needed action perform precision maintenance issue happensaving money improving productivity preventing time amazon lookout equipment allows customer get value existing sensor help make timely decision materially improve operational efficiency amazon lookout equipment available directly via aws console well supporting partner aws partner network service available today u east n virginia eu ireland asia pacific seoul availability additional region coming month addition amazon lookout equipment aws offer industrial manufacturing customer broadest range cloudtoedge industrial machine learning service including amazon monitron predictive maintenance using endtoend solution comprised sensor gateway machine learning service amazon lookout vision visual anomaly detection using computer vision model cloud aws panorama visual inspection using appliance software development kit brings computer vision model onpremises camera many industrial manufacturing company heavily invested physical sensor technology aim improving maintenance equipment even gear place company position deploy machine learning model top ream data due lack resource scarcity data scientist result miss critical insight actionable finding would help better manage operation said swami sivasubramanian vp amazon machine learning aws today excited announce general availability amazon lookout equipment new service enables customer benefit custom machine learning model built specific environment quickly easily identify abnormal machine behaviorso take action avoid impact expense equipment downtime siemens energy offer product solution service across entire energy value chain support customer way sustainable future matter far along journey siemens energy work customer improve performance reliability safety existing business line enhanced digital service solution digitalization key driver sustainable energy future said amogh bhonde senior vice president digital solution siemens energy amazon lookout equipment see opportunity combine aws machine learning siemens energy subject matter expertise give improved visibility system equipment across entirety customer operation amazon lookout equipment automated machine learning workflow make easy build deploy model across variety asset type data science knowledge required siemens energy value aws trusted partner accelerating continued development omnivise suite digital solution cepsa global energy chemical company operating endtoend every stage oil gas value chain cepsa also manufacture product raw material plant origin driving new strategy become reference energy transition cepsa digital transformation focused people regard professional engine behind transformation amazon lookout equipment bringing machine learning insight expert know equipment bestreliability maintenance engineersallowing make informed decision drive higher uptime lower operational cost said alberto gascn head advanced analytics cepsa solution like predictive maintenance equipment traditionally involve manual complex data science choosing right algorithm parameter amazon lookout equipment automates process engineer focus solving critical challenge impact business embassy thing eot creator twin talk secure scalable etl data delivery system designed tap unrealized value hidden within operational data scada system historian enable industrial operating company leverage power cloudbased data analytics machine learning ai using predictive analytics anomaly detection one across production site key enables customer achieve highest level production optimization well cost emission reduction twin talk system liberates operational data enable cloudbased eventdriven realtime architecture amazon cloud service like iot sitewise said matt oberdorfer ceo embassy thing leveraging amazon lookout equipment suite solution enables automated machine learning process improves accuracy detecting meaningful insight enables insight action faster lookout equipment true gamechanger put ai hand maintenance engineer abstracting away traditionally datascienceheavy step scalable effectively across asset rovisys global operational technology system integrator leading independent provider comprehensive process automation solution service machine learning one promising technology industrial customer potential provide major value decreasing maintenance operational cost said bryan debois director industrial ai rovisys rovisys working aws integrate amazon lookout equipment data onpremises equipment infrastructure using aws iot service order enable advanced machine learning maintenance solution scale technology let customer leverage existing infrastructure unlock even value data quickly easily seeq advanced analytics solution enables engineer subject matter expert process manufacturing organization rapidly investigate share insight data historian iiot platform aws service manufacturing business system pleased announcing work aws develop solution deliver diagnostic monitoring predictive analytics powered big data machine learning innovation said megan buntain director cloud partnership seeq corporation using seeq amazon lookout equipment help organization turn data insight deliver continuous improvement sustainability objective tensoriot aws advanced consulting partner delivering complete endtoend product solution iot data engineering machine learning artificial intelligence tensoriot build solution aws service accelerate integration machine learning product process across industrial operation said charles burden vice president consulting tensoriot leveraging amazon lookout equipment help reduce heavy lift leveraging machine learning automatically developing managing supporting continuous improvement anomaly detection model greatly reduces number manual touchpoints needed allows engineer turn insight operational improvement simply put lookout equipment allows company innovate faster amazon web service year amazon web service world comprehensive broadly adopted cloud platform aws continually expanding service support virtually cloud workload fully featured service compute storage database networking analytics machine learning artificial intelligence ai internet thing iot mobile security hybrid virtual augmented reality vr ar medium application development deployment management availability zone az within geographic region announced plan availability zone five aws region australia india indonesia spain switzerland million customersincluding fastestgrowing startup largest enterprise leading government agenciestrust aws power infrastructure become agile lower cost learn aws visit awsamazoncom amazon amazon guided four principle customer obsession rather competitor focus passion invention commitment operational excellence longterm thinking customer review click shopping personalized recommendation prime fulfillment amazon aws kindle direct publishing kindle fire tablet fire tv amazon echo alexa product service pioneered amazon information visit follow amazonnews,0.9996,0.4998,0.1143286957,0.3854713043,Positive Impact
09/04/2021,165.235,168.61,164.45,168.61,168.61,86830000,3.3,50.56966791,1.192,0,13.66057312,0.8419472675,0.2413396506,0.07,267.054,13900.19043,15956.37012,6915.799805,6169.410156,3450.679932,49591.32031,19228,158.5900302,158.1557195,158.0258125,151.3355571,156.8074501,166.3241139,147.2907863,78.23219364,2.154935036,0.4290466608,1.725888375,3.202320644,153.6720455,10414898000,100,94.81836964,16.69000053,"Amazon defeats warehouse union push, challenges expected","Efforts to unionize Amazon's Bessemer, Alabama warehouse were defeated by a wide margin in the second day of vote counting. More than half of the 3,215 votes cast broke in in factor of the retailer.",https://techcrunch.com/2021/04/09/amazon-defeats-warehouse-union-push-challenges-expected/,techcrunch.com,5,effort unionize amazon bessemer alabama warehouse defeated wide margin second day vote counting half vote cast broke factor retailer,-0.6369,-0.31845,0.1309339286,-0.449383929,Negative Impact
12/04/2021,167.7605,169.75,167.56,168.97,168.97,65636000,3.3,50.56966791,1.192,0,13.66057312,0.8419472675,0.2413396506,0.07,267.054,13850,15977.45996,6889.100098,6161.680176,3412.949951,47883.37891,19201.30078,158.7318002,158.316967,158.4549766,151.5110192,157.5321999,168.4110566,146.6533431,76.97606913,2.68959644,0.8811566166,1.808439823,3.121464321,155.4646001,10480534000,96.07808048,96.13559652,16.90999985,"Amazon's recent stock surge has helped fend off bearish 'death cross' pattern, for now","Amazon.com Inc. stock's recent surge, in which it has shot up 9.3% this month toward a six-month high in afternoon trading Monday, as helped stave off an impending bearish ""death cross"" pattern, at least for now. A ""death cross"" appears when the 50-day moving average (DMA), which many see as a shorter-term trend tracker, crosses below the 200-DMA, which is seen as a dividing line between longer-term uptrends and downtrends.",https://www.marketwatch.com/story/amazons-recent-stock-surge-has-helped-fend-off-bearish-death-cross-pattern-for-now-2021-04-12,marketwatch.com,8,amazoncom inc stock recent surge shot month toward sixmonth high afternoon trading monday helped stave impending bearish death cross pattern least death cross appears day moving average dma many see shorterterm trend tracker cross dma seen dividing line longerterm uptrends downtrends,-0.8316,-0.66528,0.05143333333,-0.716713333,Negative Impact
13/04/2021,170.0425,171.60,169.78,170.00,170.00,66316000,3.3,50.56966791,1.192,0,13.66057312,0.8419472675,0.2413396506,0.07,267.054,13996.09961,15962.33984,6890.5,6184.100098,3396.469971,48544.05859,19203.69922,158.9256003,158.478322,158.9077226,151.6949892,158.3279999,170.4071271,146.2488727,76.69417517,3.160045344,1.336934362,1.823110982,3.05532183,157.464836,10546850000,92.66052349,96.24620132,16.64999962,"Amazon Could Be Worth $3 Trillion in Three Years, Analyst Says",Jefferies' Brent Thill asserts that Amazon Web Services is the company's most valuable businessÃÂÃÂand well-positioned for strong growth.,https://www.barrons.com/articles/amazon-could-be-worth-3-trillion-in-three-years-analyst-says-51618348040,barrons.com,9,jefferies brent thill asserts amazon web service company valuable businessand wellpositioned strong growth,0.8658,0.77922,0.3057714286,0.4734485714,Positive Impact
14/04/2021,170.202,170.21,166.30,166.65,166.65,62904000,3.3,50.56966791,1.192,0,13.66057312,0.8419472675,0.2413396506,0.07,267.054,13857.83984,16000.15039,6939.600098,6208.580078,3416.719971,48544.05859,19171.69922,158.9157202,158.6383545,159.2113411,151.8437952,158.9308495,171.4215792,146.4401197,74.1937692,3.225381801,1.71462385,1.510757951,3.065928868,159.7264632,10483946000,77.29352516,88.67737638,16.98999977,Indian Merchants Protest Against Amazon's Alleged Preferential Treatment: Bloomberg,"Amazon.Com Inc's (NASDAQ: AMZN) alleged unfair practices has attracted a protest event from over half a million small Indian business merchants on Thursday, Bloomberg reports. The local traders have long blamed giant e-tailers like Amazon and Walmart Inc (NYSE: WMT)-owned Flipkart for affecting the livelihoods of small online and offline sellers via preferential treatment.",https://www.benzinga.com/news/21/04/20621733/indian-merchants-protest-against-amazons-alleged-preferential-treatment-bloomberg,benzinga.com,5,amazoncom inc nasdaq amzn alleged unfair practice attracted protest event half million small indian business merchant thursday bloomberg report local trader long blamed giant etailers like amazon walmart inc nyse wmtowned flipkart affecting livelihood small online offline seller via preferential treatment,-0.2263,-0.11315,0.2601627273,-0.373312727,Negative Impact
15/04/2021,168.55,169.85,167.60,168.95,168.95,64672000,3.3,50.56966791,1.192,0,13.66057312,0.8419472675,0.2413396506,0.07,267.054,14038.75977,16116.84961,6983.5,6234.140137,3398.98999,48803.67969,19321.90039,158.9148102,158.813032,159.5934257,152.014051,159.5392494,172.7545464,146.3239524,82.40604444,3.423649953,2.05642907,1.367220882,3.035072327,161.62623,10548618000,87.86464476,85.93956447,16.56999969,U.S. labor movement looks for path forward after Amazon defeat,Regina McDowell was not surprised that workers overwhelmingly rejected a union at an Amazon.com Inc warehouse in Alabama last week.,https://www.reuters.com/article/us-usa-economy-union/u-s-labor-movement-looks-for-path-forward-after-amazon-defeat-idUSKBN2C217J,reuters.com,10,regina mcdowell surprised worker overwhelmingly rejected union amazoncom inc warehouse alabama last week,-0.4404,-0.4404,0.196164,-0.636564,Negative Impact
16/04/2021,169,170.34,167.78,169.97,169.97,63720000,3.3,50.56966791,1.192,0,13.66057312,0.8419472675,0.2413396506,0.07,267.054,14052.33984,16186.29004,7019.5,6287.069824,3426.620117,48832.03125,19351.30078,159.0017203,158.973187,160.0004286,152.192737,160.4678741,173.8834922,147.0522561,82.89177833,3.621140532,2.369371363,1.251769169,3.001323155,163.2220342,10612338000,91.93157954,85.69658316,16.25,"Das neue F1 Insights Powered by AWS hilft FORMEL-1-Fans, sekundenschnelle Entscheidungen auf der Strecke zu verstehen","SEATTLE--(BUSINESS WIRE)--Amazon Web Services (AWS), ein Unternehmen von Amazon.com, Inc. (NASDAQ: AMZN), und FORMEL 1 (F1) (NASDAQ: FWONA, FWONK) prÃÂÃÂ¤sentieren heute sechs neue F1 Insights powered by AWS, die bis zur Rennsaison 2021 eingefÃÂÃÂ¼hrt werden. Mit den neuen ErgÃÂÃÂ¤nzungen werden den Fans bis zum Ende der Saison insgesamt 18 AWS-gestÃÂÃÂ¼tzte Statistiken zur VerfÃÂÃÂ¼gung stehen. F1 Insights powered by AWS sind Echtzeit-Rennstatistiken, die in Form von Grafiken auf dem Bildschirm angezeigt werden und das Erlebnis der Fans vor, wÃÂÃÂ¤hrend und nach jedem Rennen verÃÂÃÂ¤ndern, indem sie die Daten und Analysen zur VerfÃÂÃÂ¼gung stellen, die die Fans zur Auslegung der Rennstrategie und Leistung von Fahrern und Teams brauchen. Die erste neue Statistik, Braking Performance, wird beim GRAND PRIX in Italien vom 16. bis 18. April neu auf den Markt kommen. Der neue Satz von Statistiken fÃÂÃÂ¼r 2021 wird eine Reihe von AWS-Technologien, darunter Machine Learning, verwenden, um den Fans zu helfen, mÃÂÃÂ¶gliche Rennergebnisse besser zu verstehen und hervorzuheben und ihre Lieblingsfahrer und -autos zu vergleichen. NÃÂÃÂ¤here Informationen ÃÂÃÂ¼ber AWS und seine Beteiligung an der Formel 1, einschlieÃÂÃÂlich der 12 zuvor verÃÂÃÂ¶ffentlichten F1 Insights, finden Sie unter: https://aws.amazon.com/f1/. Die Formel 1 ist ein datengesteuerter Sport, bei dem es fÃÂÃÂ¼r die Fans besonders spannend ist, vor und nach einem Rennen Statistiken durchzugehen, um ein tieferes VerstÃÂÃÂ¤ndnis der Entscheidungen von Fahrern und Teams sowie der Leistung der Autos auf der Strecke zu erlangen. F1 Insights powered by AWS verleiht den Statistiken eine neue Echtzeitdimension und bringt die Renndaten in den richtigen Kontext, um den Fans zu helfen, SchlÃÂÃÂ¼sselmomente auf der Rennstrecke besser zu verstehen. An jedem Rennwagen erzeugen ÃÂÃÂ¼ber 300 Sensoren mehr als 1,1 Millionen Datenpunkte pro Sekunde, die F1 von den Autos an die Box und zur Verarbeitung an AWS ÃÂÃÂ¼bertrÃÂÃÂ¤gt. Die Formel 1 vertraut auf die Breite und Tiefe der Dienstleistungen von AWS, um diese Datenflut zu streamen und zu analysieren, wÃÂÃÂ¤hrend sie erzeugt wird, und sie dann fÃÂÃÂ¼r Fernseh- und Online-Zuschauer auf der ganzen Welt durch die F1 Insights auf sinnvolle Weise zu prÃÂÃÂ¤sentieren. Das erste F1 Insight, das in dieser Saison eingefÃÂÃÂ¼hrt wird, Braking Performance, verdeutlicht, wie der Bremsstil eines Fahrers wÃÂÃÂ¤hrend eines KurvenmanÃÂÃÂ¶vers beim Verlassen einer Kurve von Vorteil sein kann. Bei guter AusfÃÂÃÂ¼hrung optimiert das Bremsen die Geschwindigkeit des Autos in den Phasen der Kurvenfahrt und erlaubt es dem Fahrer, eine bessere Position auf der Strecke zu erlangen. Indem die Statistik anzeigt und vergleicht, wie nah sich die Fahrer dem Scheitelpunkt einer Kurve nÃÂÃÂ¤hern, bevor sie bremsen, werden die Bremsstile und die Leistung der Fahrer dargestellt. AuÃÂÃÂerdem werden die wichtigsten Leistungsmetriken gezeigt, die das Zusammenspiel von Auto und Fahrer bei der Kurvenfahrt bestimmen, wie z. B. die HÃÂÃÂ¶chstgeschwindigkeit bei der AnnÃÂÃÂ¤herung, die Geschwindigkeitsabnahme beim Bremsen, die eingesetzte Bremsleistung (KWH) und die immensen G-KrÃÂÃÂ¤fte, denen der Fahrer bei der Kurvenfahrt ausgesetzt ist. Braking Performance stÃÂÃÂ¼tzt sich auf die bestehende Statistik Corner Analysis, die das physikalische Verhalten von Autos bei Kurvenfahrten darstellt. Braking Performance und die anderen fÃÂÃÂ¼nf neuen F1 Insights powered by AWS (siehe unten) werden in dieser Saison von April bis Dezember als Grafiken auf dem Bildschirm eingefÃÂÃÂ¼hrt. Jede neue Statistik gewÃÂÃÂ¤hrt den Fans einen grÃÂÃÂ¶ÃÂÃÂeren Einblick in die sekundenschnelle Action auf der Strecke und die Entscheidungsfindung hinter der Boxenmauer. Car Exploitation zeigt den Fans, wann die F1-Fahrer ihre Autos wÃÂÃÂ¤hrend der SchlÃÂÃÂ¼sselpunkte eines Rennens in Bereichen wie Reifentraktion, Bremsen, Beschleunigung und ManÃÂÃÂ¶vrieren an die Leistungsgrenze bringen. Die Statistik stellt die Daten in Echtzeit dar, indem sie die aktuelle Leistung eines Autos wÃÂÃÂ¤hrend eines Rennens verglichen mit einem theoretischen Leistungslimit aufzeigt und dann die dadurch gewonnene oder verlorene Zeit pro Runde berechnet. Die Statistik debÃÂÃÂ¼tiert vom 11. bis 13. Juni beim FORMULA 1 HEINEKEN GRAND PRIX DU CANADA 2021. Energy Usage gibt Aufschluss darÃÂÃÂ¼ber, wie die Hightech-Motoren der F1-Autos wÃÂÃÂ¤hrend eines Rennens Energie verbrauchen, auch dann, wenn die Teams Energie freisetzen, um ein anderes Auto zu ÃÂÃÂ¼berholen. Die Statistik zeigt die EnergieflÃÂÃÂ¼sse durch jede Komponente des fortschrittlichen F1-Motors, der so genannten Power Unit, und gibt an, wie viel Batterieenergie zu jedem beliebigen Zeitpunkt eines Rennens noch vorhanden ist. Der F1-Motor betreibt ein Fahrzeug mit einer Kombination aus interner Verbrennung und Hybridsystemen, die Energie vom Bremsen und vom Turbolader zurÃÂÃÂ¼ckgewinnen. Allerdings gibt es Grenzen fÃÂÃÂ¼r die EnergiespeicherkapazitÃÂÃÂ¤t der Power Unit und die Energiemenge, die wÃÂÃÂ¤hrend einer Rennrunde durch sie flieÃÂÃÂen kann. Rennteams erfassen diese Daten, damit sie die Leistung ihres Autos in SchlÃÂÃÂ¼sselmomenten eines Rennens maximieren kÃÂÃÂ¶nnen, und entscheiden, wann sie die Energie in gleichmÃÂÃÂ¤ÃÂÃÂigen StrÃÂÃÂ¶men einsetzen, um die besten Rundenzeiten zu erzielen, oder sie in konzentrierten Momenten freisetzen, um die Position zu gewinnen oder zu halten, wenn sie sich mit einem anderen Fahrer anlegen. Energy Usage erlaubt es den Fans, diese Entscheidungen in Echtzeit zu sehen. Die Statistik kommt erstmals vom 16. bis 18. Juli beim FORMULA 1 PIRELLI BRITISH GRAND PRIX 2021 zum Einsatz. Die Startanalyse zeigt an, welcher Fahrer auf dem Pedal am schnellsten war und die perfekte Linie gewÃÂÃÂ¤hlt hat, sowie welche Fahrer in der Startaufstellung zu kÃÂÃÂ¤mpfen hatten und weshalb. Den perfekten Start zu schaffen, ist eine der KernfÃÂÃÂ¤higkeiten eines Fahrers, und die Startanalyse wird den Fans dabei helfen, zu verstehen, wie die Entscheidungen eines Fahrers einen frÃÂÃÂ¼hen Vorteil im Rennen verdienen oder opfern. Die Statistik wird vom 10. bis 12. September beim FORMULA 1 HEINEKEN GRAN PREMIO D'ITALIA 2021 erstmals vorgestellt. Pitlane Performance analysiert die Performance im Boxenstopp und sorgt so fÃÂÃÂ¼r zusÃÂÃÂ¤tzliche Spannung in dem Teil des Rennens, der sich hinter der Boxenmauer abspielt. Boxenstopps sind ein essenzielles und prÃÂÃÂ¤zise koordiniertes, aber auch ein zeitintensives Element eines F1-Rennens. Pitlane Performance liefert Einblicke jenseits der stationÃÂÃÂ¤ren Stoppzeit eines Autos, wie z. B. die Leistung des Fahrers und des Teams wÃÂÃÂ¤hrend jedes Schrittes eines Boxenstopps in der Boxengasse, und beleuchtet die insgesamt verlorene oder gewonnene Zeit in der Boxengasse, je nachdem, wie effizient das Team arbeitet. Die Statistik wird erstmals vom 8. bis 10. Oktober beim FORMULA 1 JAPANESE GRAND PRIX 2021 vorgestellt. Undercut Threat unterstÃÂÃÂ¼tzt die Fans dabei, vorauszusehen, welche Autos in Gefahr sind, als Ergebnis eines ÃÂÃÂUndercutsÃÂÃÂ ÃÂÃÂ¼berholt zu werden. Der Undercut ist eine F1-Rennstrategie, bei der ein Fahrer, der auf der Verfolgung ist, in die Box einfÃÂÃÂ¤hrt, um frische Reifen zu holen, in der Erwartung, dass die verbesserte Rundenzeit, die sich aus den neuen Reifen ergibt, es dem Fahrer ermÃÂÃÂ¶glicht, das Auto vor ihm zu ÃÂÃÂ¼berholen, sobald dieses Auto in der Box ist. Im Juni 2020 fÃÂÃÂ¼hrte die Formel 1 eine ÃÂÃÂ¤hnliche Statistik, Pit Strategy Battle, ein, um ein Undercut Ballte zu markieren, wÃÂÃÂ¤hrend sie stattfindet, und den Fans dabei zu helfen, in Echtzeit einschÃÂÃÂ¤tzen zu kÃÂÃÂ¶nnen, wie erfolgreich die Strategie der einzelnen Fahrer sein wird. Undercut Threat bringt eine neue Ebene der Vorhersage ins Spiel, indem es die Rennleistung analysiert, bevor eines der beiden Autos in die Box kommt, und so die Spannung der Fans und das GefÃÂÃÂ¼hl der GefÃÂÃÂ¤hrdung durch mÃÂÃÂ¶gliche kommende Geschehnisse erhÃÂÃÂ¶ht. Es stellt Daten ÃÂÃÂ¼ber die AbstÃÂÃÂ¤nde zwischen den Autos, die durchschnittliche Boxenausfallzeit und die Reifenleistung visuell dar, sodass man erkennen kann, welche Autos gefÃÂÃÂ¤hrdet sind. Die Statistik wird erstmals vom 19. bis 21. November beim FORMULA 1 ROLEX AUSTRALIAN GRAND PRIX 2021 eingesetzt. Um diese neuen Erkenntnisse zu gewinnen, wird die Formel 1 historische Renndaten nutzen, die auf dem Amazon Simple Storage Service (Amazon S3) gespeichert sind, kombiniert mit Live-Daten, die von Sensoren an F1-Rennwagen und von der Rennstrecke ÃÂÃÂ¼ber Amazon Kinesis, einem Dienst zur Echtzeit-Datenerfassung, -verarbeitung und -analyse, gestreamt werden. F1-Ingenieure und -Wissenschaftler werden diese Daten dazu nutzen, Modelle fÃÂÃÂ¼r Machine Learning mit Amazon SageMaker zu nutzen, einer Dienstleistung von AWS, die Entwickler und Datenwissenschaftler dabei unterstÃÂÃÂ¼tzt, Modelle fÃÂÃÂ¼r Machine Learning schnell in der Cloud und am Edge zu erstellen, zu trainieren und bereitzustellen. F1 ist in der Lage, Renn-Performance-Metriken in Echtzeit zu analysieren, indem es diese ML-Modelle auf AWS Lambda einsetzt, was eine serverlose Dienstleistung ist, auf der Code ohne die Notwendigkeit der Bereitstellung oder des Managements von Servern ausgefÃÂÃÂ¼hrt werden kann. Alle Erkenntnisse werden in die internationale ÃÂÃÂbertragung der Rennen rund um den Globus, einschlieÃÂÃÂlich der digitalen Plattform von F1, F1TV, integriert und helfen den Fans, die sekundenschnellen Entscheidungen und Rennstrategien von Fahrern oder Teamstrategen zu verstehen, die den Ausgang eines Rennens dramatisch beeinflussen kÃÂÃÂ¶nnen. ÃÂÃÂF1 Insights Powered by AWS ermÃÂÃÂ¶glicht den Fans einen Einblick darÃÂÃÂ¼ber, wie Auto, Fahrer und Team zusammenspielen, damit sie das Geschehen auf der Strecke besser einschÃÂÃÂ¤tzen kÃÂÃÂ¶nnenÃÂÃÂ, sagt Rob Smedley, Chief Engineer von FORMEL 1. ÃÂÃÂMit diesem neuen Satz von Rennstatistiken fÃÂÃÂ¼r 2021 tauchen wir tiefer ein als je zuvor. Neue Einblicke wie Braking Performance und Undercut Threat legen zusÃÂÃÂ¤tzliche Schichten von Rennstrategien und Performance frei und nutzen fortschrittliche Visualisierungen, um den Rennsport noch verstÃÂÃÂ¤ndlicher und spannender zu machen. Die Technologie der Rennwagen verbessert sich kontinuierlich, und dank AWS kÃÂÃÂ¶nnen unsere Fans verstehen, wie sich diese Technologie auf die Ergebnisse der Rennen auswirkt.ÃÂÃÂ ÃÂÃÂDaten sind zu einem wesentlichen Teil der Geschichte des modernen Sports geworden, und fÃÂÃÂ¼r die Formel 1 ÃÂÃÂ wo wortwÃÂÃÂ¶rtlich jede Sekunde auf der Strecke mehr als eine Million Datenpunkte erzeugt ÃÂÃÂ brauchen wir einen Partner, der diese Rohdaten in Echtzeit in Bedeutung ÃÂÃÂ¼bersetzen kann. AWS macht es der Formel 1 mÃÂÃÂ¶glich, ihre Datenmengen in groÃÂÃÂem Umfang zu analysieren, bessere und besser informierte Entscheidungen zu fÃÂÃÂ¤llen und die Fans nÃÂÃÂ¤her an jede Phase des Geschehens auf der Strecke heranzubringen, von der Startaufstellung ÃÂÃÂ¼ber die Kurvenfahrt bis zum BoxenstoppÃÂÃÂ, sagt Darren Mowry, Director of Business Development bei AWS EMEA SARL. ÃÂÃÂDie fÃÂÃÂ¼hrenden Sportunternehmen der Welt verwenden AWS, um datengesteuerte LÃÂÃÂ¶sungen zu entwickeln und die Art neu zu erfinden, wie Sport beobachtet, gespielt und verwaltet wird. Unsere Arbeit mit der Formel 1 demonstriert, wie fortschrittliche Statistiken das Erlebnis der Fans verbessern kÃÂÃÂ¶nnen, indem sie die Taktiken und Strategien hinter den scheinbar einfachsten Elementen eines Rennens aufdecken.ÃÂÃÂ Nachrichten darÃÂÃÂ¼ber, wie AWS die Formel 1 bei der Entwicklung des Rennwagens der nÃÂÃÂ¤chsten Generation unterstÃÂÃÂ¼tzt, finden Sie unter: https://aws.amazon.com/f1/news/. ÃÂÃÂber Amazon Web Services Seit mehr als 15 Jahren war Amazon Web Services die weltweit umfassendste und weitlÃÂÃÂ¤ufig angenommene Cloud-Plattform. AWS hat seine Services kontinuierlich erweitert, um nahezu jeden Cloud-Workload zu unterstÃÂÃÂ¼tzen, und verfÃÂÃÂ¼gt jetzt ÃÂÃÂ¼ber mehr als 200 voll ausgestattete Services fÃÂÃÂ¼r Computing, Speicher, Datenbanken, Networking, Analytik, maschinelles Lernen und kÃÂÃÂ¼nstliche Intelligenz (artificial intelligence, AI), Internet der Dinge (Internet of Things, IoT), mobile Technologien, Sicherheit, Hybrid, Virtual und Augmented Reality (VR und AR), Medien sowie Anwendungsentwicklung, Bereitstellung und Management in 80 VerfÃÂÃÂ¼gbarkeitszonen (Availability Zones, AZs) innerhalb von 25 geografischen Regionen, mit angekÃÂÃÂ¼ndigten PlÃÂÃÂ¤nen fÃÂÃÂ¼r 15 weitere VerfÃÂÃÂ¼gbarkeitszonen und fÃÂÃÂ¼nf weitere AWS-Regionen in Australien, Indien, Indonesien, Spanien und der Schweiz. Millionen von Kunden ÃÂÃÂ darunter die am schnellsten wachsenden Start-ups, grÃÂÃÂ¶ÃÂÃÂten Unternehmen und fÃÂÃÂ¼hrenden RegierungsbehÃÂÃÂ¶rden ÃÂÃÂ vertrauen AWS, um ihre Infrastruktur mit Strom zu versorgen, agiler zu werden und Kosten zu senken. Mehr Informationen zu AWS erhalten Sie unter aws.amazon.com. ÃÂÃÂber Amazon Amazon orientiert sich an vier GrundsÃÂÃÂ¤tzen: Orientierung am Kunden statt an der Konkurrenz, Leidenschaft fÃÂÃÂ¼r Neuerungen, Einsatz fÃÂÃÂ¼r betriebliche Optimierung sowie langfristiges Denken. Kundenrezensionen, 1-Klick-EinkÃÂÃÂ¤ufe, persÃÂÃÂ¶nliche Empfehlungen, Prime, Versand durch Amazon, AWS, Kindle Direct Publishing, Kindle, Fire-Tablets, Fire TV, Amazon Echo und Alexa sind nur einige der von Amazon angebotenen Produkte und Dienstleistungen. Weitere Informationen finden Sie unter www.amazon.com/about und folgen Sie @AmazonNews. ÃÂÃÂber Formula 1ÃÂÃÂ® Formula 1ÃÂÃÂ®, auf Deutsch Formel 1-Rennsport begann 1950 und ist der prestigetrÃÂÃÂ¤chtigste Motorsportwettbewerb der Welt sowie die weltweit beliebteste jÃÂÃÂ¤hrliche Sportserie. Die FIA-Formel-1-Weltmeisterschaft 2021 (FIA Formula One World ChampionshipÃÂÃÂ) lÃÂÃÂ¤uft von MÃÂÃÂ¤rz bis Dezember und umfasst 23 Rennen in 22 LÃÂÃÂ¤ndern auf fÃÂÃÂ¼nf Kontinenten. FIA Formula One World ChampionshipÃÂÃÂ Limited gehÃÂÃÂ¶rt zur Formula 1ÃÂÃÂ® und hat die exklusiven kommerziellen Rechte an der FIA Formula One World ChampionshipÃÂÃÂ inne. Formula 1ÃÂÃÂ® ist eine Tochtergesellschaft der Liberty Media Corporation (NASDAQ: LSXMA, LSXMB, LSXMK, BATRA, BATRK, FWONA, FWONK), die der Formula One Group Tracking Stock zugerechnet wird. Das F1-Logo, das F1 FORMULA 1 Logo, FORMULA 1, F1, FIA FORMULA ONE WORLD CHAMPIONSHIP, GRAND PRIX, PADDOCK CLUB und verwandte Markenzeichen sind Markenzeichen von Formula One Licensing BV, einem Unternehmen der Formula 1. Alle Rechte vorbehalten. Die Ausgangssprache, in der der Originaltext verÃÂÃÂ¶ffentlicht wird, ist die offizielle und autorisierte Version. ÃÂÃÂbersetzungen werden zur besseren VerstÃÂÃÂ¤ndigung mitgeliefert. Nur die Sprachversion, die im Original verÃÂÃÂ¶ffentlicht wurde, ist rechtsgÃÂÃÂ¼ltig. Gleichen Sie deshalb ÃÂÃÂbersetzungen mit der originalen Sprachversion der VerÃÂÃÂ¶ffentlichung ab.",https://www.businesswire.com/news/home/20210416005589/de/,businesswire.com,5,seattlebusiness wireamazon web service aws ein unternehmen von amazoncom inc nasdaq amzn und formel f nasdaq fwona fwonk prsentieren heute sechs neue f insight powered aws die bi zur rennsaison eingefhrt werden mit den neuen ergnzungen werden den fan bi zum ende der saison insgesamt awsgesttzte statistiken zur verfgung stehen f insight powered aws sind echtzeitrennstatistiken die form von grafiken auf dem bildschirm angezeigt werden und da erlebnis der fan vor whrend und nach jedem rennen verndern indem sie die daten und analysen zur verfgung stellen die die fan zur auslegung der rennstrategie und leistung von fahrern und team brauchen die erste neue statistik braking performance wird beim grand prix italien vom bi april neu auf den markt kommen der neue satz von statistiken fr wird eine reihe von awstechnologien darunter machine learning verwenden um den fan zu helfen mgliche rennergebnisse besser zu verstehen und hervorzuheben und ihre lieblingsfahrer und auto zu vergleichen nhere informationen ber aws und seine beteiligung der formel einschlielich der zuvor verffentlichten f insight finden sie unter die formel ist ein datengesteuerter sport bei dem e fr die fan besonders spannend ist vor und nach einem rennen statistiken durchzugehen um ein tieferes verstndnis der entscheidungen von fahrern und team sowie der leistung der auto auf der strecke zu erlangen f insight powered aws verleiht den statistiken eine neue echtzeitdimension und bringt die renndaten den richtigen kontext um den fan zu helfen schlsselmomente auf der rennstrecke besser zu verstehen jedem rennwagen erzeugen ber sensoren mehr al millionen datenpunkte pro sekunde die f von den auto die box und zur verarbeitung aws bertrgt die formel vertraut auf die breite und tiefe der dienstleistungen von aws um diese datenflut zu streamen und zu analysieren whrend sie erzeugt wird und sie dann fr fernseh und onlinezuschauer auf der ganzen welt durch die f insight auf sinnvolle weise zu prsentieren da erste f insight da dieser saison eingefhrt wird braking performance verdeutlicht wie der bremsstil eines fahrers whrend eines kurvenmanvers beim verlassen einer kurve von vorteil sein kann bei guter ausfhrung optimiert da bremsen die geschwindigkeit de auto den phasen der kurvenfahrt und erlaubt e dem fahrer eine bessere position auf der strecke zu erlangen indem die statistik anzeigt und vergleicht wie nah sich die fahrer dem scheitelpunkt einer kurve nhern bevor sie bremsen werden die bremsstile und die leistung der fahrer dargestellt auerdem werden die wichtigsten leistungsmetriken gezeigt die da zusammenspiel von auto und fahrer bei der kurvenfahrt bestimmen wie z b die hchstgeschwindigkeit bei der annherung die geschwindigkeitsabnahme beim bremsen die eingesetzte bremsleistung kwh und die immensen gkrfte denen der fahrer bei der kurvenfahrt ausgesetzt ist braking performance sttzt sich auf die bestehende statistik corner analysis die da physikalische verhalten von auto bei kurvenfahrten darstellt braking performance und die anderen fnf neuen f insight powered aws siehe unten werden dieser saison von april bi dezember al grafiken auf dem bildschirm eingefhrt jede neue statistik gewhrt den fan einen greren einblick die sekundenschnelle action auf der strecke und die entscheidungsfindung hinter der boxenmauer car exploitation zeigt den fan wann die ffahrer ihre auto whrend der schlsselpunkte eines rennens bereichen wie reifentraktion bremsen beschleunigung und manvrieren die leistungsgrenze bringen die statistik stellt die daten echtzeit dar indem sie die aktuelle leistung eines auto whrend eines rennens verglichen mit einem theoretischen leistungslimit aufzeigt und dann die dadurch gewonnene oder verlorene zeit pro runde berechnet die statistik debtiert vom bi juni beim formula heineken grand prix du canada energy usage gibt aufschluss darber wie die hightechmotoren der fautos whrend eines rennens energie verbrauchen auch dann wenn die team energie freisetzen um ein anderes auto zu berholen die statistik zeigt die energieflsse durch jede komponente de fortschrittlichen fmotors der genannten power unit und gibt wie viel batterieenergie zu jedem beliebigen zeitpunkt eines rennens noch vorhanden ist der fmotor betreibt ein fahrzeug mit einer kombination au interner verbrennung und hybridsystemen die energie vom bremsen und vom turbolader zurckgewinnen allerdings gibt e grenzen fr die energiespeicherkapazitt der power unit und die energiemenge die whrend einer rennrunde durch sie flieen kann rennteams erfassen diese daten damit sie die leistung ihres auto schlsselmomenten eines rennens maximieren knnen und entscheiden wann sie die energie gleichmigen strmen einsetzen um die besten rundenzeiten zu erzielen oder sie konzentrierten momenten freisetzen um die position zu gewinnen oder zu halten wenn sie sich mit einem anderen fahrer anlegen energy usage erlaubt e den fan diese entscheidungen echtzeit zu sehen die statistik kommt erstmals vom bi juli beim formula pirelli british grand prix zum einsatz die startanalyse zeigt welcher fahrer auf dem pedal schnellsten war und die perfekte linie gewhlt hat sowie welche fahrer der startaufstellung zu kmpfen hatten und weshalb den perfekten start zu schaffen ist eine der kernfhigkeiten eines fahrers und die startanalyse wird den fan dabei helfen zu verstehen wie die entscheidungen eines fahrers einen frhen vorteil im rennen verdienen oder opfern die statistik wird vom bi september beim formula heineken gran premio ditalia erstmals vorgestellt pitlane performance analysiert die performance im boxenstopp und sorgt fr zustzliche spannung dem teil de rennens der sich hinter der boxenmauer abspielt boxenstopps sind ein essenzielles und przise koordiniertes aber auch ein zeitintensives element eines frennens pitlane performance liefert einblicke jenseits der stationren stoppzeit eines auto wie z b die leistung de fahrers und de team whrend jedes schrittes eines boxenstopps der boxengasse und beleuchtet die insgesamt verlorene oder gewonnene zeit der boxengasse je nachdem wie effizient da team arbeitet die statistik wird erstmals vom bi oktober beim formula japanese grand prix vorgestellt undercut threat untersttzt die fan dabei vorauszusehen welche auto gefahr sind al ergebnis eines undercut berholt zu werden der undercut ist eine frennstrategie bei der ein fahrer der auf der verfolgung ist die box einfhrt um frische reifen zu holen der erwartung das die verbesserte rundenzeit die sich au den neuen reifen ergibt e dem fahrer ermglicht da auto vor ihm zu berholen sobald diesis auto der box ist im juni fhrte die formel eine hnliche statistik pit strategy battle ein um ein undercut ballte zu markieren whrend sie stattfindet und den fan dabei zu helfen echtzeit einschtzen zu knnen wie erfolgreich die strategie der einzelnen fahrer sein wird undercut threat bringt eine neue ebene der vorhersage in spiel indem e die rennleistung analysiert bevor eines der beiden auto die box kommt und die spannung der fan und da gefhl der gefhrdung durch mgliche kommende geschehnisse erhht e stellt daten ber die abstnde zwischen den auto die durchschnittliche boxenausfallzeit und die reifenleistung visuell dar sodass man erkennen kann welche auto gefhrdet sind die statistik wird erstmals vom bi november beim formula rolex australian grand prix eingesetzt um diese neuen erkenntnisse zu gewinnen wird die formel historische renndaten nutzen die auf dem amazon simple storage service amazon gespeichert sind kombiniert mit livedaten die von sensoren frennwagen und von der rennstrecke ber amazon kinesis einem dienst zur echtzeitdatenerfassung verarbeitung und analyse gestreamt werden fingenieure und wissenschaftler werden diese daten dazu nutzen modelle fr machine learning mit amazon sagemaker zu nutzen einer dienstleistung von aws die entwickler und datenwissenschaftler dabei untersttzt modelle fr machine learning schnell der cloud und edge zu erstellen zu trainieren und bereitzustellen f ist der lage rennperformancemetriken echtzeit zu analysieren indem e diese mlmodelle auf aws lambda einsetzt eine serverlose dienstleistung ist auf der code ohne die notwendigkeit der bereitstellung oder de management von servern ausgefhrt werden kann alle erkenntnisse werden die internationale bertragung der rennen rund um den globus einschlielich der digitalen plattform von f ftv integriert und helfen den fan die sekundenschnellen entscheidungen und rennstrategien von fahrern oder teamstrategen zu verstehen die den ausgang eines rennens dramatisch beeinflussen knnen f insight powered aws ermglicht den fan einen einblick darber wie auto fahrer und team zusammenspielen damit sie da geschehen auf der strecke besser einschtzen knnen sagt rob smedley chief engineer von formel mit diesem neuen satz von rennstatistiken fr tauchen wir tiefer ein al je zuvor neue einblicke wie braking performance und undercut threat legen zustzliche schichten von rennstrategien und performance frei und nutzen fortschrittliche visualisierungen um den rennsport noch verstndlicher und spannender zu machen die technologie der rennwagen verbessert sich kontinuierlich und dank aws knnen unsere fan verstehen wie sich diese technologie auf die ergebnisse der rennen auswirkt daten sind zu einem wesentlichen teil der geschichte de modernen sport geworden und fr die formel wo wortwrtlich jede sekunde auf der strecke mehr al eine million datenpunkte erzeugt brauchen wir einen partner der diese rohdaten echtzeit bedeutung bersetzen kann aws macht e der formel mglich ihre datenmengen groem umfang zu analysieren bessere und besser informierte entscheidungen zu fllen und die fan nher jede phase de geschehens auf der strecke heranzubringen von der startaufstellung ber die kurvenfahrt bi zum boxenstopp sagt darren mowry director business development bei aws emea sarl die fhrenden sportunternehmen der welt verwenden aws um datengesteuerte lsungen zu entwickeln und die art neu zu erfinden wie sport beobachtet gespielt und verwaltet wird unsere arbeit mit der formel demonstriert wie fortschrittliche statistiken da erlebnis der fan verbessern knnen indem sie die taktiken und strategien hinter den scheinbar einfachsten elementen eines rennens aufdecken nachrichten darber wie aws die formel bei der entwicklung de rennwagens der nchsten generation untersttzt finden sie unter ber amazon web service seit mehr al jahren war amazon web service die weltweit umfassendste und weitlufig angenommene cloudplattform aws hat seine service kontinuierlich erweitert um nahezu jeden cloudworkload zu untersttzen und verfgt jetzt ber mehr al voll ausgestattete service fr computing speicher datenbanken networking analytik maschinelles lernen und knstliche intelligenz artificial intelligence ai internet der dinge internet thing iot mobile technologien sicherheit hybrid virtual und augmented reality vr und ar medien sowie anwendungsentwicklung bereitstellung und management verfgbarkeitszonen availability zone az innerhalb von geografischen regionen mit angekndigten plnen fr weitere verfgbarkeitszonen und fnf weitere awsregionen australien indien indonesien spanien und der schweiz millionen von kunden darunter die schnellsten wachsenden startup grten unternehmen und fhrenden regierungsbehrden vertrauen aws um ihre infrastruktur mit strom zu versorgen agiler zu werden und kosten zu senken mehr informationen zu aws erhalten sie unter awsamazoncom ber amazon amazon orientiert sich vier grundstzen orientierung kunden statt der konkurrenz leidenschaft fr neuerungen einsatz fr betriebliche optimierung sowie langfristiges denken kundenrezensionen klickeinkufe persnliche empfehlungen prime versand durch amazon aws kindle direct publishing kindle firetablets fire tv amazon echo und alexa sind nur einige der von amazon angebotenen produkte und dienstleistungen weitere informationen finden sie unter und folgen sie amazonnews ber formula formula auf deutsch formel rennsport begann und ist der prestigetrchtigste motorsportwettbewerb der welt sowie die weltweit beliebteste jhrliche sportserie die fiaformelweltmeisterschaft fia formula one world championship luft von mrz bi dezember und umfasst rennen lndern auf fnf kontinenten fia formula one world championship limited gehrt zur formula und hat die exklusiven kommerziellen rechte der fia formula one world championship inne formula ist eine tochtergesellschaft der liberty medium corporation nasdaq lsxma lsxmb lsxmk batra batrk fwona fwonk die der formula one group tracking stock zugerechnet wird da flogo da f formula logo formula f fia formula one world championship grand prix paddock club und verwandte markenzeichen sind markenzeichen von formula one licensing bv einem unternehmen der formula alle rechte vorbehalten die ausgangssprache der der originaltext verffentlicht wird ist die offizielle und autorisierte version bersetzungen werden zur besseren verstndigung mitgeliefert nur die sprachversion die im original verffentlicht wurde ist rechtsgltig gleichen sie deshalb bersetzungen mit der originalen sprachversion der verffentlichung ab,-0.9999,-0.49995,0.09800230769,-0.597952308,Negative Impact
19/04/2021,169.5165,171.80,168.01,168.60,168.60,54508000,3.3,50.56966791,1.192,0,13.66057312,0.8419472675,0.2413396506,0.07,267.054,13914.76953,16107.55957,7000.100098,6296.689941,3477.550049,47949.42188,19204.40039,159.0427301,159.0965145,160.3376861,152.3559983,161.2104988,174.7039852,147.7170125,77.85419019,3.625195195,2.620536129,1.004659066,3.047644479,164.5625097,10557830000,84.09673481,87.9643197,17.29000092,Amazon chart produces 'death cross' pattern despite rising short- and long-term trend trackers,"Amazon.com Inc.'s stock chart has produced a ""death cross"" pattern, the first in 18 months, but it has done so even both the shorter-term and longer-term trend trackers were rising. A ""death cross,"" in which the 50-day moving average crosses (50-DMA) below the 200-day moving average (200-DMA), is typically seen as a bearish technical pattern, with many chart watchers seeing them as marking the spot a shorter-term selloff transitions to a longer-term downtrend.",https://www.marketwatch.com/story/amazon-chart-produces-death-cross-pattern-despite-rising-short--and-long-term-trend-trackers-2021-04-19,marketwatch.com,8,amazoncom inc stock chart produced death cross pattern first month done even shorterterm longerterm trend tracker rising death cross day moving average cross dma day moving average dma typically seen bearish technical pattern many chart watcher seeing marking spot shorterterm selloff transition longerterm downtrend,-0.8316,-0.66528,0.2284936364,-0.893773636,Negative Impact
20/04/2021,168.68,169.15,165.80,166.73,166.73,52460000,3.3,50.56966791,1.192,0,13.66057312,0.8419472675,0.2413396506,0.07,267.054,13786.26953,15944.61035,6859.899902,6165.109863,3472.939941,47705.80078,19040.80078,159.0252701,159.207612,160.5885414,152.4990679,161.7700485,175.2020615,148.3380355,75.45922022,3.438204672,2.784069838,0.6541348344,3.1378588,171.7964935,10505370000,72.88917219,82.97249551,18.68000031,Amazon wird grÃÂÃÂ¶ÃÂÃÂter Abnehmer erneuerbarer Energien in Europa,"SEATTLE--(BUSINESS WIRE)--Amazon (NASDAQ: AMZN) gab heute neun neue Projekte in den USA, in Kanada, Spanien, Schweden und dem Vereinigten KÃÂÃÂ¶nigreich fÃÂÃÂ¼r die Nutzung von Wind- und Solarenergie bekannt. Das Unternehmen unterhÃÂÃÂ¤lt nun weltweit 206 Projekte fÃÂÃÂ¼r erneuerbare Energien, darunter 71 Projekte fÃÂÃÂ¼r angewendete Wind- und Solarenergie und 135 Dachsolaranlagen auf Einrichtungen und GeschÃÂÃÂ¤ften weltweit, die insgesamt auf eine KapazitÃÂÃÂ¤t von 8,5 GW Stromproduktion kommen. Mit dieser Bekanntgabe ist Amazon nun der grÃÂÃÂ¶ÃÂÃÂte unternehmerische Abnehmer erneuerbarer Energien in Europa, mit mehr als 2,5 GW KapazitÃÂÃÂ¤t fÃÂÃÂ¼r erneuerbare Energien, die ausreicht, um mehr als 2 Millionen Haushalte in Europa mit Strom zu versorgen. Diese Projekte werden erneuerbare Energien fÃÂÃÂ¼r die Niederlassungen, Fulfillment-Zentren, Whole Foods Market Niederlassungen und ÃÂÃÂAmazon Web Services (AWS)ÃÂÃÂ-Rechenzentren liefern, die weltweit Amazon und Millionen von AWS-Kunden unterstÃÂÃÂ¼tzen. Die erneuerbare Energie aus diesen Projekten ermÃÂÃÂ¶glicht es Amazon auch, seine Verpflichtung einzugehen, die Menge sauberer Energie fÃÂÃÂ¼r elektrischen Strom zu generieren, der von allen Echo-GerÃÂÃÂ¤ten fÃÂÃÂ¼r Verbraucher benÃÂÃÂ¶tigt wird. Mit all diesen Projekte ist Amazon auf einem guten Weg, bis 2025 100 % seiner AktivitÃÂÃÂ¤ten mit erneuerbaren Energien zu durchzufÃÂÃÂ¼hren ÃÂÃÂ fÃÂÃÂ¼nf Jahre vor dem ursprÃÂÃÂ¼nglich festgelegten Ziel im Jahr 2030. Die Investition in erneuerbare Energien ist eine der Hauptaktionen, die Amazon aufgrund seines Klimaversprechens (The Climate Pledge) durchfÃÂÃÂ¼hrt. Dabei geht es um die Verpflichtung, bis zum Jahr 2040, 10 Jahre vor dem Pariser Klimaabkommen, klimaneutral zu sein. ÃÂÃÂAmazon setzt seine Investitionen in erneuerbare Energien im Rahmen der Anstrengungen, seinem Versprechen fÃÂÃÂ¼r KlimaneutralitÃÂÃÂ¤t bis zum Jahr 2040 gerecht zu werden, in grÃÂÃÂ¶ÃÂÃÂerem Umfang fortÃÂÃÂ, sagte Jeff Bezos, GrÃÂÃÂ¼nder und CEO von Amazon. ÃÂÃÂMit diesen neuen Wind- und Solarprojekten haben wir weltweit 206 erneuerbare Wind- und Solarprojekte angekÃÂÃÂ¼ndigt, sodass wir jetzt der grÃÂÃÂ¶ÃÂÃÂte unternehmerische Abnehmer erneuerbarer Energien in Europa und weltweit sind. Viele unserer GeschÃÂÃÂ¤ftsbereiche arbeiten bereits mit erneuerbaren Energien, und wir gehen davon aus, Amazon bis zum Jahr 2025 insgesamt mit Strom aus erneuerbaren Energien zu versorgen ÃÂÃÂ fÃÂÃÂ¼nf Jahre vor unserem ursprÃÂÃÂ¼nglichen Zieljahr 2030.ÃÂÃÂ Die neun neuen Wind- und Solarprojekte, die heute in den USA, in Kanada, Spanien, Schweden und dem Vereinigten KÃÂÃÂ¶nigreich bekannt gegeben wurden, sind folgende: Unser erstes Solarprojekt mit Energiespeicherung: Mit Standort im kalifornischen Imperial Valley ermÃÂÃÂ¶glicht es das erste Amazon Solarprojekt zusammen mit Energiespeichern, Strom aus Sonneneinstrahlung mit der grÃÂÃÂ¶ÃÂÃÂten Nachfrage abzustimmen. Das Projekt generiert 100 Megawatt (MW) Solarenergie, was ausreicht, um mehr als 28.000 Haushalte fÃÂÃÂ¼r ein Jahr zu versorgen. AuÃÂÃÂerdem verfÃÂÃÂ¼gt es ÃÂÃÂ¼ber einen Energiespeicher von 70 MW. Mit dem Projekt kann Amazon auch Technologien der nÃÂÃÂ¤chsten Generation fÃÂÃÂ¼r Energiespeicherung und -management nutzen, wÃÂÃÂ¤hrend die ZuverlÃÂÃÂ¤ssigkeit und BestÃÂÃÂ¤ndigkeit des kalifornischen Stromnetzes erhalten bleibt. Unser erstes Projekt fÃÂÃÂ¼r erneuerbare Energien in Kanada: Amazon gibt seine erste Investition in erneuerbare Energien in Kanada bekannt: ein 80 MW Solarprojekt im County of Newell in Alberta. Nach seinem Abschluss wird es 195.000 Megawattstunden (MWh) erneuerbare Energie in das Stromnetz einspeisen, was ausreicht, um mehr als 18.000 kanadische Haushalte ein Jahr lang zu versorgen. Das grÃÂÃÂ¶ÃÂÃÂte unternehmerische Projekt fÃÂÃÂ¼r erneuerbare Energien im Vereinigten KÃÂÃÂ¶nigreich: Das neueste Amazon Projekt im Vereinigten KÃÂÃÂ¶nigreich besteht aus einem 350-MW-Windpark vor der schottischen KÃÂÃÂ¼ste und ist damit das grÃÂÃÂ¶ÃÂÃÂte im Land. Es ist auch das grÃÂÃÂ¶ÃÂÃÂte UnternehmensgeschÃÂÃÂ¤ft fÃÂÃÂ¼r erneuerbare Energien, das bisher von einem Unternehmen im Vereinigten KÃÂÃÂ¶nigreich bekannt gegeben wurde. Neue Projekte in den USA: Das erste Projekt von Amazon fÃÂÃÂ¼r erneuerbare Energien in Oklahoma ist ein 118-MW-Windprojekt in Murray County. Amazon baut auch neue Solarprojekte in den Countys Allen, Auglaize und Licking in Ohio. Insgesamt werden diese Projekte in Ohio mehr als 400 MW der benÃÂÃÂ¶tigten Energie des Bundesstaates liefern. ZusÃÂÃÂ¤tzliche Investitionen in Spanien und Schweden: In Spanien befinden sich die neuesten Amazon Solarprojekte in Extremadura und Andalusien. Sie speisen beide insgesamt mehr als 170 MW zusÃÂÃÂ¤tzlich in das Netz ein. An der KÃÂÃÂ¼ste Nord-Schwedens betreibt Amazon seit neuestem ein 258-MW-Windprojekt. Hier finden Sie eine Karte aller Amazon Projekte fÃÂÃÂ¼r erneuerbare Energien weltweit. ÃÂÃÂAmazon ist ein fÃÂÃÂ¼hrender Abnehmer erneuerbarer Energien und verÃÂÃÂ¤ndert den Markt kontinuierlich durch fortgesetzte Innovationen und Investments in erneuerbare Energien. Wir sehen mit Begeisterung die neuesten Engagements von Amazon weltweit, unter anderem in Spanien, Schweden und dem Vereinigten KÃÂÃÂ¶nigreich. Langfristige Investitionen wie diese tragen entscheidend dazu bei, dass sich Unternehmen weiter in Richtung KlimaneutralitÃÂÃÂ¤t bewegenÃÂÃÂ, sagte Hannah Hunt, Impact Director von RE-Source, einer Beschaffungsplattform fÃÂÃÂ¼r erneuerbare Energien in Europa. ÃÂÃÂAmazon setzt seine tragende Rolle als fÃÂÃÂ¼hrende Organisation beim ÃÂÃÂbergang von Unternehmen zur Stromversorgung aus erneuerbaren Energien weltweit fort und zeigt, dass ehrgeizige Ziele in diesem Bereich sowohl erreichbar als auch weitgehend vorteilhaft sindÃÂÃÂ, bemerkte Gregory Wetstone, President und CEO des American Council on Renewable Energy (ACORE). ÃÂÃÂDie neun neuen Projekte des Unternehmens fÃÂÃÂ¼r saubere Energie erzeugen einen beeindruckenden Gesamtrekord von 8,5 Gigawatt an weltweiter KapazitÃÂÃÂ¤t fÃÂÃÂ¼r erneuerbare Energien und umfassen das erste Solar- und Energiespeicherprojekt von Amazon, das ein sauberes, verlÃÂÃÂ¤ssliches Stromnetz mit fortschrittlichen Technologien bereitstellt. ÃÂÃÂFÃÂÃÂ¼hrende Unternehmen wie Amazon wissen vom Wert, den Solarenergie fÃÂÃÂ¼r Ihre GeschÃÂÃÂ¤fte und die Erde erzeugtÃÂÃÂ, sagte Abigail Ross Hopper, President und CEO der Solar Energy Industries Association (SEIA). ÃÂÃÂWir sehen mit Begeisterung, dass Amazon sich durchgehend an seine Klimaversprechen hÃÂÃÂ¤lt und weltweit in VermÃÂÃÂ¶genswerte fÃÂÃÂ¼r erneuerbare Energien investiert. Die BÃÂÃÂ¶rse an der Wall Street, Kunden und internationale GeschÃÂÃÂ¤fte beobachten, was amerikanische Unternehmen hinsichtlich des Klimawandels unternehmen. Diese Art von Leadership kann sich bedeutend auf die Klimakrise auswirken.ÃÂÃÂ Im Jahr 2019 riefen Amazon und Global Optimism gemeinsam das Klimaschutzversprechen ÃÂÃÂThe Climate PledgeÃÂÃÂ ins Leben, eine Verpflichtung, die Vorgaben des Pariser Abkommens zehn Jahre frÃÂÃÂ¼her zu erreichen und bis 2040 klimaneutral zu sein. Das Klimaversprechen hat inzwischen 53 Unterzeichner, darunter IBM, Unilever, Verizon, Siemens, Microsoft und Best Buy. Um sein Ziel zu erreichen, wird Amazon die Emissionen in allen Bereichen seiner GeschÃÂÃÂ¤ftstÃÂÃÂ¤tigkeit weiter reduzieren, indem es echte GeschÃÂÃÂ¤ftsmaÃÂÃÂnahmen ergreift. Zu diesem Zweck wird das Unternehmen einen Weg finden, seinen Betrieb zu 100 % mit erneuerbaren Energien zu versorgen, fÃÂÃÂ¼nf Jahre vor dem ursprÃÂÃÂ¼nglichen Ziel des Unternehmens bis 2030; es wird seine ÃÂÃÂShipment ZeroÃÂÃÂ-Vision verwirklichen, wonach alle Lieferungen bis 2030 zu 50 % netto und letztlich ganz kohlenstofffrei sein sollen; und es wird 100.000 elektrische Lieferfahrzeuge kaufen, die bisher grÃÂÃÂ¶ÃÂÃÂte Bestellung von elektrischen Lieferfahrzeugen. Weiterhin sollen ÃÂÃÂ¼ber den Klimafonds (Climate Pledge Fund) 2 Mrd. US-Dollar in die Entwicklung von Diensten und LÃÂÃÂ¶sungen zur Kohlenstoffreduktion investiert werden. Weitere Informationen finden Sie unter https://sustainability.aboutamazon.com/. ÃÂÃÂber Amazon Amazon orientiert sich an vier GrundsÃÂÃÂ¤tzen: Orientierung am Kunden statt an der Konkurrenz, Leidenschaft fÃÂÃÂ¼r Neuerungen, Einsatz fÃÂÃÂ¼r betriebliche Optimierung sowie langfristiges Denken. Kundenrezensionen, 1-Klick-EinkÃÂÃÂ¤ufe, persÃÂÃÂ¶nliche Empfehlungen, Prime, Versand durch Amazon, AWS, Kindle Direct Publishing, Kindle, Fire-Tablets, Fire TV, Amazon Echo und Alexa sind nur einige der von Amazon angebotenen Produkte und Dienstleistungen. FÃÂÃÂ¼r weitere Informationen besuchen Sie amazon.com/about und folgen Sie @AmazonNews. ÃÂÃÂber Amazon Web Services Seit 15 Jahren ist Amazon Web Services die umfassendste und am weitesten verbreitete Cloud-Plattform der Welt. AWS hat seine Services kontinuierlich erweitert, um nahezu jeden Cloud-Workload zu unterstÃÂÃÂ¼tzen, und verfÃÂÃÂ¼gt jetzt ÃÂÃÂ¼ber mehr als 200 voll ausgestattete Services fÃÂÃÂ¼r Computing, Speicher, Datenbanken, Networking, Analytik, maschinelles Lernen und kÃÂÃÂ¼nstliche Intelligenz (artificial intelligence, AI), Internet der Dinge (Internet of Things, IoT), mobile Technologien, Sicherheit, Hybrid, Virtual und Augmented Reality (VR und AR), Medien sowie Anwendungsentwicklung, Bereitstellung und Management in 80 VerfÃÂÃÂ¼gbarkeitszonen (Availability Zones, AZs) innerhalb von 25 geografischen Regionen, mit angekÃÂÃÂ¼ndigten PlÃÂÃÂ¤nen fÃÂÃÂ¼r 15 weitere VerfÃÂÃÂ¼gbarkeitszonen und fÃÂÃÂ¼nf weitere AWS-Regionen in Australien, Indien, Indonesien, Spanien und der Schweiz. Millionen von Kunden ÃÂÃÂ darunter die am schnellsten wachsenden Start-ups, grÃÂÃÂ¶ÃÂÃÂten Unternehmen und fÃÂÃÂ¼hrenden RegierungsbehÃÂÃÂ¶rden ÃÂÃÂ vertrauen AWS, um ihre Infrastruktur mit Strom zu versorgen, agiler zu werden und Kosten zu senken. Mehr Informationen zu AWS erhalten Sie unter aws.amazon.com. Die Ausgangssprache, in der der Originaltext verÃÂÃÂ¶ffentlicht wird, ist die offizielle und autorisierte Version. ÃÂÃÂbersetzungen werden zur besseren VerstÃÂÃÂ¤ndigung mitgeliefert. Nur die Sprachversion, die im Original verÃÂÃÂ¶ffentlicht wurde, ist rechtsgÃÂÃÂ¼ltig. Gleichen Sie deshalb ÃÂÃÂbersetzungen mit der originalen Sprachversion der VerÃÂÃÂ¶ffentlichung ab.",https://www.businesswire.com/news/home/20210420005945/de/,businesswire.com,5,seattlebusiness wireamazon nasdaq amzn gab heute neun neue projekte den usa kanada spanien schweden und dem vereinigten knigreich fr die nutzung von wind und solarenergie bekannt da unternehmen unterhlt nun weltweit projekte fr erneuerbare energien darunter projekte fr angewendete wind und solarenergie und dachsolaranlagen auf einrichtungen und geschften weltweit die insgesamt auf eine kapazitt von gw stromproduktion kommen mit dieser bekanntgabe ist amazon nun der grte unternehmerische abnehmer erneuerbarer energien europa mit mehr al gw kapazitt fr erneuerbare energien die ausreicht um mehr al millionen haushalte europa mit strom zu versorgen diese projekte werden erneuerbare energien fr die niederlassungen fulfillmentzentren whole food market niederlassungen und amazon web service awsrechenzentren liefern die weltweit amazon und millionen von awskunden untersttzen die erneuerbare energie au diesen projekten ermglicht e amazon auch seine verpflichtung einzugehen die menge sauberer energie fr elektrischen strom zu generieren der von allen echogerten fr verbraucher bentigt wird mit diesen projekte ist amazon auf einem guten weg bi seiner aktivitten mit erneuerbaren energien zu durchzufhren fnf jahre vor dem ursprnglich festgelegten ziel im jahr die investition erneuerbare energien ist eine der hauptaktionen die amazon aufgrund seine klimaversprechens climate pledge durchfhrt dabei geht e um die verpflichtung bi zum jahr jahre vor dem pariser klimaabkommen klimaneutral zu sein amazon setzt seine investitionen erneuerbare energien im rahmen der anstrengungen seinem versprechen fr klimaneutralitt bi zum jahr gerecht zu werden grerem umfang fort sagte jeff bezos grnder und ceo von amazon mit diesen neuen wind und solarprojekten haben wir weltweit erneuerbare wind und solarprojekte angekndigt sodass wir jetzt der grte unternehmerische abnehmer erneuerbarer energien europa und weltweit sind viele unserer geschftsbereiche arbeiten bereits mit erneuerbaren energien und wir gehen davon au amazon bi zum jahr insgesamt mit strom au erneuerbaren energien zu versorgen fnf jahre vor unserem ursprnglichen zieljahr die neun neuen wind und solarprojekte die heute den usa kanada spanien schweden und dem vereinigten knigreich bekannt gegeben wurden sind folgende unser erstes solarprojekt mit energiespeicherung mit standort im kalifornischen imperial valley ermglicht e da erste amazon solarprojekt zusammen mit energiespeichern strom au sonneneinstrahlung mit der grten nachfrage abzustimmen da projekt generiert megawatt mw solarenergie ausreicht um mehr al haushalte fr ein jahr zu versorgen auerdem verfgt e ber einen energiespeicher von mw mit dem projekt kann amazon auch technologien der nchsten generation fr energiespeicherung und management nutzen whrend die zuverlssigkeit und bestndigkeit de kalifornischen stromnetzes erhalten bleibt unser erstes projekt fr erneuerbare energien kanada amazon gibt seine erste investition erneuerbare energien kanada bekannt ein mw solarprojekt im county newell alberta nach seinem abschluss wird e megawattstunden mwh erneuerbare energie da stromnetz einspeisen ausreicht um mehr al kanadische haushalte ein jahr lang zu versorgen da grte unternehmerische projekt fr erneuerbare energien im vereinigten knigreich da neueste amazon projekt im vereinigten knigreich besteht au einem mwwindpark vor der schottischen kste und ist damit da grte im land e ist auch da grte unternehmensgeschft fr erneuerbare energien da bisher von einem unternehmen im vereinigten knigreich bekannt gegeben wurde neue projekte den usa da erste projekt von amazon fr erneuerbare energien oklahoma ist ein mwwindprojekt murray county amazon baut auch neue solarprojekte den county allen auglaize und licking ohio insgesamt werden diese projekte ohio mehr al mw der bentigten energie de bundesstaates liefern zustzliche investitionen spanien und schweden spanien befinden sich die neuesten amazon solarprojekte extremadura und andalusien sie speisen beide insgesamt mehr al mw zustzlich da netz ein der kste nordschwedens betreibt amazon seit neuestem ein mwwindprojekt hier finden sie eine karte aller amazon projekte fr erneuerbare energien weltweit amazon ist ein fhrender abnehmer erneuerbarer energien und verndert den markt kontinuierlich durch fortgesetzte innovationen und investment erneuerbare energien wir sehen mit begeisterung die neuesten engagement von amazon weltweit unter anderem spanien schweden und dem vereinigten knigreich langfristige investitionen wie diese tragen entscheidend dazu bei das sich unternehmen weiter richtung klimaneutralitt bewegen sagte hannah hunt impact director von resource einer beschaffungsplattform fr erneuerbare energien europa amazon setzt seine tragende rolle al fhrende organisation beim bergang von unternehmen zur stromversorgung au erneuerbaren energien weltweit fort und zeigt das ehrgeizige ziele diesem bereich sowohl erreichbar al auch weitgehend vorteilhaft sind bemerkte gregory wetstone president und ceo de american council renewable energy acore die neun neuen projekte de unternehmens fr saubere energie erzeugen einen beeindruckenden gesamtrekord von gigawatt weltweiter kapazitt fr erneuerbare energien und umfassen da erste solar und energiespeicherprojekt von amazon da ein sauberes verlssliches stromnetz mit fortschrittlichen technologien bereitstellt fhrende unternehmen wie amazon wissen vom wert den solarenergie fr ihre geschfte und die erde erzeugt sagte abigail ross hopper president und ceo der solar energy industry association seia wir sehen mit begeisterung das amazon sich durchgehend seine klimaversprechen hlt und weltweit vermgenswerte fr erneuerbare energien investiert die brse der wall street kunden und internationale geschfte beobachten amerikanische unternehmen hinsichtlich de klimawandels unternehmen diese art von leadership kann sich bedeutend auf die klimakrise auswirken im jahr riefen amazon und global optimism gemeinsam da klimaschutzversprechen climate pledge in leben eine verpflichtung die vorgaben de pariser abkommens zehn jahre frher zu erreichen und bi klimaneutral zu sein da klimaversprechen hat inzwischen unterzeichner darunter ibm unilever verizon siemens microsoft und best buy um sein ziel zu erreichen wird amazon die emissionen allen bereichen seiner geschftsttigkeit weiter reduzieren indem e echte geschftsmanahmen ergreift zu diesem zweck wird da unternehmen einen weg finden seinen betrieb zu mit erneuerbaren energien zu versorgen fnf jahre vor dem ursprnglichen ziel de unternehmens bi e wird seine shipment zerovision verwirklichen wonach alle lieferungen bi zu netto und letztlich ganz kohlenstofffrei sein sollen und e wird elektrische lieferfahrzeuge kaufen die bisher grte bestellung von elektrischen lieferfahrzeugen weiterhin sollen ber den klimafonds climate pledge fund mrd usdollar die entwicklung von diensten und lsungen zur kohlenstoffreduktion investiert werden weitere informationen finden sie unter ber amazon amazon orientiert sich vier grundstzen orientierung kunden statt der konkurrenz leidenschaft fr neuerungen einsatz fr betriebliche optimierung sowie langfristiges denken kundenrezensionen klickeinkufe persnliche empfehlungen prime versand durch amazon aws kindle direct publishing kindle firetablets fire tv amazon echo und alexa sind nur einige der von amazon angebotenen produkte und dienstleistungen fr weitere informationen besuchen sie amazoncomabout und folgen sie amazonnews ber amazon web service seit jahren ist amazon web service die umfassendste und weitesten verbreitete cloudplattform der welt aws hat seine service kontinuierlich erweitert um nahezu jeden cloudworkload zu untersttzen und verfgt jetzt ber mehr al voll ausgestattete service fr computing speicher datenbanken networking analytik maschinelles lernen und knstliche intelligenz artificial intelligence ai internet der dinge internet thing iot mobile technologien sicherheit hybrid virtual und augmented reality vr und ar medien sowie anwendungsentwicklung bereitstellung und management verfgbarkeitszonen availability zone az innerhalb von geografischen regionen mit angekndigten plnen fr weitere verfgbarkeitszonen und fnf weitere awsregionen australien indien indonesien spanien und der schweiz millionen von kunden darunter die schnellsten wachsenden startup grten unternehmen und fhrenden regierungsbehrden vertrauen aws um ihre infrastruktur mit strom zu versorgen agiler zu werden und kosten zu senken mehr informationen zu aws erhalten sie unter awsamazoncom die ausgangssprache der der originaltext verffentlicht wird ist die offizielle und autorisierte version bersetzungen werden zur besseren verstndigung mitgeliefert nur die sprachversion die im original verffentlicht wurde ist rechtsgltig gleichen sie deshalb bersetzungen mit der originalen sprachversion der verffentlichung ab,-0.9969,-0.49845,0.2967616667,-0.795211667,Negative Impact
21/04/2021,165.8,168.14,165.19,168.10,168.10,44224000,3.3,50.56966791,1.192,0,13.66057312,0.8419472675,0.2413396506,0.07,267.054,13950.21973,16121.61035,6895.299805,6210.549805,3472.929932,47705.80078,19143.30078,159.06435,159.283857,160.8831476,152.654311,162.3313484,175.8400855,148.8226114,74.93575674,3.361528922,2.899561654,0.4619672671,3.120036534,171.7964935,10549594000,76.9305434,77.97215013,17.5,De Climate Pledge kondigt meer dan 100 ondertekenaars aan die zich verbinden tot het bereiken van netto-nul koolstof tegen 2040 of vroeger,"SEATTLE--(BUSINESS WIRE)--Vandaag hebben Amazon en Global Optimism aangekondigd dat meer dan 100 bedrijven nu de Climate Pledge hebben ondertekend. Onder de 52 nieuwe ondertekenaars die zich vandaag bij The Climate Pledge aansluiten, bevinden zich bekende merken, waaronder Alaska Airlines, Colgate-Palmolive, HEINEKEN, PepsiCo, TelefÃÂÃÂ³nica en Visa. De ondertekenaars van de belofte genereren in totaal meer dan $ 1,4 biljoen aan wereldwijde jaaromzet en hebben meer dan 5 miljoen werknemers in 25 bedrijfstakken in 16 landen ÃÂÃÂ wat de collectieve impact aantoont die de Climate Pledge kan hebben bij het aanpakken van klimaatverandering. Deze bekendmaking is officieel geldend in de originele brontaal. Vertalingen zijn slechts als leeshulp bedoeld en moeten worden vergeleken met de tekst in de brontaal, die als enige rechtsgeldig is.",https://www.businesswire.com/news/home/20210421005723/nl/,businesswire.com,5,seattlebusiness wirevandaag hebben amazon en global optimism aangekondigd dat meer dan bedrijven nu de climate pledge hebben ondertekend onder de nieuwe ondertekenaars die zich vandaag bij climate pledge aansluiten bevinden zich bekende merken waaronder alaska airline colgatepalmolive heineken pepsico telefnica en visa de ondertekenaars van de belofte genereren totaal meer dan biljoen aan wereldwijde jaaromzet en hebben meer dan miljoen werknemers bedrijfstakken landen wat de collectieve impact aantoont die de climate pledge kan hebben bij het aanpakken van klimaatverandering deze bekendmaking officieel geldend de originele brontaal vertalingen zijn slechts al leeshulp bedoeld en moeten worden vergeleken met de tekst de brontaal die al enige rechtsgeldig,-0.8176,-0.4088,0.2155488,-0.6243488,Negative Impact
22/04/2021,168.584,168.64,165.07,165.45,165.45,51612000,3.3,50.56966791,1.192,0,13.66057312,0.8419472675,0.2413396506,0.07,267.054,13818.41016,16030.62012,6938.200195,6267.279785,3465.110107,48080.67188,19031.59961,159.0683899,159.361087,161.0623181,152.7816512,162.8862732,175.9185565,149.8539899,64.14427895,3.051830901,2.930015504,0.1218153973,3.130965097,171.532254,10497982000,53.80611574,67.87527711,18.70999908,Reports Of A Full-Size Checkout-Free Amazon Supermarket Should Be Taken As Seriously As A Heart Attack,Simple math highlights why the recent rumors of a full-scale Amazon checkout-free grocery store should scare the heck out of the grocery industry.,https://www.forbes.com/sites/christopherwalton/2021/04/22/reports-of-a-full-size-checkout-free-amazon-supermarket-should-be-taken-as-seriously-as-a-heart-attack/,forbes.com,8,simple math highlight recent rumor fullscale amazon checkoutfree grocery store scare heck grocery industry,-0.0258,-0.02064,0.33739,-0.35803,Negative Impact
23/04/2021,165.955,168.75,165.43,167.04,167.04,63856000,3.3,50.56966791,1.192,0,13.66057312,0.8419472675,0.2413396506,0.07,267.054,14016.80957,16206,6938.600098,6257.939941,3474.169922,47878.44922,19102.30078,159.1226901,159.4260295,161.2968941,152.9235651,163.6228233,175.7743624,151.4712843,61.66151317,2.901409291,2.924294261,-0.022884971,3.100750514,171.1446685,10561838000,56.57643414,62.43769776,17.32999992,"ÃÂÃÂThe Climate PledgeÃÂÃÂ gibt bekannt, dass sich mehr als 100 Unterzeichner verpflichtet haben, bis 2040 oder frÃÂÃÂ¼her Netto-Null-Kohlenstoffemissionen zu erreichen","SEATTLE--(BUSINESS WIRE)--Heute gaben Amazon und Global Optimism bekannt, dass mittlerweile mehr als 100 Unternehmen The Climate Pledge unterzeichnet haben. Zu den 52 neuen Unterzeichnern, die sich heute ÃÂÃÂThe Climate PledgeÃÂÃÂ angeschlossen haben, gehÃÂÃÂ¶ren bekannte Marken wie Alaska Airlines, Colgate-Palmolive, HEINEKEN, PepsiCo, TelefÃÂÃÂ³nica und Visa. Die Unterzeichner der Verpflichtung erwirtschaften insgesamt weltweit einen Jahresumsatz von mehr als 1,4 Billionen US-Dollar und beschÃÂÃÂ¤ftigen mehr als fÃÂÃÂ¼nf Millionen Mitarbeiter in 25 Branchen in 16 LÃÂÃÂ¤ndern ÃÂÃÂ was verdeutlicht, welchen kollektiven Einfluss ÃÂÃÂThe Climate PledgeÃÂÃÂ auf den Kampf gegen den Klimawandel haben kann. Die Unterzeichner von ÃÂÃÂThe Climate PledgeÃÂÃÂ stimmen zu: Treibhausgasemissionen regelmÃÂÃÂ¤ÃÂÃÂig zu messen und darÃÂÃÂ¼ber zu berichten. Dekarbonisierungsstrategien im Einklang mit dem ÃÂÃÂbereinkommen von Paris durch echte geschÃÂÃÂ¤ftliche VerÃÂÃÂ¤nderungen und Innovationen umzusetzen, einschlieÃÂÃÂlich Effizienzsteigerungen, erneuerbarer Energien, Materialreduzierungen und anderer Strategien zur Beseitigung von CO2-Emissionen. Alle verbleibenden Emissionen durch zusÃÂÃÂ¤tzliche, quantifizierbare, reale, dauerhafte und fÃÂÃÂ¼r die Gesellschaft vorteilhafte Kompensationen zu neutralisieren, um bis zum Jahr 2040 einen jÃÂÃÂ¤hrlichen Netto-KohlenstoffausstoÃÂÃÂ von Null zu erreichen ÃÂÃÂ ein Jahrzehnt vor dem im ÃÂÃÂbereinkommen von Paris festgelegten Ziel von 2050. Alle Unterzeichner ergreifen wissenschaftlich fundierte, wirkungsvolle MaÃÂÃÂnahmen im Kampf gegen den Klimawandel, indem sie Innovationen u. a. in den Bereichen Effizienz der Lieferkette, nachhaltiger Transport, Kreislaufwirtschaft, saubere EnergielÃÂÃÂ¶sungen entwickeln. Viele Unternehmen binden auch ihre Kunden sinnvoll in ihre BemÃÂÃÂ¼hungen um Netto-Null-Emissionen ein ÃÂÃÂ mit Initiativen, die sich auf innovative Verpackungen und nachhaltiges Produktdesign und -entwicklung konzentrieren, wÃÂÃÂ¤hrend sie gleichzeitig LÃÂÃÂ¶sungen anbieten, die die Kunden befÃÂÃÂ¤higen, ihre eigenen Emissionen mithilfe von AufklÃÂÃÂ¤rungskampagnen und nachhaltigen Einkaufserlebnissen zu reduzieren. ÃÂÃÂVor weniger als zwei Jahren war Amazon MitbegrÃÂÃÂ¼nder von ÃÂÃÂThe Climate PledgeÃÂÃÂ und rief andere Unternehmen dazu auf, das ÃÂÃÂbereinkommen von Paris zehn Jahre frÃÂÃÂ¼her zu erreichen ÃÂÃÂ mittlerweile haben mehr als 100 Unternehmen mit einem weltweiten Jahresumsatz von ÃÂÃÂ¼ber 1,4 Billionen US-Dollar und mehr als 5 Millionen Mitarbeitern die Verpflichtung unterzeichnetÃÂÃÂ, sagte Jeff Bezos, der GrÃÂÃÂ¼nder und CEO von Amazon. ÃÂÃÂWir sind stolz darauf, mit den anderen Unterzeichnern an einem Strang zu ziehen und unsere GrÃÂÃÂ¶ÃÂÃÂenvorteile zu nutzen, um die Wirtschaft durch echte wirtschaftliche VerÃÂÃÂ¤nderungen und Innovationen zu dekarbonisieren.ÃÂÃÂ ÃÂÃÂWir haben bei der GrÃÂÃÂ¼ndung von ÃÂÃÂThe Climate PledgeÃÂÃÂ geholfen, um ein Modell zu etablieren, das die Dekarbonisierung bei den ehrgeizigsten Unternehmen beschleunigtÃÂÃÂ, sagte Christiana Figueres, die frÃÂÃÂ¼here UN-Klimachefin und jetzige GrÃÂÃÂ¼ndungsgesellschafterin von Global Optimism. ÃÂÃÂHeute sind mehr als 100 Unternehmen, darunter bekannte Marken und Unternehmen aus allen Branchen, an ÃÂÃÂThe Climate PledgeÃÂÃÂ mit seinem Ziel der Netto-Null-Emissionen bis 2040 beteiligt. Sie zeigen, dass eine schnellere Umsetzung der Dekarbonisierung ihrer Unternehmen ein Weg hin zum Wettbewerbsvorteil ist. Es besteht kein Zweifel, dass wir uns an einem entscheidenden Wendepunkt befinden, um die im ÃÂÃÂbereinkommen von Paris angestrebte kohlenstoffarme Wirtschaft zu realisieren. Ich spreche den FÃÂÃÂ¼hrungsspitzen der Unternehmen, die ÃÂÃÂThe Climate PledgeÃÂÃÂ bereits beigetreten sind, meine Anerkennung aus und freue mich darauf, die nÃÂÃÂ¤chsten 100 zu begrÃÂÃÂ¼ÃÂÃÂen.ÃÂÃÂ Amazon und Global Optimism begrÃÂÃÂ¼ÃÂÃÂen die neuen Unterzeichner, die sich ÃÂÃÂThe Climate PledgeÃÂÃÂ verpflichtet haben. Informationen ÃÂÃÂ¼ber alle 52 neuen Unterzeichner, die sich ÃÂÃÂThe Climate PledgeÃÂÃÂ verpflichtet haben, finden Sie auf dem Blog About Amazon. Zu den neuen Unterzeichnern gehÃÂÃÂ¶ren: Alaska Airlines Alaska Airlines fliegt mehr als 120 Ziele in den USA, Mexiko, Kanada und Costa Rica an und erreicht ÃÂÃÂ¼ber die Oneworld Alliance Ziele auf der ganzen Welt. Das Unternehmen engagiert sich seit Langem fÃÂÃÂ¼r die Menschen und die Umwelt und ergreift mutige MaÃÂÃÂnahmen, um die Auswirkungen auf das Klima kurz- und langfristig zu reduzieren und bis 2040 Netto-Null-Emissionen zu erreichen. Dazu gehÃÂÃÂ¶ren die kontinuierliche Verbesserung der Effizienz der Flotte, die Standardisierung und Ausweitung der Nutzung neuester Technologien aus den Bereichen kÃÂÃÂ¼nstliche Intelligenz und maschinelles Lernen fÃÂÃÂ¼r die Planung optimierter Routen, Reduzierung des Treibstoffverbrauchs und der Kohlendioxidemissionen, die Zusammenarbeit mit der Regierung und der Industrie mit dem Ziel einer Ausweitung der VerfÃÂÃÂ¼gbarkeit und des Einsatzes nachhaltiger Flugkraftstoffe, die ÃÂÃÂ¼ber den gesamten Lebenszyklus hinweg bis zu 80 % weniger Kohlendioxidemissionen verursachen, die Erforschung und Weiterentwicklung neuartiger Antriebskonzepte auf Grundlage von Elektrifizierungstechnologien fÃÂÃÂ¼r den Regionalflugverkehr und die Investition in glaubwÃÂÃÂ¼rdige CO2-Kompensationen zur SchlieÃÂÃÂung etwaiger LÃÂÃÂ¼cken zwischen Ist und Ziel. Das Unternehmen ist bereits dabei, Emissionen durch Flottenoptimierung zu reduzieren, spart Treibstoff durch die einzigartig gestalteten Winglets seiner Flugzeuge und eine Navigationstechnologie, die die effizienteste Route ermittelt. Im Rahmen seines umfangreichen Programms fÃÂÃÂ¼r soziale und ÃÂÃÂ¶kologische Nachhaltigkeit LIFT lÃÂÃÂ¤dt Alaska Airlines seine Kunden dazu ein, ihre Meilen zu spenden und gemeinnÃÂÃÂ¼tzige Organisationen wie die Nature Conservancy und UNCF zu unterstÃÂÃÂ¼tzen, mit ÃÂÃÂThe Good TravelerÃÂÃÂ CO2-Kompensationen zu erwerben und Abfall durch Recycling an Bord (aufgrund der COVID-19-Pandemie vorÃÂÃÂ¼bergehend ausgesetzt) und durch Reisen mit wiederverwendbaren Wasserflaschen der #FillBeforeYouFly-Initiative des Unternehmens zu reduzieren. ÃÂÃÂWir bei Alaska Airlines wissen, dass Reisen das Leben der Menschen maÃÂÃÂgeblich verÃÂÃÂ¤ndern kÃÂÃÂ¶nnen, und wir haben es uns zur Aufgabe gemacht, sozial und ÃÂÃÂ¶kologisch verantwortlich zu handelnÃÂÃÂ, sagte Ben Minicucci, der CEO von Alaska Airlines. ÃÂÃÂWir befinden uns auf einer Reise, durch die wir sicherstellen wollen, dass Nachhaltigkeit ein Kernbestandteil unserer Kultur ist, und wir sind dankbar fÃÂÃÂ¼r die Partner in der Luftfahrtbranche und darÃÂÃÂ¼ber hinaus, die gemeinsam mit uns den Weg hin zur Netto-Null-RealitÃÂÃÂ¤t beschreiten. Wir mÃÂÃÂ¼ssen wirklich zusammenhalten, um das zu erreichen, und die Zusammenarbeit mit den anderen nachhaltigkeitsorientierten Unternehmen im Rahmen von ÃÂÃÂThe Climate PledgeÃÂÃÂ ist ein wichtiger Schritt.ÃÂÃÂ Colgate-Palmolive Auf der ganzen Welt entwickelt Colgate-Palmolive neue Ideen fÃÂÃÂ¼r eine gesÃÂÃÂ¼ndere Zukunft fÃÂÃÂ¼r alle Menschen, ihre Haustiere und unseren Planeten. Das Unternehmen setzt sich fÃÂÃÂ¼r den Umweltschutz ein, indem es MaÃÂÃÂnahmen zum Kampf gegen den Klimawandel vorantreibt. Eine wesentliche PrioritÃÂÃÂ¤t ist die flÃÂÃÂ¤chendeckende Nutzung erneuerbarer Energie in allen Betrieben bis 2030 durch Solaranlagen und StromabnahmevertrÃÂÃÂ¤ge. Mit bekannten Marken wie u. a. Colgate, Palmolive, Tom's of Maine und Hill's beliefert Colgate-Palmolive Milliarden von Menschen auf der ganzen Welt. Das Unternehmen hat sich dem Wachstum und einer verantwortungsvollen und nachhaltigen BetriebsfÃÂÃÂ¼hrung fÃÂÃÂ¼r seine Mitarbeiter, Kunden und die Gemeinden, in denen es tÃÂÃÂ¤tig ist, verschrieben. Es strebt regelmÃÂÃÂ¤ÃÂÃÂig nach besseren und nachhaltigeren MÃÂÃÂ¶glichkeiten zur Herstellung seiner Produkte und Verpackungen und sucht nach MÃÂÃÂ¶glichkeiten, weniger Kunststoff, Wasser und Energie bei gleichzeitiger Minimierung des Abfalls zu verbrauchen. Im Jahr 2019 stellte Colgate die erste recycelbare Zahnpastatube vor und verfolgt das Ziel, sein weltweites Produktprogramm bis 2025 umzustellen. Colgate gibt seine Technologie jetzt auch an Dritte, einschlieÃÂÃÂlich Wettbewerbern, weiter, um so fÃÂÃÂ¼r eine Umstellung aller Tuben zu sorgen. Das Unternehmen geht darÃÂÃÂ¼ber hinaus mit seiner Initiative ÃÂÃÂSave WaterÃÂÃÂ beim Wassersparen voran und fordert seine Kunden dazu auf, beim ZÃÂÃÂ¤hneputzen den Wasserhahn zu schlieÃÂÃÂen. Dadurch wurden seit 2016 bereits 155 Milliarden Gallonen Wasser und 8,3 Millionen Tonnen Treibhausgas eingespart. ÃÂÃÂColgate ist stolz darauf, sich ÃÂÃÂThe Climate PledgeÃÂÃÂ anzuschlieÃÂÃÂen, da wir wissen, dass Verantwortlichkeit, Partnerschaft und Zusammenarbeit unerlÃÂÃÂ¤sslich sind, um die nachhaltigen Umweltverbesserungen zu erreichen, die wir uns alle wÃÂÃÂ¼nschenÃÂÃÂ, sagte Prabha Parameswaran, Global President von Colgate-Palmolive. ÃÂÃÂDie Marke Colgate ist in mehr Haushalten zu finden als jede andere. Daher haben wir die auÃÂÃÂerordentliche Chance ÃÂÃÂ und Verantwortung ÃÂÃÂ angenommen, unseren ÃÂÃÂ¶kologischen FuÃÂÃÂabdruck zu reduzieren und MaÃÂÃÂnahmen gegen den Klimawandel voranzutreiben. Wir sind stolz auf die Fortschritte, die wir gemacht haben, und verpflichten uns, noch mehr zu tun, wÃÂÃÂ¤hrend unser Unternehmen sich intensiv darum bemÃÂÃÂ¼ht, eine gesÃÂÃÂ¼ndere Zukunft fÃÂÃÂ¼r alle Menschen, ihre Haustiere und unseren Planeten zu gestalten.ÃÂÃÂ HEINEKEN HEINEKEN beliefert Verbraucher auf der ganzen Welt und weiÃÂÃÂ, wie wichtig es ist, nicht nur ein profitables, sondern auch ein nachhaltiges Unternehmen zu fÃÂÃÂ¼hren. Mit der ÃÂÃÂ¼ber zehn Jahre laufenden Initiative fÃÂÃÂ¼r nachhaltige Entwicklung, ÃÂÃÂBrew a Better WorldÃÂÃÂ, stellt das Unternehmen seine Bindung an die UN-Nachhaltigkeitsziele unter Beweis und erstellt einen Fahrplan zu diesen Zielen und den darin festgelegten Vorgaben, um einen bedeutsamen und transparenten Beitrag zum Schutz des Planeten, zur Sicherung des Wohlstands und zur BekÃÂÃÂ¤mpfung der Armut zu leisten. Im Rahmen dieser Initiative hat HEINEKEN in seinen Betrieben seit 2008 bereits eine Senkung der CO2-Emissionen um 51 % und des Wasserverbrauchs um 33 % erzielt. Die NachhaltigkeitsbemÃÂÃÂ¼hungen des Unternehmens erstrecken sich ÃÂÃÂ¼ber die gesamte WertschÃÂÃÂ¶pfungskette ÃÂÃÂvon der Gerste bis zur BarÃÂÃÂ, denn es setzt sich sowohl fÃÂÃÂ¼r nachhaltige Landwirtschaft, Brauerei, Verpackung und Vertrieb als auch fÃÂÃÂ¼r einen verantwortungsvollen Konsum von Alkohol ein. ÃÂÃÂSeit ÃÂÃÂ¼ber 150 Jahren engagieren wir uns mit groÃÂÃÂer Leidenschaft dafÃÂÃÂ¼r, einen positiven Einfluss auf die Welt um uns herum zu haben. Wir wissen, dass wir nur dann erfolgreich sein kÃÂÃÂ¶nnen, wenn es unseren Mitarbeitern, dem Planeten und der Gesellschaft in unserem Umfeld gut gehtÃÂÃÂ, sagte Dolf van den Brink, der Vorsitzende und CEO von HEINEKEN. ÃÂÃÂDas bedeutet, dass wir bei jeder unserer AktivitÃÂÃÂ¤ten auf ÃÂÃÂBrew a Better WorldÃÂÃÂ fokussiert sind. Wir wissen, dass Taten mehr sagen als Worte und dass eine echte und dauerhafte VerÃÂÃÂ¤nderung nur durch gemeinsame Anstrengungen mÃÂÃÂ¶glich ist. Wir mÃÂÃÂ¼ssen ganzheitlich denken und handeln, wenn es um den positiven Einfluss von ÃÂÃÂBrew a Better WorldÃÂÃÂ auf das gesamte ÃÂÃÂkosystem von HEINEKEN geht ÃÂÃÂ einschlieÃÂÃÂlich unserer Mitarbeiter, Partner und Lieferanten, nicht staatlichen Organisationen, Regierungen, lokalen Gemeinden und anderen Interessengruppen. Durch unseren Beitritt zu ÃÂÃÂThe Climate PledgeÃÂÃÂ verstÃÂÃÂ¤rken wir unseren Einsatz fÃÂÃÂ¼r Nachhaltigkeit, und wir freuen uns, einer Gemeinschaft beizutreten, die untereinander Wissen, Ideen und Best Practices austauscht.ÃÂÃÂ PepsiCo PepsiCo mit seinem Portfolio bekannter Marken ÃÂÃÂ wie u. a. Quaker, Walkers, Gatorade, Doritos und SodaStream ÃÂÃÂ und einer breiten Palette von Lebensmittel- und GetrÃÂÃÂ¤nkeprodukten, die von Kunden auf der ganzen Welt konsumiert werden, hat sich dazu verpflichtet, seine GrÃÂÃÂ¶ÃÂÃÂe, Reichweite und Kompetenz dafÃÂÃÂ¼r zu nutzen, ein nachhaltigeres Lebensmittelsystem aufzubauen. PepsiCo stellt sich ein Lebensmittelsystem vor, das ErnÃÂÃÂ¤hrung und Genuss bietet und die wirtschaftliche und soziale Entwicklung weiter vorantreibt, ohne die natÃÂÃÂ¼rlichen Grenzen des Planeten zu ÃÂÃÂ¼berschreiten. Das Unternehmen konzentriert sich auf die FÃÂÃÂ¶rderung einer nachhaltigen Landwirtschaft, die BekÃÂÃÂ¤mpfung der Wasserunsicherheit, die Vermeidung von PlastikmÃÂÃÂ¼ll, die Entwicklung nÃÂÃÂ¤hrstoffreicherer und nachhaltigerer Produkte und die Reduzierung der Treibhausgasemissionen in seiner gesamten WertschÃÂÃÂ¶pfungskette. Im Rahmen dieser MaÃÂÃÂnahmen bemÃÂÃÂ¼ht sich PepsiCo darum, eine Welt zu schaffen, in der Verpackungen nicht zu Abfall werden. Derzeit sind 88 % der Verpackungen des Unternehmens recycelbar, kompostierbar oder biologisch abbaubar, und Ziel ist, bis 2025 eine Quote von 100 % zu erreichen. PepsiCo baut darÃÂÃÂ¼ber hinaus sein Programm ÃÂÃÂSustainable from the StartÃÂÃÂ weiter aus, eine Initiative, die die Umweltauswirkungen in jeder Phase der Produktentwicklung beleuchtet. Im Januar 2021 kÃÂÃÂ¼ndigte PepsiCo das neue auf wissenschaftlichen Erkenntnissen basierendes Ziel an, seine Kohlenstoffemissionen bis zum Jahr 2030 um mehr als 40 % zu senken (im Vergleich zum Ausgangsjahr 2015). Damit hat das Unternehmen seine bisherige Klimaschutzverpflichtung mehr als verdoppelt und sich zum Ziel gesetzt, bis 2040 Netto-Null-Emissionen zu erreichen. ÃÂÃÂPepsiCo freut sich sehr ÃÂÃÂ¼ber seinen Beitritt zu ÃÂÃÂThe Climate PledgeÃÂÃÂ, denn wir werden unsere Arbeit fÃÂÃÂ¼r ein nachhaltigeres und regenerativeres Lebensmittelsystem fortsetzenÃÂÃÂ, sagte Ramon Laguarta, der Vorsitzende und CEO von PepsiCo. ÃÂÃÂIn einer Zeit, in der sich die Welt darum ringt, sich von dem Schock einer globalen Pandemie zu erholen, sind gemeinschaftliche LÃÂÃÂ¶sungen fÃÂÃÂ¼r gemeinsame Herausforderungen unerlÃÂÃÂ¤sslich. Wir alle mÃÂÃÂ¼ssen unseren jeweiligen Beitrag leisten, aber auch zusammenstehen, um den Klimawandel zu bekÃÂÃÂ¤mpfen und bis 2040 Netto-Null-Emissionen zu erreichen.ÃÂÃÂ TelefÃÂÃÂ³nica Als einer der grÃÂÃÂ¶ÃÂÃÂten Telefonanbieter und Mobilfunknetzbetreiber der Welt hat sich TelefÃÂÃÂ³nica verpflichtet, seine eigene CO2-Bilanz zu reduzieren und gleichzeitig LÃÂÃÂ¶sungen anzubieten, die es den Kunden ermÃÂÃÂ¶glichen, ihre eigenen Emissionen zu verringern. TelefÃÂÃÂ³nica hat sich bereits dazu verpflichtet, die Emissionen seiner gesamten WertschÃÂÃÂ¶pfungskette in ÃÂÃÂbereinstimmung mit dem 1,5-Grad-Celsius-Ziel zu reduzieren. Dazu gehÃÂÃÂ¶rt die Verpflichtung, bis zum Jahr 2025 in allen Betrieben an den wichtigsten MÃÂÃÂ¤rkten (Spanien, GroÃÂÃÂbritannien, Deutschland und Brasilien) Netto-Null-Emissionen zu erreichen, wobei die Betriebe in Lateinamerika und die ÃÂÃÂ¼brige WertschÃÂÃÂ¶pfungskette bis zum Jahr 2040 Netto-Null-Emissionen erreichen sollen. Das Unternehmen setzt sich weiterhin dafÃÂÃÂ¼r ein, seine Kunden bei der Reduzierung ihrer Emissionen durch KonnektivitÃÂÃÂ¤t und seine Eco-Smart-Services zu unterstÃÂÃÂ¼tzen. Dabei handelt es sich um ein Produktsiegel, das KÃÂÃÂ¤ufern dabei hilft, Nachhaltigkeitskriterien auf einfache Weise in ihre Kaufentscheidungen einflieÃÂÃÂen zu lassen. Im vergangenen Jahr half Eco Smart den Kunden dabei, mehr als 9,5 Millionen Tonnen CO2 zu vermeiden, was als KohlenstoffÃÂÃÂ¤quivalent der Pflanzung von 158 Millionen BÃÂÃÂ¤umen entspricht. ÃÂÃÂUnsere Strategie in Bezug auf Energie und Klimawandel konzentriert sich darauf, unsere Auswirkungen zu mindern, neue Chancen zu nutzen und sich weiterzuentwickeln, um Klimarisiken zu bekÃÂÃÂ¤mpfenÃÂÃÂ, sagte Elena ValderrÃÂÃÂ¡bano, Global Director fÃÂÃÂ¼r Unternehmensethik und Nachhaltigkeit von TelefÃÂÃÂ³nica. ÃÂÃÂDurch unseren Beitritt zu ÃÂÃÂThe Climate PledgeÃÂÃÂ unterstreichen wir unser Engagement fÃÂÃÂ¼r Nachhaltigkeit und freuen uns, uns einer Gruppe anderer fÃÂÃÂ¼hrender Unternehmen anzuschlieÃÂÃÂen, fÃÂÃÂ¼r die Nachhaltigkeit an erster Stelle steht.ÃÂÃÂ Visa Als fÃÂÃÂ¼hrendes internationales Unternehmen fÃÂÃÂ¼r Zahlungstechnologien hat sich Visa verpflichtet, einen Beitrag zu einer nachhaltigeren und integrativeren Welt beizutragen und damit auch eine fÃÂÃÂ¼hrende Rolle beim weltweiten Wandel hin zu einer kohlenstoffarmen Wirtschaft zu spielen. Die Nachhaltigkeitsbilanz von Visa umfasst das Erreichen des Ziels, im Jahr 2020 komplett auf vollstÃÂÃÂ¤ndig erneuerbaren Strom umzusteigen, die Verbesserung der Nachhaltigkeit unserer BÃÂÃÂ¼ros und Rechenzentren durch Energie- und Wassereffizienz, Vermeidung von DeponieabfÃÂÃÂ¤llen und ein weltweites ÃÂÃÂGreen TeamsÃÂÃÂ-Programm fÃÂÃÂ¼r Mitarbeiter. Zur UnterstÃÂÃÂ¼tzung dieser BemÃÂÃÂ¼hungen gab Visa im Jahr 2020 eine grÃÂÃÂ¼ne Anleihe in HÃÂÃÂ¶he von 500 Millionen US-Dollar aus, die vermutlich die erste dieser Art eines digitalen Zahlungsnetzwerks ist. Visa initiiert und fÃÂÃÂ¶rdert auch weiterhin nachhaltigen Handel durch strategische Partnerschaften und Programme, die sich darauf konzentrieren, Nachhaltigkeit in Zahlungskarten und -konten zu verankern und nachhaltiges Verhalten durch seine Arbeit in den Bereichen Verkehr, Laden von Elektrofahrzeugen, Reisen und Tourismus zu unterstÃÂÃÂ¼tzen. ÃÂÃÂWir bei Visa haben uns der Nachhaltigkeit und der Schaffung einer nachhaltigeren Zukunft verschriebenÃÂÃÂ, sagte Alfred F. Kelly Jr., der Vorsitzende und CEO von Visa. ÃÂÃÂWir sind stolz darauf, ÃÂÃÂThe Climate PledgeÃÂÃÂ im Rahmen unserer Verpflichtung, bis zum Jahr 2040 Netto-Null-Emissionen zu erreichen, beizutreten, und wir freuen uns darauf, gemeinsam mit den Unterzeichnern diese wichtige Arbeit voranzutreiben.ÃÂÃÂ ÃÂÃÂber ÃÂÃÂThe Climate PledgeÃÂÃÂ Im Jahr 2019 riefen Amazon und Global Optimism gemeinsam das Klimaschutzversprechen ÃÂÃÂThe Climate PledgeÃÂÃÂ ins Leben, eine Verpflichtung, die Vorgaben des Pariser Abkommens zehn Jahre frÃÂÃÂ¼her zu erreichen und bis 2040 netto klimaneutral zu sein. Mittlerweile haben 105 Organisationen ÃÂÃÂThe Climate PledgeÃÂÃÂ unterzeichnet und damit ein wichtiges Signal gesendet, dass die Nachfrage nach Produkten und Dienstleistungen, die zur Verringerung der CO2-Emissionen beitragen, schnell wachsen wird. Weitere Informationen erhalten Sie unter www.theclimatepledge.com. ÃÂÃÂber Amazon Amazon orientiert sich an vier GrundsÃÂÃÂ¤tzen: Orientierung am Kunden statt an der Konkurrenz, Leidenschaft fÃÂÃÂ¼r Neuerungen, Einsatz fÃÂÃÂ¼r betriebliche Optimierung sowie langfristiges Denken. Kundenrezensionen, 1-Klick-EinkÃÂÃÂ¤ufe, persÃÂÃÂ¶nliche Empfehlungen, Prime, Versand durch Amazon, AWS, Kindle Direct Publishing, Kindle, Fire-Tablets, Fire TV, Amazon Echo und Alexa sind nur einige der von Amazon angebotenen Produkte und Dienstleistungen. Weitere Informationen finden Sie unter www.amazon.com/about. ÃÂÃÂber Global Optimism Global Optimism existiert, um bahnbrechende und branchenweite VerÃÂÃÂ¤nderungen herbeizufÃÂÃÂ¼hren. Das Erreichen einer emissionsfreien Zukunft ist keine weit in der Ferne liegende Herausforderung. Es ist eine, die wir jetzt in Angriff nehmen mÃÂÃÂ¼ssen. Jede wissenschaftliche Bewertung zeigt, dass wir unsere Emissionen zwischen 2020 und 2030 halbieren mÃÂÃÂ¼ssen, um das Ziel von Netto-Emissionen von Null bis 2050 zu erreichen und die globale ErwÃÂÃÂ¤rmung unter 1,5 Grad Celsius zu halten. Die BewÃÂÃÂ¤ltigung der Klimakrise ist nur mÃÂÃÂ¶glich, wenn alle ÃÂÃÂ¼berall ihren Beitrag leisten. Wir arbeiten mit gleichgesinnten Kollektiven aus allen Branchen zusammen, die bereit sind, in die erforderlichen Entscheidungen zu investieren, um sich auf diese herausfordernde ÃÂÃÂ lebensbejahende ÃÂÃÂ Reise zu begeben. Weitere Informationen finden Sie unter https://globaloptimism.com/. Die Ausgangssprache, in der der Originaltext verÃÂÃÂ¶ffentlicht wird, ist die offizielle und autorisierte Version. ÃÂÃÂbersetzungen werden zur besseren VerstÃÂÃÂ¤ndigung mitgeliefert. Nur die Sprachversion, die im Original verÃÂÃÂ¶ffentlicht wurde, ist rechtsgÃÂÃÂ¼ltig. Gleichen Sie deshalb ÃÂÃÂbersetzungen mit der originalen Sprachversion der VerÃÂÃÂ¶ffentlichung ab.",https://www.businesswire.com/news/home/20210423005526/de/,businesswire.com,5,seattlebusiness wireheute gaben amazon und global optimism bekannt das mittlerweile mehr al unternehmen climate pledge unterzeichnet haben zu den neuen unterzeichnern die sich heute climate pledge angeschlossen haben gehren bekannte marken wie alaska airline colgatepalmolive heineken pepsico telefnica und visa die unterzeichner der verpflichtung erwirtschaften insgesamt weltweit einen jahresumsatz von mehr al billionen usdollar und beschftigen mehr al fnf millionen mitarbeiter branchen lndern verdeutlicht welchen kollektiven einfluss climate pledge auf den kampf gegen den klimawandel haben kann die unterzeichner von climate pledge stimmen zu treibhausgasemissionen regelmig zu messen und darber zu berichten dekarbonisierungsstrategien im einklang mit dem bereinkommen von paris durch echte geschftliche vernderungen und innovationen umzusetzen einschlielich effizienzsteigerungen erneuerbarer energien materialreduzierungen und anderer strategien zur beseitigung von coemissionen alle verbleibenden emissionen durch zustzliche quantifizierbare reale dauerhafte und fr die gesellschaft vorteilhafte kompensationen zu neutralisieren um bi zum jahr einen jhrlichen nettokohlenstoffaussto von null zu erreichen ein jahrzehnt vor dem im bereinkommen von paris festgelegten ziel von alle unterzeichner ergreifen wissenschaftlich fundierte wirkungsvolle manahmen im kampf gegen den klimawandel indem sie innovationen u den bereichen effizienz der lieferkette nachhaltiger transport kreislaufwirtschaft saubere energielsungen entwickeln viele unternehmen binden auch ihre kunden sinnvoll ihre bemhungen um nettonullemissionen ein mit initiativen die sich auf innovative verpackungen und nachhaltiges produktdesign und entwicklung konzentrieren whrend sie gleichzeitig lsungen anbieten die die kunden befhigen ihre eigenen emissionen mithilfe von aufklrungskampagnen und nachhaltigen einkaufserlebnissen zu reduzieren vor weniger al zwei jahren war amazon mitbegrnder von climate pledge und rief andere unternehmen dazu auf da bereinkommen von paris zehn jahre frher zu erreichen mittlerweile haben mehr al unternehmen mit einem weltweiten jahresumsatz von ber billionen usdollar und mehr al millionen mitarbeitern die verpflichtung unterzeichnet sagte jeff bezos der grnder und ceo von amazon wir sind stolz darauf mit den anderen unterzeichnern einem strang zu ziehen und unsere grenvorteile zu nutzen um die wirtschaft durch echte wirtschaftliche vernderungen und innovationen zu dekarbonisieren wir haben bei der grndung von climate pledge geholfen um ein modell zu etablieren da die dekarbonisierung bei den ehrgeizigsten unternehmen beschleunigt sagte christiana figueres die frhere unklimachefin und jetzige grndungsgesellschafterin von global optimism heute sind mehr al unternehmen darunter bekannte marken und unternehmen au allen branchen climate pledge mit seinem ziel der nettonullemissionen bi beteiligt sie zeigen das eine schnellere umsetzung der dekarbonisierung ihrer unternehmen ein weg hin zum wettbewerbsvorteil ist e besteht kein zweifel das wir un einem entscheidenden wendepunkt befinden um die im bereinkommen von paris angestrebte kohlenstoffarme wirtschaft zu realisieren ich spreche den fhrungsspitzen der unternehmen die climate pledge bereits beigetreten sind meine anerkennung au und freue mich darauf die nchsten zu begren amazon und global optimism begren die neuen unterzeichner die sich climate pledge verpflichtet haben informationen ber alle neuen unterzeichner die sich climate pledge verpflichtet haben finden sie auf dem blog amazon zu den neuen unterzeichnern gehren alaska airline alaska airline fliegt mehr al ziele den usa mexiko kanada und costa rica und erreicht ber die oneworld alliance ziele auf der ganzen welt da unternehmen engagiert sich seit langem fr die menschen und die umwelt und ergreift mutige manahmen um die auswirkungen auf da klima kurz und langfristig zu reduzieren und bi nettonullemissionen zu erreichen dazu gehren die kontinuierliche verbesserung der effizienz der flotte die standardisierung und ausweitung der nutzung neuester technologien au den bereichen knstliche intelligenz und maschinelles lernen fr die planung optimierter routen reduzierung de treibstoffverbrauchs und der kohlendioxidemissionen die zusammenarbeit mit der regierung und der industrie mit dem ziel einer ausweitung der verfgbarkeit und de einsatzes nachhaltiger flugkraftstoffe die ber den gesamten lebenszyklus hinweg bi zu weniger kohlendioxidemissionen verursachen die erforschung und weiterentwicklung neuartiger antriebskonzepte auf grundlage von elektrifizierungstechnologien fr den regionalflugverkehr und die investition glaubwrdige cokompensationen zur schlieung etwaiger lcken zwischen ist und ziel da unternehmen ist bereits dabei emissionen durch flottenoptimierung zu reduzieren spart treibstoff durch die einzigartig gestalteten winglets seiner flugzeuge und eine navigationstechnologie die die effizienteste route ermittelt im rahmen seine umfangreichen programms fr soziale und kologische nachhaltigkeit lift ldt alaska airline seine kunden dazu ein ihre meilen zu spenden und gemeinntzige organisationen wie die nature conservancy und uncf zu untersttzen mit good traveler cokompensationen zu erwerben und abfall durch recycling bord aufgrund der covidpandemie vorbergehend ausgesetzt und durch reisen mit wiederverwendbaren wasserflaschen der fillbeforeyouflyinitiative de unternehmens zu reduzieren wir bei alaska airline wissen das reisen da leben der menschen mageblich verndern knnen und wir haben e un zur aufgabe gemacht sozial und kologisch verantwortlich zu handeln sagte ben minicucci der ceo von alaska airline wir befinden un auf einer reise durch die wir sicherstellen wollen das nachhaltigkeit ein kernbestandteil unserer kultur ist und wir sind dankbar fr die partner der luftfahrtbranche und darber hinaus die gemeinsam mit un den weg hin zur nettonullrealitt beschreiten wir mssen wirklich zusammenhalten um da zu erreichen und die zusammenarbeit mit den anderen nachhaltigkeitsorientierten unternehmen im rahmen von climate pledge ist ein wichtiger schritt colgatepalmolive auf der ganzen welt entwickelt colgatepalmolive neue ideen fr eine gesndere zukunft fr alle menschen ihre haustiere und unseren planeten da unternehmen setzt sich fr den umweltschutz ein indem e manahmen zum kampf gegen den klimawandel vorantreibt eine wesentliche prioritt ist die flchendeckende nutzung erneuerbarer energie allen betrieben bi durch solaranlagen und stromabnahmevertrge mit bekannten marken wie u colgate palmolive tom maine und hill beliefert colgatepalmolive milliarden von menschen auf der ganzen welt da unternehmen hat sich dem wachstum und einer verantwortungsvollen und nachhaltigen betriebsfhrung fr seine mitarbeiter kunden und die gemeinden denen e ttig ist verschrieben e strebt regelmig nach besseren und nachhaltigeren mglichkeiten zur herstellung seiner produkte und verpackungen und sucht nach mglichkeiten weniger kunststoff wasser und energie bei gleichzeitiger minimierung de abfalls zu verbrauchen im jahr stellte colgate die erste recycelbare zahnpastatube vor und verfolgt da ziel sein weltweites produktprogramm bi umzustellen colgate gibt seine technologie jetzt auch dritte einschlielich wettbewerbern weiter um fr eine umstellung aller tuben zu sorgen da unternehmen geht darber hinaus mit seiner initiative save water beim wassersparen voran und fordert seine kunden dazu auf beim zhneputzen den wasserhahn zu schlieen dadurch wurden seit bereits milliarden gallonen wasser und millionen tonnen treibhausgas eingespart colgate ist stolz darauf sich climate pledge anzuschlieen da wir wissen das verantwortlichkeit partnerschaft und zusammenarbeit unerlsslich sind um die nachhaltigen umweltverbesserungen zu erreichen die wir un alle wnschen sagte prabha parameswaran global president von colgatepalmolive die marke colgate ist mehr haushalten zu finden al jede andere daher haben wir die auerordentliche chance und verantwortung angenommen unseren kologischen fuabdruck zu reduzieren und manahmen gegen den klimawandel voranzutreiben wir sind stolz auf die fortschritte die wir gemacht haben und verpflichten un noch mehr zu tun whrend unser unternehmen sich intensiv darum bemht eine gesndere zukunft fr alle menschen ihre haustiere und unseren planeten zu gestalt heineken heineken beliefert verbraucher auf der ganzen welt und wei wie wichtig e ist nicht nur ein profitables sondern auch ein nachhaltiges unternehmen zu fhren mit der ber zehn jahre laufenden initiative fr nachhaltige entwicklung brew better world stellt da unternehmen seine bindung die unnachhaltigkeitsziele unter beweis und erstellt einen fahrplan zu diesen zielen und den darin festgelegten vorgaben um einen bedeutsamen und transparenten beitrag zum schutz de planeten zur sicherung de wohlstands und zur bekmpfung der armut zu leisten im rahmen dieser initiative hat heineken seinen betrieben seit bereits eine senkung der coemissionen um und de wasserverbrauchs um erzielt die nachhaltigkeitsbemhungen de unternehmens erstrecken sich ber die gesamte wertschpfungskette von der gerste bi zur bar denn e setzt sich sowohl fr nachhaltige landwirtschaft brauerei verpackung und vertrieb al auch fr einen verantwortungsvollen konsum von alkohol ein seit ber jahren engagieren wir un mit groer leidenschaft dafr einen positiven einfluss auf die welt um un herum zu haben wir wissen das wir nur dann erfolgreich sein knnen wenn e unseren mitarbeitern dem planeten und der gesellschaft unserem umfeld gut geht sagte dolf van den brink der vorsitzende und ceo von heineken da bedeutet das wir bei jeder unserer aktivitten auf brew better world fokussiert sind wir wissen das taten mehr sagen al worte und das eine echte und dauerhafte vernderung nur durch gemeinsame anstrengungen mglich ist wir mssen ganzheitlich denken und handeln wenn e um den positiven einfluss von brew better world auf da gesamte kosystem von heineken geht einschlielich unserer mitarbeiter partner und lieferanten nicht staatlichen organisationen regierungen lokalen gemeinden und anderen interessengruppen durch unseren beitritt zu climate pledge verstrken wir unseren einsatz fr nachhaltigkeit und wir freuen un einer gemeinschaft beizutreten die untereinander wissen ideen und best practice austauscht pepsico pepsico mit seinem portfolio bekannter marken wie u quaker walker gatorade doritos und sodastream und einer breiten palette von lebensmittel und getrnkeprodukten die von kunden auf der ganzen welt konsumiert werden hat sich dazu verpflichtet seine gre reichweite und kompetenz dafr zu nutzen ein nachhaltigeres lebensmittelsystem aufzubauen pepsico stellt sich ein lebensmittelsystem vor da ernhrung und genus bietet und die wirtschaftliche und soziale entwicklung weiter vorantreibt ohne die natrlichen grenzen de planeten zu berschreiten da unternehmen konzentriert sich auf die frderung einer nachhaltigen landwirtschaft die bekmpfung der wasserunsicherheit die vermeidung von plastikmll die entwicklung nhrstoffreicherer und nachhaltigerer produkte und die reduzierung der treibhausgasemissionen seiner gesamten wertschpfungskette im rahmen dieser manahmen bemht sich pepsico darum eine welt zu schaffen der verpackungen nicht zu abfall werden derzeit sind der verpackungen de unternehmens recycelbar kompostierbar oder biologisch abbaubar und ziel ist bi eine quote von zu erreichen pepsico baut darber hinaus sein programm sustainable start weiter au eine initiative die die umweltauswirkungen jeder phase der produktentwicklung beleuchtet im januar kndigte pepsico da neue auf wissenschaftlichen erkenntnissen basierendes ziel seine kohlenstoffemissionen bi zum jahr um mehr al zu senken im vergleich zum ausgangsjahr damit hat da unternehmen seine bisherige klimaschutzverpflichtung mehr al verdoppelt und sich zum ziel gesetzt bi nettonullemissionen zu erreichen pepsico freut sich sehr ber seinen beitritt zu climate pledge denn wir werden unsere arbeit fr ein nachhaltigeres und regenerativeres lebensmittelsystem fortsetzen sagte ramon laguarta der vorsitzende und ceo von pepsico einer zeit der sich die welt darum ringt sich von dem schock einer globalen pandemie zu erholen sind gemeinschaftliche lsungen fr gemeinsame herausforderungen unerlsslich wir alle mssen unseren jeweiligen beitrag leisten aber auch zusammenstehen um den klimawandel zu bekmpfen und bi nettonullemissionen zu erreichen telefnica al einer der grten telefonanbieter und mobilfunknetzbetreiber der welt hat sich telefnica verpflichtet seine eigene cobilanz zu reduzieren und gleichzeitig lsungen anzubieten die e den kunden ermglichen ihre eigenen emissionen zu verringern telefnica hat sich bereits dazu verpflichtet die emissionen seiner gesamten wertschpfungskette bereinstimmung mit dem gradcelsiusziel zu reduzieren dazu gehrt die verpflichtung bi zum jahr allen betrieben den wichtigsten mrkten spanien grobritannien deutschland und brasilien nettonullemissionen zu erreichen wobei die betriebe lateinamerika und die brige wertschpfungskette bi zum jahr nettonullemissionen erreichen sollen da unternehmen setzt sich weiterhin dafr ein seine kunden bei der reduzierung ihrer emissionen durch konnektivitt und seine ecosmartservices zu untersttzen dabei handelt e sich um ein produktsiegel da kufern dabei hilft nachhaltigkeitskriterien auf einfache weise ihre kaufentscheidungen einflieen zu lassen im vergangenen jahr half eco smart den kunden dabei mehr al millionen tonnen co zu vermeiden al kohlenstoffquivalent der pflanzung von millionen bumen entspricht unsere strategie bezug auf energie und klimawandel konzentriert sich darauf unsere auswirkungen zu mindern neue chancen zu nutzen und sich weiterzuentwickeln um klimarisiken zu bekmpfen sagte elena valderrbano global director fr unternehmensethik und nachhaltigkeit von telefnica durch unseren beitritt zu climate pledge unterstreichen wir unser engagement fr nachhaltigkeit und freuen un un einer gruppe anderer fhrender unternehmen anzuschlieen fr die nachhaltigkeit erster stelle steht visa al fhrendes internationale unternehmen fr zahlungstechnologien hat sich visa verpflichtet einen beitrag zu einer nachhaltigeren und integrativeren welt beizutragen und damit auch eine fhrende rolle beim weltweiten wandel hin zu einer kohlenstoffarmen wirtschaft zu spielen die nachhaltigkeitsbilanz von visa umfasst da erreichen de ziels im jahr komplett auf vollstndig erneuerbaren strom umzusteigen die verbesserung der nachhaltigkeit unserer bros und rechenzentren durch energie und wassereffizienz vermeidung von deponieabfllen und ein weltweites green teamsprogramm fr mitarbeiter zur untersttzung dieser bemhungen gab visa im jahr eine grne anleihe hhe von millionen usdollar au die vermutlich die erste dieser art eines digitalen zahlungsnetzwerks ist visa initiiert und frdert auch weiterhin nachhaltigen handel durch strategische partnerschaften und programme die sich darauf konzentrieren nachhaltigkeit zahlungskarten und konten zu verankern und nachhaltiges verhalten durch seine arbeit den bereichen verkehr laden von elektrofahrzeugen reisen und tourismus zu untersttzen wir bei visa haben un der nachhaltigkeit und der schaffung einer nachhaltigeren zukunft verschrieben sagte alfred f kelly jr der vorsitzende und ceo von visa wir sind stolz darauf climate pledge im rahmen unserer verpflichtung bi zum jahr nettonullemissionen zu erreichen beizutreten und wir freuen un darauf gemeinsam mit den unterzeichnern diese wichtige arbeit voranzutreiben ber climate pledge im jahr riefen amazon und global optimism gemeinsam da klimaschutzversprechen climate pledge in leben eine verpflichtung die vorgaben de pariser abkommens zehn jahre frher zu erreichen und bi netto klimaneutral zu sein mittlerweile haben organisationen climate pledge unterzeichnet und damit ein wichtiges signal gesendet das die nachfrage nach produkten und dienstleistungen die zur verringerung der coemissionen beitragen schnell wachsen wird weitere informationen erhalten sie unter ber amazon amazon orientiert sich vier grundstzen orientierung kunden statt der konkurrenz leidenschaft fr neuerungen einsatz fr betriebliche optimierung sowie langfristiges denken kundenrezensionen klickeinkufe persnliche empfehlungen prime versand durch amazon aws kindle direct publishing kindle firetablets fire tv amazon echo und alexa sind nur einige der von amazon angebotenen produkte und dienstleistungen weitere informationen finden sie unter ber global optimism global optimism existiert um bahnbrechende und branchenweite vernderungen herbeizufhren da erreichen einer emissionsfreien zukunft ist keine weit der ferne liegende herausforderung e ist eine die wir jetzt angriff nehmen mssen jede wissenschaftliche bewertung zeigt das wir unsere emissionen zwischen und halbieren mssen um da ziel von nettoemissionen von null bi zu erreichen und die globale erwrmung unter grad celsius zu halten die bewltigung der klimakrise ist nur mglich wenn alle berall ihren beitrag leisten wir arbeiten mit gleichgesinnten kollektiven au allen branchen zusammen die bereit sind die erforderlichen entscheidungen zu investieren um sich auf diese herausfordernde lebensbejahende reise zu begeben weitere informationen finden sie unter die ausgangssprache der der originaltext verffentlicht wird ist die offizielle und autorisierte version bersetzungen werden zur besseren verstndigung mitgeliefert nur die sprachversion die im original verffentlicht wurde ist rechtsgltig gleichen sie deshalb bersetzungen mit der originalen sprachversion der verffentlichung ab,-0.9998,-0.4999,0.1563536364,-0.656253636,Negative Impact
26/04/2021,167.4,171.42,166.55,170.45,170.45,97614000,3.3,50.56966791,1.192,0,13.66057312,0.8419472675,0.2413396506,0.07,267.054,14138.78027,16241.20996,6963.100098,6275.52002,3441.169922,48386.51172,19170.59961,159.2695599,159.482622,161.6558393,153.0979575,164.5152481,175.8530921,153.1774041,66.69370094,3.022196062,2.943874621,0.07832144062,3.340894427,165.0724945,10659452000,87.31395531,65.89883506,17.63999939,Earnings Outlook: Amazon earnings preview: Prime Day could return to summer after COVID-19 pushed it to fall last year,"Amazon.com Inc. is scheduled to report its first-quarter earnings on Thursday after the closing bell, but analysts are already looking ahead to the possible summertime return of the colossal Prime Day shopping event.",https://www.marketwatch.com/story/amazon-earnings-preview-prime-day-could-return-to-summer-after-covid-19-pushed-it-to-fall-last-year-11619464356,marketwatch.com,8,amazoncom inc scheduled report firstquarter earnings thursday closing bell analyst already looking ahead possible summertime return colossal prime day shopping event,0,0,0.251772,-0.251772,Negative Impact
27/04/2021,172.1735,173.00,169.90,170.87,170.87,76542000,3.3,50.56966791,1.192,0,13.66057312,0.8419472675,0.2413396506,0.07,267.054,14090.21973,16273.30957,6945,6273.759766,3442.610107,48944.14063,19175.09961,159.4092801,159.5369795,162.017238,153.2748087,165.3694984,175.8455155,154.8934813,63.59999952,3.116013224,2.978302342,0.1377108824,3.27671596,165.1994946,10735994000,75.11985874,73.00341606,17.55999947,"Amazon Launches Fire Tablets For Kids, Fire HD 10 Series","Amazon.Com Inc (NASDAQ: AMZN) introduced the all-new Fire Kids Pro tablets for kids aged six and twelve and the next generation Fire HD 10 Kids tablet for kids aged three and seven. Fire Kids Pro is a reasonably priced kids tablet, including a full-featured Fire tablet, a one-year subscription to Amazon Kids+ with an expanded selection of content for older kids, a slim protective case, and a two-year guarantee.",https://www.benzinga.com/news/21/04/20815634/amazon-launches-fire-tablets-for-kids-fire-hd-10-series,benzinga.com,5,amazoncom inc nasdaq amzn introduced allnew fire kid pro tablet kid aged six twelve next generation fire hd kid tablet kid aged three seven fire kid pro reasonably priced kid tablet including fullfeatured fire tablet oneyear subscription amazon kid expanded selection content older kid slim protective case twoyear guarantee,-0.7096,-0.3548,0.2426696429,-0.597469643,Negative Impact
28/04/2021,171.74,174.49,171.25,172.93,172.93,92638000,3.3,50.56966791,1.192,0,13.66057312,0.8419472675,0.2413396506,0.07,267.054,14051.03027,16322.12988,6963.700195,6306.97998,3457.070068,49733.83984,19357,159.5988303,159.6256046,162.4449935,153.470333,166.3775238,175.5446871,157.2103605,65.05693249,3.317818328,3.046205539,0.2716127892,3.374358041,165.5115148,10828632000,84.38649743,82.27343716,17.28000069,Should You Buy Amazon Before the First-Quarter Earnings Report?,The e-commerce giant has a habit of beating revenue forecasts.,https://www.fool.com/investing/2021/04/28/should-buy-amazon-before-first-quarter-earnings/,fool.com,7,ecommerce giant habit beating revenue forecast,-0.4588,-0.32116,0.2169817391,-0.538141739,Negative Impact
29/04/2021,175.255,175.72,171.75,173.57,173.57,153648000,3.3,50.56966791,1.192,0,13.66057312,0.8419472675,0.2413396506,0.07,267.054,14082.5498,16376,6961.5,6302.569824,3474.899902,49765.94141,19255.90039,159.7615002,159.7224321,162.881092,153.670285,167.3205994,175.2250707,159.416128,60.57579334,3.489212096,3.134806851,0.3544052453,3.360608782,166.0504642,10982280000,79.74651806,79.75095808,17.61000061,AWS kÃÂÃÂ¼ndigt die allgemeine VerfÃÂÃÂ¼gbarkeit von Amazon Nimble Studio an,"SEATTLE--(BUSINESS WIRE)--Heute hat Amazon Web Services, Inc. (AWS), ein Unternehmen von Amazon.com, Inc. (NASDAQ: AMZN), die allgemeine VerfÃÂÃÂ¼gbarkeit von Amazon Nimble Studio bekannt gegeben, einem neuen Dienst, mit dem Kunden ein Studio fÃÂÃÂ¼r die Produktion von Inhalten in Stunden statt Wochen einrichten kÃÂÃÂ¶nnen und dessen ElastizitÃÂÃÂ¤t ihnen eine nahezu unbegrenzte Skalierbarkeit und den Zugriff auf BildsynthesemÃÂÃÂ¶glichkeiten nach Bedarf gewÃÂÃÂ¤hrt. Mit Amazon Nimble Studio kÃÂÃÂ¶nnen Kunden schnell KÃÂÃÂ¼nstler von ÃÂÃÂ¼berall auf der Welt einbeziehen und mit ihnen zusammenarbeiten und Inhalte schneller und kostengÃÂÃÂ¼nstiger produzieren. KÃÂÃÂ¼nstler haben Zugriff auf beschleunigte virtuelle Workstations, Hochgeschwindigkeitsspeicher und skalierbares Rendering in der globalen Infrastruktur von AWS, damit sie Inhalte schneller erstellen kÃÂÃÂ¶nnen. FÃÂÃÂ¼r die Nutzung von Amazon Nimble Studio fallen keine VorabgebÃÂÃÂ¼hren oder Verbindlichkeiten an, und Kunden zahlen nur fÃÂÃÂ¼r die zugrunde liegenden verwendeten AWS-Services. Um loszulegen, besuchen Sie bitte die folgende Website: https://aws.amazon.com/nimble-studio/ Um hochwertige visuelle Effekte, Animationen und kreative Inhalte zum Leben zu erwecken, haben sich Studios in der Vergangenheit auf hochleistungsfÃÂÃÂ¤hige lokale Workstations verlassen, die ÃÂÃÂ¼ber lokale Netzwerke mit geringer Latenz mit gemeinsam genutzten Dateispeichersystemen verbunden sind. Der gestiegene Appetit der Verbraucher auf Premium-Inhalte und -Erlebnisse hat zu einer hÃÂÃÂ¶heren Nachfrage nach rechenintensivem Rendern von visuellen Effekten und Animationen gefÃÂÃÂ¼hrt. Diese stetig wachsende Nachfrage fÃÂÃÂ¼hrt dazu, dass Content-Produktionsstudios ihre Rechen-, Netzwerk- und Speicherinfrastruktur fÃÂÃÂ¼r SpitzenkapazitÃÂÃÂ¤ten ausrÃÂÃÂ¼sten, was sich als teuer, schwierig zu verwalten und schwer skalierbar erweist. Beispielsweise generiert ein typischer animierter Spielfilm jetzt 730 Terabyte Daten und bis zu einer halben Milliarde Dateien. Dies erfordert mehr als 150 Millionen Rechenstunden und die Koordination von Hunderten von KÃÂÃÂ¼nstlern und Technikern. Die Nachfrage der Verbraucher nach mehr Inhalten hat auch dazu gefÃÂÃÂ¼hrt, dass Studios Talente aus der ganzen Welt einbeziehen mÃÂÃÂ¼ssen, die dann leistungsstarke Workstations, spezielle Software sowie Hochgeschwindigkeitsspeicher und -netzwerke benÃÂÃÂ¶tigen. All diese EinschrÃÂÃÂ¤nkungen kÃÂÃÂ¶nnen zu ProduktionsverzÃÂÃÂ¶gerungen, erhÃÂÃÂ¶hten Kosten und verpassten MÃÂÃÂ¶glichkeiten fÃÂÃÂ¼r Content-Produktionsstudios fÃÂÃÂ¼hren. Mit Amazon Nimble Studio kÃÂÃÂ¶nnen Kunden in nur wenigen Stunden ein neues Studio fÃÂÃÂ¼r die Produktion von Inhalten erstellen. Kreativschaffende haben dann sofort Zugriff auf hochleistungsfÃÂÃÂ¤hige Workstations, die von G4dn-Instanzen der Elastic Compute Cloud (EC2) von Amazon mit NVIDIA-Grafikprozessoren (GPUs), gemeinsam genutztem Dateispeicher von Amazon FSx und Streaming mit extrem geringer Latenz ÃÂÃÂ¼ber das globale AWS-Netzwerk unterstÃÂÃÂ¼tzt werden. Amazon Nimble Studio bietet Content-Produktionsstudios die MÃÂÃÂ¶glichkeit, mit so wenig Ressourcen wie nÃÂÃÂ¶tig zu beginnen, diese Ressourcen zu skalieren, wenn die Anforderungen an die Bildsynthese am hÃÂÃÂ¶chsten sind, und sie nach Abschluss der Projekte wieder herunterzufahren. Content-Produktionsstudios kÃÂÃÂ¶nnen Telearbeiter aus der ganzen Welt einbinden und ihnen nur so lange wie nÃÂÃÂ¶tig Zugriff auf genau die richtige Menge an Hochleistungsinfrastruktur bieten ÃÂÃÂ alles, ohne lokale Workstations, Dateisysteme und Netzwerke mit geringer Latenz beschaffen, einrichten und verwalten zu mÃÂÃÂ¼ssen. Amazon Nimble Studio unterstÃÂÃÂ¼tzt sowohl Windows- als auch Linux-Betriebssysteme, sodass KÃÂÃÂ¼nstler mit ihren bevorzugten kreativen Anwendungen von Drittanbietern arbeiten kÃÂÃÂ¶nnen. DarÃÂÃÂ¼ber hinaus kÃÂÃÂ¶nnen Studios benutzerdefinierte Softwareanwendungen verwenden und diese ÃÂÃÂ¼ber Amazon Machine Images (AMIs) in Amazon Nimble Studio einbinden, um eine nahtlose Migration von der lokalen zur Cloud-Infrastruktur zu gewÃÂÃÂ¤hrleisten. Amazon Nimble Studio ist die neueste AWS-LÃÂÃÂ¶sung fÃÂÃÂ¼r Medien- und Unterhaltungskunden. Sie ist Teil der AWS-Anwendung Thinkbox Deadline fÃÂÃÂ¼r Bildsynthese-Management als Kernfunktion zur UnterstÃÂÃÂ¼tzung der Inhaltsproduktion. FÃÂÃÂ¼hrende Medien- und Unterhaltungsunternehmen wie Discovery, Disney, EuroSport, Formel 1, FOX, HBO Max, Peacock und Weta Digital verwenden speziell entwickelte AWS-LÃÂÃÂ¶sungen, mit denen Content-Ersteller, Rechteinhaber, Produzenten und Distributoren die Neuerfindung in fÃÂÃÂ¼nf wichtigen GeschÃÂÃÂ¤ftsbereichen der Branche beschleunigen kÃÂÃÂ¶nnen: Content-Produktion, Direct-to-Consumer- und Over-the-Top-Streaming (OTT), Rundfunk, Medienlieferkette und -archiv sowie Datenwissenschaft und Analytik. ÃÂÃÂAmazon Nimble Studio wird die Art und Weise ÃÂÃÂ¤ndern, wie Kunden Inhalte mithilfe einer cloudbasierten Produktionspipeline produzierenÃÂÃÂ, sagte Kyle Roche, Head of Content Production Tech bei AWS. ÃÂÃÂBis heute haben die Studios Schwierigkeiten, mit der stÃÂÃÂ¤ndig steigenden Nachfrage nach kreativen Inhalten Schritt zu halten, was zu einem exponentiellen Anstieg der fÃÂÃÂ¼r die Erstellung von Inhalten erforderlichen Rechenleistung gefÃÂÃÂ¼hrt hat ÃÂÃÂ dies beschleunigt die Veralterung von Workstations und belastet die Speicher- und Rendering-KapazitÃÂÃÂ¤t vor Ort. Wir freuen uns, Ihnen Amazon Nimble Studio vorstellen zu kÃÂÃÂ¶nnen, einen revolutionÃÂÃÂ¤ren neuen Service fÃÂÃÂ¼r Kreativschaffende, der fÃÂÃÂ¼r die Cloud entwickelt wurde, um die Produktion der Inhalte, welche die Verbraucher sehen mÃÂÃÂ¶chten, viel schneller, einfacher und kostengÃÂÃÂ¼nstiger zu gestalten.ÃÂÃÂ Amazon Nimble Studio ist ab sofort in sechs AWS-Regionen und lokalen AWS-Zonen verfÃÂÃÂ¼gbar: Region US-Ost (N. Virginia), Region US-West (Oregon), Region Kanada (Central), Region Europa (London), Region Asien-Pazifik (Sydney) und lokale US-Zone (Los Angeles). Weitere Regionen kommen in KÃÂÃÂ¼rze hinzu. Anjekumi verbindet Spieler und ermÃÂÃÂ¶glicht ihnen, Spiele von ÃÂÃÂ¼berall auf der Welt mit GerÃÂÃÂ¤ten der nÃÂÃÂ¤chsten Generation zu spielen. ÃÂÃÂMit Amazon Nimble Studio kÃÂÃÂ¶nnen wir uns eher auf das kreative Ergebnis als auf den technischen Weg konzentrieren, da es einige wesentliche Probleme in unserer Produktionspipeline lÃÂÃÂ¶stÃÂÃÂ, sagte Kurt Rauer, CEO von Anjekumi. ÃÂÃÂUnser GeschÃÂÃÂ¤ft ist global, und mit Amazon Nimble Studio kÃÂÃÂ¶nnen wir kreative Menschen weltweit ohne die damit verbundenen Reibungen einbeziehen.ÃÂÃÂ Die California State University ist ein staatliches UniversitÃÂÃÂ¤tssystem in Kalifornien mit 23 Standorten. ÃÂÃÂAls grÃÂÃÂ¶ÃÂÃÂtes ÃÂÃÂ¶ffentliches Hochschulsystem des Landes ist das System der California State University stolz darauf, eine innovative Denkweise in der Medien- und Unterhaltungsbildung zu haben, die eine vielfÃÂÃÂ¤ltige, aus einer Minderheitsmehrheit bestehende Studentenschaft befÃÂÃÂ¤higtÃÂÃÂ, sagte Dina Ibrahim, Executive Director der San Francisco State University. ÃÂÃÂAWS ist ein perfekter Partner, um einen Weg nach vorne fÃÂÃÂ¼r unsere kreativen Programme darzustellen, da wir in naher Zukunft mehr von unseren Bildungserlebnissen in die Cloud verlagern mÃÂÃÂ¶chten. DarÃÂÃÂ¼ber hinaus bieten LÃÂÃÂ¶sungen wie Amazon Nimble Studio unseren Studierenden einen einfacheren, praktischen Zugriff auf die neuesten technischen Instrumente fÃÂÃÂ¼r Content-Creation, wodurch sie sich besser fÃÂÃÂ¼r eine erfolgreiche Karriere aufstellen kÃÂÃÂ¶nnen.ÃÂÃÂ Evil Eye Pictures ist ein mit Oscar- und Emmy-Preisen ausgezeichnetes Animations-, Effekt- und Designstudio mit Sitz in der kalifornischen Metropole San Francisco. ÃÂÃÂWir gehen gerne ÃÂÃÂ¼ber das Traditionelle hinaus und setzen auf neue Technologien, die innovatives Storytelling unterstÃÂÃÂ¼tzenÃÂÃÂ, sagte Dan Rosen, MitbegrÃÂÃÂ¼nder und Executive Creative Director von Evil Eye Pictures. ÃÂÃÂDurch die Aufnahme von Amazon Nimble Studio in unser Arsenal kÃÂÃÂ¶nnen wir Projekte einfacher skalieren und mit den besten Talenten zusammenarbeiten, unabhÃÂÃÂ¤ngig davon, wo sie sich befinden.ÃÂÃÂ Shomen Productions ist ein virtuelles Animations- und VFX-Studio, das einen globalen Talentpool nutzt, um Markeninhalte zu erstellen. ÃÂÃÂWir glauben, dass die Zukunft der Produktion aus verstreuten Teams und agilen Studios besteht. Der geografische Zugang zu einem bereitgestellten Talentpool ist kein Hindernis mehr fÃÂÃÂ¼r die KreativitÃÂÃÂ¤tÃÂÃÂ, sagte James Bennett, GrÃÂÃÂ¼nder und Direktor von VFX & Animation bei Shomen Productions. ÃÂÃÂMit einer ProduktionslÃÂÃÂ¶sung wie Amazon Nimble Studio kann Ihr Team Produktionsressourcen nach Belieben skalieren und ÃÂÃÂ¼ber groÃÂÃÂe Entfernungen hinweg effizient zusammenarbeiten. Die FÃÂÃÂ¤higkeit, so einfach aus der Ferne mit Kreativschaffenden zusammenzuarbeiten, die auf der ganzen Welt verteilt sind, als ob sie neben Ihnen sitzen wÃÂÃÂ¼rden, hat enorme Anziehungskraft. Wir glauben, dass Amazon Nimble Studio fÃÂÃÂ¼r die kreative Produktion genauso wichtig sein wird wie iTunes fÃÂÃÂ¼r die Musikindustrie.ÃÂÃÂ Sinking Ship Entertainment ist ein mit mehreren Emmy-Preisen ausgezeichnetes Produktions- und New-Media-Unternehmen mit Sitz in Toronto. ÃÂÃÂWir haben die Entwicklung von Amazon Nimble Studio mit Spannung verfolgt und freuen uns darauf, diese LÃÂÃÂ¶sung in unseren Workflow aufzunehmenÃÂÃÂ, sagte Shervin Shahidi, Direktor des Bereichs Digital Transformation bei Sinking Ship Entertainment. ÃÂÃÂSie wird unseren FÃÂÃÂ¤higkeiten dynamische ElastizitÃÂÃÂ¤t verleihen und es uns ermÃÂÃÂ¶glichen, unseren Talentpool auf KÃÂÃÂ¼nstler weltweit auszudehnen.ÃÂÃÂ Spire Animation Studios ist ein neues Studio fÃÂÃÂ¼r Animationen in SpielfilmlÃÂÃÂ¤nge. ÃÂÃÂSpire Animation wurde gegrÃÂÃÂ¼ndet, um kreative und technische Talente von Weltklasse in die Lage zu versetzen, vielfÃÂÃÂ¤ltige animierte High-End-Unterhaltung fÃÂÃÂ¼r ein globales Publikum zu entwickelnÃÂÃÂ, sagte Brad Lewis, MitbegrÃÂÃÂ¼nder und Chief Creative Officer von Spire Animation Studios. ÃÂÃÂDurch die Nutzung von Technologien der nÃÂÃÂ¤chsten Generation wie Amazon Nimble Studio und Echtzeit-Spiel-Engines ÃÂÃÂ¼berdenken wir den Prozess der Inhaltsproduktion, auch wenn unsere KÃÂÃÂ¼nstler nicht am selben Ort ansÃÂÃÂ¤ssig sind.ÃÂÃÂ Heute kÃÂÃÂ¼ndigte AWS auch AWS for Media & Entertainment an, eine Initiative, die es Branchenkunden erleichtert, speziell entwickelte AWS-Funktionen und PartnerlÃÂÃÂ¶sungen fÃÂÃÂ¼r ihre Workloads mit hÃÂÃÂ¶chster PrioritÃÂÃÂ¤t zu entdecken, zu implementieren und bereitzustellen. Dies ermÃÂÃÂ¶glicht es ihnen, ÃÂÃÂ¼berzeugende Inhalte schneller zu erstellen, neue Kundenerlebnisse zu erfinden, Angebote direkt an den Verbraucher zu erweitern und die Effizienz der Medienversorgungskette zu verbessern. AWS for Media & Entertainment richtet die breitesten und tiefsten branchenspezifischen Cloud-Funktionen aus, einschlieÃÂÃÂlich speziell entwickelter Medien- und Kreativdienste, Hardware, LÃÂÃÂ¶sungen, Tools und Partner. AWS for Media & Entertainment richtet auÃÂÃÂerdem dedizierte Ressourcen in jedem BranchenlÃÂÃÂ¶sungsbereich ein, um Kunden dabei zu helfen, die WertschÃÂÃÂ¶pfungszeit zu verkÃÂÃÂ¼rzen, indem AWS-interne Ressourcen, AWS Professional Services und mehr als 400 branchenspezifische ISV-Partner (Independent Software Vendor) sowie mehr als 100 Systemintegratoren (SI) aufeinander abgestimmt werden. Weitere Informationen finden Sie hier: https://aws.amazon.com/blogs/media/announcing-aws-for-media-and-entertainment/ ÃÂÃÂber Amazon Web Services Seit 15 Jahren ist Amazon Web Services die umfassendste und am weitesten verbreitete Cloud-Plattform der Welt. AWS hat seine Services kontinuierlich erweitert, um nahezu jeden Cloud-Workload zu unterstÃÂÃÂ¼tzen, und verfÃÂÃÂ¼gt jetzt ÃÂÃÂ¼ber mehr als 200 voll ausgestattete Services fÃÂÃÂ¼r Computing, Speicher, Datenbanken, Networking, Analytik, maschinelles Lernen und kÃÂÃÂ¼nstliche Intelligenz (KI), Internet der Dinge (Internet of Things, IoT), mobile Technologien, Sicherheit, hybride Technologien, virtuelle und erweiterte RealitÃÂÃÂ¤t (VR und AR), Medien sowie Anwendungsentwicklung, -bereitstellung und -management in 80 VerfÃÂÃÂ¼gbarkeitszonen (Availability Zones, AZ) innerhalb von 25 geografischen Regionen, mit angekÃÂÃÂ¼ndigten PlÃÂÃÂ¤nen fÃÂÃÂ¼r 15 weitere VerfÃÂÃÂ¼gbarkeitszonen und fÃÂÃÂ¼nf weitere AWS-Regionen in Australien, Indien, Indonesien, Spanien und der Schweiz. Millionen von Kunden ÃÂÃÂ darunter die wachstumsstÃÂÃÂ¤rksten Start-ups, die grÃÂÃÂ¶ÃÂÃÂten Konzerne und fÃÂÃÂ¼hrende RegierungsbehÃÂÃÂ¶rden ÃÂÃÂ verlassen sich auf AWS, um ihre Infrastruktur anzutreiben, agiler zu werden und Kosten zu senken. Mehr Informationen zu AWS erhalten Sie unter aws.amazon.com. ÃÂÃÂber Amazon Amazon orientiert sich an vier GrundsÃÂÃÂ¤tzen: Orientierung am Kunden statt an der Konkurrenz, Leidenschaft fÃÂÃÂ¼r Neuerungen, Einsatz fÃÂÃÂ¼r betriebliche Optimierung sowie langfristiges Denken. Kundenrezensionen, 1-Klick-EinkÃÂÃÂ¤ufe, persÃÂÃÂ¶nliche Empfehlungen, Prime, Versand durch Amazon, AWS, Kindle Direct Publishing, Kindle, Fire-Tablets, Fire TV, Amazon Echo und Alexa sind nur einige der von Amazon angebotenen Produkte und Dienstleistungen. Weitere Informationen finden Sie unter www.amazon.com/about und folgen Sie @AmazonNews. Die Ausgangssprache, in der der Originaltext verÃÂÃÂ¶ffentlicht wird, ist die offizielle und autorisierte Version. ÃÂÃÂbersetzungen werden zur besseren VerstÃÂÃÂ¤ndigung mitgeliefert. Nur die Sprachversion, die im Original verÃÂÃÂ¶ffentlicht wurde, ist rechtsgÃÂÃÂ¼ltig. Gleichen Sie deshalb ÃÂÃÂbersetzungen mit der originalen Sprachversion der VerÃÂÃÂ¶ffentlichung ab.",https://www.businesswire.com/news/home/20210429006213/de/,businesswire.com,5,seattlebusiness wireheute hat amazon web service inc aws ein unternehmen von amazoncom inc nasdaq amzn die allgemeine verfgbarkeit von amazon nimble studio bekannt gegeben einem neuen dienst mit dem kunden ein studio fr die produktion von inhalten stunden statt wochen einrichten knnen und dessen elastizitt ihnen eine nahezu unbegrenzte skalierbarkeit und den zugriff auf bildsynthesemglichkeiten nach bedarf gewhrt mit amazon nimble studio knnen kunden schnell knstler von berall auf der welt einbeziehen und mit ihnen zusammenarbeiten und inhalte schneller und kostengnstiger produzieren knstler haben zugriff auf beschleunigte virtuelle workstation hochgeschwindigkeitsspeicher und skalierbares rendering der globalen infrastruktur von aws damit sie inhalte schneller erstellen knnen fr die nutzung von amazon nimble studio fallen keine vorabgebhren oder verbindlichkeiten und kunden zahlen nur fr die zugrunde liegenden verwendeten awsservices um loszulegen besuchen sie bitte die folgende website um hochwertige visuelle effekte animationen und kreative inhalte zum leben zu erwecken haben sich studio der vergangenheit auf hochleistungsfhige lokale workstation verlassen die ber lokale netzwerke mit geringer latenz mit gemeinsam genutzten dateispeichersystemen verbunden sind der gestiegene appetit der verbraucher auf premiuminhalte und erlebnisse hat zu einer hheren nachfrage nach rechenintensivem rendern von visuellen effekten und animationen gefhrt diese stetig wachsende nachfrage fhrt dazu das contentproduktionsstudios ihre rechen netzwerk und speicherinfrastruktur fr spitzenkapazitten ausrsten sich al teuer schwierig zu verwalten und schwer skalierbar erweist beispielsweise generiert ein typischer animierter spielfilm jetzt terabyte daten und bi zu einer halben milliarde dateien dy erfordert mehr al millionen rechenstunden und die koordination von hunderten von knstlern und technikern die nachfrage der verbraucher nach mehr inhalten hat auch dazu gefhrt das studio talente au der ganzen welt einbeziehen mssen die dann leistungsstarke workstation spezielle software sowie hochgeschwindigkeitsspeicher und netzwerke bentigen diese einschrnkungen knnen zu produktionsverzgerungen erhhten kosten und verpassten mglichkeiten fr contentproduktionsstudios fhren mit amazon nimble studio knnen kunden nur wenigen stunden ein neues studio fr die produktion von inhalten erstellen kreativschaffende haben dann sofort zugriff auf hochleistungsfhige workstation die von gdninstanzen der elastic compute cloud ec von amazon mit nvidiagrafikprozessoren gpus gemeinsam genutztem dateispeicher von amazon fsx und streaming mit extrem geringer latenz ber da globale awsnetzwerk untersttzt werden amazon nimble studio bietet contentproduktionsstudios die mglichkeit mit wenig ressourcen wie ntig zu beginnen diese ressourcen zu skalieren wenn die anforderungen die bildsynthese hchsten sind und sie nach abschluss der projekte wieder herunterzufahren contentproduktionsstudios knnen telearbeiter au der ganzen welt einbinden und ihnen nur lange wie ntig zugriff auf genau die richtige menge hochleistungsinfrastruktur bieten alles ohne lokale workstation dateisysteme und netzwerke mit geringer latenz beschaffen einrichten und verwalten zu mssen amazon nimble studio untersttzt sowohl window al auch linuxbetriebssysteme sodass knstler mit ihren bevorzugten kreativen anwendungen von drittanbietern arbeiten knnen darber hinaus knnen studio benutzerdefinierte softwareanwendungen verwenden und diese ber amazon machine image amis amazon nimble studio einbinden um eine nahtlose migration von der lokalen zur cloudinfrastruktur zu gewhrleisten amazon nimble studio ist die neueste awslsung fr medien und unterhaltungskunden sie ist teil der awsanwendung thinkbox deadline fr bildsynthesemanagement al kernfunktion zur untersttzung der inhaltsproduktion fhrende medien und unterhaltungsunternehmen wie discovery disney eurosport formel fox hbo max peacock und weta digital verwenden speziell entwickelte awslsungen mit denen contentersteller rechteinhaber produzenten und distributoren die neuerfindung fnf wichtigen geschftsbereichen der branche beschleunigen knnen contentproduktion directtoconsumer und overthetopstreaming ott rundfunk medienlieferkette und archiv sowie datenwissenschaft und analytik amazon nimble studio wird die art und weise ndern wie kunden inhalte mithilfe einer cloudbasierten produktionspipeline produzieren sagte kyle roche head content production tech bei aws bi heute haben die studio schwierigkeiten mit der stndig steigenden nachfrage nach kreativen inhalten schritt zu halten zu einem exponentiellen anstieg der fr die erstellung von inhalten erforderlichen rechenleistung gefhrt hat dy beschleunigt die veralterung von workstation und belastet die speicher und renderingkapazitt vor ort wir freuen un ihnen amazon nimble studio vorstellen zu knnen einen revolutionren neuen service fr kreativschaffende der fr die cloud entwickelt wurde um die produktion der inhalte welche die verbraucher sehen mchten viel schneller einfacher und kostengnstiger zu gestalt amazon nimble studio ist ab sofort sechs awsregionen und lokalen awszonen verfgbar region usost n virginia region uswest oregon region kanada central region europa london region asienpazifik sydney und lokale uszone los angeles weitere regionen kommen krze hinzu anjekumi verbindet spieler und ermglicht ihnen spiele von berall auf der welt mit gerten der nchsten generation zu spielen mit amazon nimble studio knnen wir un eher auf da kreative ergebnis al auf den technischen weg konzentrieren da e einige wesentliche probleme unserer produktionspipeline lst sagte kurt rauer ceo von anjekumi unser geschft ist global und mit amazon nimble studio knnen wir kreative menschen weltweit ohne die damit verbundenen reibungen einbeziehen die california state university ist ein staatliches universittssystem kalifornien mit standorten al grtes ffentliches hochschulsystem de landes ist da system der california state university stolz darauf eine innovative denkweise der medien und unterhaltungsbildung zu haben die eine vielfltige au einer minderheitsmehrheit bestehende studentenschaft befhigt sagte dina ibrahim executive director der san francisco state university aws ist ein perfekter partner um einen weg nach vorne fr unsere kreativen programme darzustellen da wir naher zukunft mehr von unseren bildungserlebnissen die cloud verlagern mchten darber hinaus bieten lsungen wie amazon nimble studio unseren studierenden einen einfacheren praktischen zugriff auf die neuesten technischen instrumente fr contentcreation wodurch sie sich besser fr eine erfolgreiche karriere aufstellen knnen evil eye picture ist ein mit oscar und emmypreisen ausgezeichnetes animation effekt und designstudio mit sitz der kalifornischen metropole san francisco wir gehen gerne ber da traditionelle hinaus und setzen auf neue technologien die innovatives storytelling untersttzen sagte dan rosen mitbegrnder und executive creative director von evil eye picture durch die aufnahme von amazon nimble studio unser arsenal knnen wir projekte einfacher skalieren und mit den besten talenten zusammenarbeiten unabhngig davon wo sie sich befinden shomen production ist ein virtuelles animation und vfxstudio da einen globalen talentpool nutzt um markeninhalte zu erstellen wir glauben das die zukunft der produktion au verstreuten team und agilen studio besteht der geografische zugang zu einem bereitgestellten talentpool ist kein hindernis mehr fr die kreativitt sagte james bennett grnder und direktor von vfx animation bei shomen production mit einer produktionslsung wie amazon nimble studio kann ihr team produktionsressourcen nach belieben skalieren und ber groe entfernungen hinweg effizient zusammenarbeiten die fhigkeit einfach au der ferne mit kreativschaffenden zusammenzuarbeiten die auf der ganzen welt verteilt sind al ob sie neben ihnen sitzen wrden hat enorme anziehungskraft wir glauben das amazon nimble studio fr die kreative produktion genauso wichtig sein wird wie itunes fr die musikindustrie sinking ship entertainment ist ein mit mehreren emmypreisen ausgezeichnetes produktions und newmediaunternehmen mit sitz toronto wir haben die entwicklung von amazon nimble studio mit spannung verfolgt und freuen un darauf diese lsung unseren workflow aufzunehmen sagte shervin shahidi direktor de bereichs digital transformation bei sinking ship entertainment sie wird unseren fhigkeiten dynamische elastizitt verleihen und e un ermglichen unseren talentpool auf knstler weltweit auszudehnen spire animation studio ist ein neues studio fr animationen spielfilmlnge spire animation wurde gegrndet um kreative und technische talente von weltklasse die lage zu versetzen vielfltige animierte highendunterhaltung fr ein globales publikum zu entwickeln sagte brad lewis mitbegrnder und chief creative officer von spire animation studio durch die nutzung von technologien der nchsten generation wie amazon nimble studio und echtzeitspielengines berdenken wir den prozess der inhaltsproduktion auch wenn unsere knstler nicht selben ort ansssig sind heute kndigte aws auch aws medium entertainment eine initiative die e branchenkunden erleichtert speziell entwickelte awsfunktionen und partnerlsungen fr ihre workload mit hchster prioritt zu entdecken zu implementieren und bereitzustellen dy ermglicht e ihnen berzeugende inhalte schneller zu erstellen neue kundenerlebnisse zu erfinden angebote direkt den verbraucher zu erweitern und die effizienz der medienversorgungskette zu verbessern aws medium entertainment richtet die breitesten und tiefsten branchenspezifischen cloudfunktionen au einschlielich speziell entwickelter medien und kreativdienste hardware lsungen tool und partner aws medium entertainment richtet auerdem dedizierte ressourcen jedem branchenlsungsbereich ein um kunden dabei zu helfen die wertschpfungszeit zu verkrzen indem awsinterne ressourcen aws professional service und mehr al branchenspezifische isvpartner independent software vendor sowie mehr al systemintegratoren si aufeinander abgestimmt werden weitere informationen finden sie hier ber amazon web service seit jahren ist amazon web service die umfassendste und weitesten verbreitete cloudplattform der welt aws hat seine service kontinuierlich erweitert um nahezu jeden cloudworkload zu untersttzen und verfgt jetzt ber mehr al voll ausgestattete service fr computing speicher datenbanken networking analytik maschinelles lernen und knstliche intelligenz ki internet der dinge internet thing iot mobile technologien sicherheit hybride technologien virtuelle und erweiterte realitt vr und ar medien sowie anwendungsentwicklung bereitstellung und management verfgbarkeitszonen availability zone az innerhalb von geografischen regionen mit angekndigten plnen fr weitere verfgbarkeitszonen und fnf weitere awsregionen australien indien indonesien spanien und der schweiz millionen von kunden darunter die wachstumsstrksten startup die grten konzerne und fhrende regierungsbehrden verlassen sich auf aws um ihre infrastruktur anzutreiben agiler zu werden und kosten zu senken mehr informationen zu aws erhalten sie unter awsamazoncom ber amazon amazon orientiert sich vier grundstzen orientierung kunden statt der konkurrenz leidenschaft fr neuerungen einsatz fr betriebliche optimierung sowie langfristiges denken kundenrezensionen klickeinkufe persnliche empfehlungen prime versand durch amazon aws kindle direct publishing kindle firetablets fire tv amazon echo und alexa sind nur einige der von amazon angebotenen produkte und dienstleistungen weitere informationen finden sie unter und folgen sie amazonnews die ausgangssprache der der originaltext verffentlicht wird ist die offizielle und autorisierte version bersetzungen werden zur besseren verstndigung mitgeliefert nur die sprachversion die im original verffentlicht wurde ist rechtsgltig gleichen sie deshalb bersetzungen mit der originalen sprachversion der verffentlichung ab,-0.9995,-0.49975,0.1610088372,-0.660758837,Negative Impact
30/04/2021,176.256,177.70,173.13,173.37,173.37,140186000,3.3,50.56966791,1.192,0,13.66057312,0.8419472675,0.2413396506,0.07,267.054,13962.67969,16219.33008,6969.799805,6269.47998,3446.860107,48782.35938,19108.30078,159.9006903,159.8370696,163.292461,153.8663121,168.0866493,175.1310191,161.0422796,59.4600941,3.56821589,3.221488658,0.3467272314,3.530644008,166.8242273,10842094000,65.71772786,76.61691445,18.61000061,The tech giants showed how dominant they are this week,The nature of technology platforms turns the law of large numb on its head.,https://www.cnbc.com/2021/04/30/tech-giants-q1-earnings-showed-dominance-amzn-aapl-googl-fb-msft.html,cnbc.com,9,nature technology platform turn law large numb head,-0.34,-0.306,0.2591162069,-0.565116207,Negative Impact
03/05/2021,174.2365,174.33,168.64,169.32,169.32,117510000,3.3,50.56966791,1.192,0,13.66057312,0.8419472675,0.2413396506,0.06,269.195,13895.12012,16325.24023,6969.799805,6307.899902,3446.860107,48718.51953,19213.19922,160.0372803,159.9337171,163.5290113,154.0201248,168.4860489,174.7853773,162.1867204,48.71476714,3.266651598,3.230521246,0.03613035195,3.749715533,167.9118043,10724584000,33.67252488,59.71225694,18.30999947,4 Stocks to Watch As E-commerce Leads Digital Payments Boom,"Digital payments seem poised to continue its good run, thanks to the rising preference for e-commerce, making it wise to look at names like Apple (AAPL), Amazon (AMZN) and PayPal (PYPL)",https://www.zacks.com/stock/news/1493024/4-stocks-to-watch-as-e-commerce-leads-digital-payments-boom,zacks.com,8,digital payment seem poised continue good run thanks rising preference ecommerce making wise look name like apple aapl amazon amzn paypal pypl,0.9201,0.73608,0.2363536842,0.4997263158,Positive Impact
04/05/2021,167.8095,168.40,163.61,165.59,165.59,108788000,3.3,50.56966791,1.192,0,13.66057312,0.8419472675,0.2413396506,0.06,269.195,13633.5,16289.26953,6923.200195,6251.75,3446.860107,48253.51172,19188,160.1684103,160.0211922,163.6099719,154.1352828,168.7061745,174.1866122,163.2257368,48.01862841,2.695527844,3.123522566,-0.427994722,3.879107884,177.6999969,10615796000,14.09870392,37.82965222,19.47999954,Investing in This ETF Right Now Could Make You a Millionaire Retiree,Your long-term portfolio needs a forward-thinking approach.,https://www.fool.com/investing/2021/05/04/investing-in-this-etf-right-now-could-make-you-a-m/,fool.com,7,longterm portfolio need forwardthinking approach,0,0,0.2755942857,-0.275594286,Negative Impact
05/05/2021,166.943,167.74,163.22,163.53,163.53,74226000,3.3,50.56966791,1.192,0,13.66057312,0.8419472675,0.2413396506,0.06,269.195,13582.41992,16348.41016,7039.299805,6339.470215,3446.860107,48677.55078,19310.69922,160.2444501,160.0396172,163.6067178,154.2287327,168.6840492,174.2479406,163.1201579,39.729399,2.052497902,2.909317633,-0.856819731,3.973178319,177.4181271,10541570000,2.133618237,16.63494901,19.14999962,Jim Cramer says investors must resist the urge to give up on 'FAANG' stocks,"""They're currently out of favor in the Wall Street fashion show. I'm telling you it's temporary,"" the ""Mad Money"" host said about Big Tech stocks.",https://www.cnbc.com/2021/05/05/jim-cramer-advises-investors-not-to-give-up-on-faang-stocks.html,cnbc.com,9,theyre currently favor wall street fashion show im telling temporary mad money host said big tech stock,-0.128,-0.1152,0.1824035714,-0.297603571,Negative Impact
06/05/2021,163.5,165.72,162.36,165.32,165.32,88954000,3.3,50.56966791,1.192,0,13.66057312,0.8419472675,0.2413396506,0.06,269.195,13632.83984,16459.59961,7076.200195,6357.089844,3441.280029,48949.76172,19291,160.39129,160.0816371,163.6738464,154.3390786,168.7017242,174.217912,163.1855365,41.44467535,1.668221217,2.66109835,-0.992877133,4.030285427,176.8501221,10630524000,19.28615906,11.83949374,18.38999939,Amazon delays Prime Day in India and Canada as Covid ravages both countries,"Prime Day, which typically takes place in July, was postponed to mid-October last year in the U.S. and elsewhere due to the pandemic.",https://www.cnbc.com/2021/05/06/amazon-delays-prime-day-in-india-and-canada-because-of-covid-19.html,cnbc.com,9,prime day typically take place july postponed midoctober last year u elsewhere due pandemic,-0.2023,-0.18207,0.16553,-0.3476,Negative Impact
07/05/2021,165.9545,166.54,164.45,164.58,164.58,94206000,3.3,50.56966791,1.192,0,13.66057312,0.8419472675,0.2413396506,0.06,269.195,13752.24023,16590.42969,7129.700195,6385.509766,3418.870117,48949.76172,19472.69922,160.6257401,160.1295621,163.7094017,154.4409833,168.5002495,174.3167187,162.6837802,42.43310965,1.289267569,2.386732194,-1.097464625,3.909034729,175.9807149,10536318000,14.47526265,11.96501332,16.69000053,Amazon pauses annual Prime Day sale in India due to COVID-19,"Amazon.com Inc has paused its annual Prime Day sale in India, a company spokeswoman said on Friday, as the country battles a severe second wave of coronavirus infections that has left thousands dead.",https://www.reuters.com/article/us-amazon-prime-day-india/amazon-pauses-annual-prime-day-sale-in-india-due-to-covid-19-idUSKBN2CO1CY,reuters.com,10,amazoncom inc paused annual prime day sale india company spokeswoman said friday country battle severe second wave coronavirus infection left thousand dead,-0.8591,-0.8591,0.1974431579,-1.056543158,Negative Impact
10/05/2021,164.116,164.15,159.50,159.52,159.52,116772000,3.3,50.56966791,1.192,0,13.66057312,0.8419472675,0.2413396506,0.06,269.195,13401.86035,16516.83008,7123.700195,6385.990234,3427.98999,49502.41016,19361.90039,160.7233002,160.1805472,163.5452881,154.4915656,168.0279999,175.0853907,160.9706091,37.88359778,0.5743464389,2.024255043,-1.449908604,4.032677787,175.163472,10419546000,0.1346462601,11.29868932,19.65999985,Amazon Blocked 10 Billion Listings Last Year Amid Rising Concerns Over Counterfeits,The company says it seized more than 2 million counterfeit products and destroyed them.,https://www.forbes.com/sites/tommybeer/2021/05/10/amazon-blocked-10-billion-listings-last-year-amid-rising-concerns-over-counterfeits/,forbes.com,8,company say seized million counterfeit product destroyed,-0.4939,-0.39512,0.1773935714,-0.572513571,Negative Impact
11/05/2021,156.814,161.90,156.37,161.20,161.20,92396000,3.3,50.56966791,1.192,0,13.66057312,0.8419472675,0.2413396506,0.06,269.195,13389.42969,16355.62012,6948,6267.390137,3441.850098,49161.80859,19274,160.8010699,160.2342972,163.4531394,154.5582714,167.5877747,175.2035547,159.9719946,38.51285048,0.1409761347,1.647599261,-1.506623126,4.216891697,173.9103942,10511942000,22.62849066,12.41279986,21.84000015,Amazon Announces Lawsuit to Combat Fraudulent Affiliate Marketing Schemes,SEATTLE--(BUSINESS WIRE)--Amazon files federal lawsuit against several yet-to-be-named individuals for operating an illegal text messaging advertising scheme.,https://www.businesswire.com/news/home/20210511006213/en/Amazon-Announces-Lawsuit-to-Combat-Fraudulent-Affiliate-Marketing-Schemes/,businesswire.com,5,seattlebusiness wireamazon file federal lawsuit several yettobenamed individual operating illegal text messaging advertising scheme,-0.6705,-0.33525,0.1032083333,-0.438458333,Negative Impact
12/05/2021,159.25,160.40,156.66,157.60,157.60,98728000,3.3,50.56966791,1.192,0,13.66057312,0.8419472675,0.2413396506,0.06,269.195,13031.67969,16042.96973,7004.600098,6279.350098,3462.75,48690.80078,19107.80078,160.8584799,160.2584797,163.2234868,154.5885075,167.135125,175.9649644,158.3052855,37.33351377,-0.487225038,1.220634401,-1.70785944,4.286141532,172.1562048,10413214000,5.759091146,9.507409355,27.59000015,EU court scraps Amazon's $303 million EU tax order,"Europe's second-top court on Thursday annulled an EU order to Amazon to pay about 250 million euros ($303.28 million) in back taxes to Luxembourg, part of an EU crackdown against unfair tax deals between multinationals and EU countries.",https://www.reuters.com/article/us-eu-amazon-taxavoidance/eu-court-scraps-amazons-303-million-eu-tax-order-idUSKBN2CT12G,reuters.com,10,europe secondtop court thursday annulled eu order amazon pay million euro million back tax luxembourg part eu crackdown unfair tax deal multinationals eu country,-0.4215,-0.4215,0.1343922222,-0.555892222,Negative Impact
13/05/2021,159.2735,160.19,156.65,158.07,158.07,67018000,3.3,50.56966791,1.192,0,13.66057312,0.8419472675,0.2413396506,0.06,269.195,13124.99023,16181.62988,6963.299805,6288.330078,3429.540039,48690.80078,19135.80078,161.01495,160.2987647,163.0215266,154.6231841,166.5910751,176.2507788,156.9313715,34.99488762,-0.93584151,0.789339219,-1.725180729,4.301642282,170.5774343,10480232000,7.992884023,12.12682194,23.12999916,Inverse ETFs to Play the Decline in Tech Sector,The technology sector is witnessing weakness since the start of the week amid intensifying fears of increasing inflation and rising interest rates.,https://www.zacks.com/stock/news/1547506/inverse-etfs-to-play-the-decline-in-tech-sector,zacks.com,8,technology sector witnessing weakness since start week amid intensifying fear increasing inflation rising interest rate,-0.4588,-0.36704,0.2512495652,-0.618289565,Negative Impact
14/05/2021,159.278,161.44,159.15,161.15,161.15,66500000,3.3,50.56966791,1.192,0,13.66057312,0.8419472675,0.2413396506,0.06,269.195,13429.98047,16415.35938,7043.600098,6385.140137,3490.379883,48732.55078,19366.69922,161.2602802,160.3461073,162.9479375,154.6880778,166.1497253,175.9643776,156.3350731,34.25924396,-1.031636633,0.4251440486,-1.456780682,4.194069999,169.1565408,10546732000,22.39179216,12.04792244,18.80999947,"Chase Offers can get you cash back with Dunkin', AT&T, and Amazon Music Unlimited just for having a credit card ÃÂÃÂ these are some of the best deals available now","If you don't have a Chase credit card yet, here are some of the best options available right now that earn flexible Chase Ultimate Rewards points, which you can redeem for cash back, travel, gift cards, and more: Chase Sapphire PreferredÃÂÃÂ® Card ÃÂÃÂ One of the best all-around travel cards, because it earns 2x points on travel and dining and a high sign-up bonus and offers valuable travel coverage like primary rental car insurance, all for a $95 annual fee (here's our Chase Sapphire Preferred Card review). Chase Sapphire ReserveÃÂÃÂ® ÃÂÃÂ The big sibling to the Preferred has a higher annual fee of $550, but offers 3x points on travel (after receiving the $300 travel credit) and dining and up to a $300 credit toward travel purchases each year (read our Chase Sapphire Reserve card review). Chase Freedom UnlimitedÃÂÃÂ® ÃÂÃÂ It's a great pick for college students and others who are new to credit cards. There's no annual fee, and you can use the Chase Ultimate Rewards points you'll earn for cash back, gift cards, travel, and more (find out more in our Chase Freedom Unlimited card review). Ink Business PreferredÃÂÃÂ® Credit Card ÃÂÃÂ This business credit card earns bonus points on a wide variety of spending categories and offers a high sign-up bonus and other perks like primary rental car insurance and cell phone protection, with a $95 annual fee (read our Ink Business Preferred card review for details). Chase Offers frequently asked questions What are Chase Offers? Chase Offers are deals available to select Chase credit and debit cardholders. These offers get you cash back at a variety of merchants, including retail stores, services, and restaurants.",https://www.businessinsider.com/personal-finance/best-chase-offers-available-now,businessinsider.com,7,dont chase credit card yet best option available right earn flexible chase ultimate reward point redeem cash back travel gift card chase sapphire preferred card one best allaround travel card earns x point travel dining high signup bonus offer valuable travel coverage like primary rental car insurance annual fee here chase sapphire preferred card review chase sapphire reserve big sibling preferred higher annual fee offer x point travel receiving travel credit dining credit toward travel purchase year read chase sapphire reserve card review chase freedom unlimited great pick college student others new credit card there annual fee use chase ultimate reward point youll earn cash back gift card travel find chase freedom unlimited card review ink business preferred credit card business credit card earns bonus point wide variety spending category offer high signup bonus perk like primary rental car insurance cell phone protection annual fee read ink business preferred card review detail chase offer frequently asked question chase offer chase offer deal available select chase credit debit cardholder offer get cash back variety merchant including retail store service restaurant,0.9919,0.69433,0.2498641667,0.4444658333,Positive Impact
17/05/2021,162.2965,164.64,161.73,163.52,163.52,74478000,3.3,50.56966791,1.192,0,13.66057312,0.8419472675,0.2413396506,0.06,269.195,13379.0498,16422.96094,7032.899902,6367.350098,3517.620117,49580.73047,19474.69922,161.5302103,160.4007348,162.9703518,154.7759527,165.8956757,175.7062621,156.0850892,38.33385229,-0.905514729,0.1590122931,-1.064527022,4.222140721,167.8777367,10621210000,33.52320239,21.30262619,19.71999931,Amazon goes after alleged fraudulent text message advertising schemes in new lawsuit,"Amazon doesn't know exactly who is using its name in an allegedly fraudulent text message advertising scheme, but the company is suing them anyway.",https://www.geekwire.com/2021/amazon-goes-alleged-fraudulent-text-message-advertising-schemes-new-lawsuit/,geekwire.com,5,amazon doesnt know exactly using name allegedly fraudulent text message advertising scheme company suing anyway,-0.5574,-0.2787,0.2330634615,-0.511763462,Negative Impact
18/05/2021,164.629,165.60,161.52,161.61,161.61,56568000,3.3,50.56966791,1.192,0,13.66057312,0.8419472675,0.2413396506,0.06,269.195,13303.63965,16337.73047,7034.200195,6353.669922,3529.01001,50193.32813,19507.09961,161.8105402,160.4176348,162.9171614,154.8439929,165.6396507,175.6237886,155.6555128,31.96702249,-0.948387898,-0.062467745,-0.885920153,4.254927499,166.726813,10564642000,24.59039143,26.83512866,21.34000015,Amazon aims to cut its workplace injury rate by half,"Amazon, which has faced criticism for above-industry-average injury rates at its warehouses, said it is taking steps to halve the rate of workplace injuries in them by 2025.",https://techxplore.com/news/2021-05-amazon-aims-workplace-injury.html,techxplore.com,5,amazon faced criticism aboveindustryaverage injury rate warehouse said taking step halve rate workplace injury,-0.7783,-0.38915,0.21449,-0.60364,Negative Impact
19/05/2021,159.75,161.74,159.20,161.59,161.59,53594000,3.3,50.56966791,1.192,0,13.66057312,0.8419472675,0.2413396506,0.06,269.195,13299.74023,16233.32031,6950.200195,6262.549805,3510.959961,49902.64063,19417,161.9794901,160.4476123,162.8651158,154.9111173,165.3141006,175.3845484,155.2436529,30.52477571,-0.973084844,-0.244591165,-0.728493679,4.152427673,165.6909817,10511048000,24.47787202,27.53048861,22.18000031,Amazon to extend ban on police use of face recognition tech,"Amazon said Tuesday it is extending its ban on the use of its facial recognition tools for law enforcement, amid persistent concerns of bias in the technology.",https://techxplore.com/news/2021-05-amazon-police-recognition-tech.html,techxplore.com,5,amazon said tuesday extending ban use facial recognition tool law enforcement amid persistent concern bias technology,-0.5106,-0.2553,0.1594171429,-0.414717143,Negative Impact
20/05/2021,162.22,162.98,161.81,162.38,162.38,52664000,3.3,50.56966791,1.192,0,13.66057312,0.8419472675,0.2413396506,0.06,269.195,13535.74023,16350.4502,7019.799805,6343.580078,3506.939941,49564.85938,19543,162.16953,160.4748248,162.8462486,154.9854744,165.160701,175.3154192,155.0059827,32.47408026,-0.918005479,-0.379274028,-0.538731451,3.925213405,165.6000061,10563712000,33.48642517,27.51822954,20.67000008,Top 5 1st-Quarter Trades of Steve Mandel's Lone Pine,"Lone Pine Capital, the hedge fund founded by Steve Mandel (Trades, Portfolio) in 1997, disclosed its first-quarter portfolio earlier this week.",https://www.gurufocus.com/news/1434889/top-5-1stquarter-trades-of-steve-mandels-lone-pine,gurufocus.com,5,lone pine capital hedge fund founded steve mandel trade portfolio disclosed firstquarter portfolio earlier week,-0.2732,-0.1366,0.255244,-0.391844,Negative Impact
21/05/2021,162.5,162.83,159.85,160.15,160.15,82098000,3.3,50.56966791,1.192,0,13.66057312,0.8419472675,0.2413396506,0.06,269.195,13470.99023,16375,7018.100098,6386.410156,3486.560059,50540.48047,19527.30078,162.2590201,160.4743374,162.7406705,155.0369026,164.816201,175.1674886,154.4649135,34.47179822,-1.042281927,-0.511875608,-0.530406319,3.731391907,164.6768555,10481614000,31.46591141,29.81006953,20.14999962,FTC Warns Amazon To Crack Down On Fake Reviews,"Amazon banned sellers of Chinese electronics brands earlier this month following a database leak that apparently connected some of these companies to fake reviews, which the world's largest retailer says it forbids. But a report from Recode on Thursday (May 20) says internal communications obtained by the news service show at least one of these [ÃÂÃÂ]",https://www.pymnts.com/amazon/2021/ftc-warns-amazon-to-crack-down-on-fake-reviews/,pymnts.com,5,amazon banned seller chinese electronics brand earlier month following database leak apparently connected company fake review world largest retailer say forbids report recode thursday may say internal communication obtained news service show least one,-0.8442,-0.4221,0.212581,-0.634681,Negative Impact
24/05/2021,160.775,162.90,160.53,162.25,162.25,48456000,3.3,50.56966791,1.192,0,13.66057312,0.8419472675,0.2413396506,0.06,269.195,13661.16992,16464.68945,7051.600098,6408.490234,3497.280029,50651.89844,19527.30078,162.41452,160.4793349,162.7214087,155.1086697,164.406176,174.463322,154.34903,44.00564553,-0.960610102,-0.601622506,-0.358987595,3.518928528,163.8460199,10530070000,51.73972869,38.89735509,18.39999962,"Mutual funds have near-record-low exposure to elite FAAMG stocks ÃÂÃÂ and that's actually helping their performance this year (FB, AMZN, AAPL, MSFT, GS)","Mutual funds this year have had near-record-low exposure to Facebook, Amazon, Apple, Microsoft, and Alphabet's Google compared to 2020, a factor that has resulted in higher returns so far in 2021. In general, mutual funds were underweight FAAMG by 555 basis points at the beginning of the second quarter of 2021 ÃÂÃÂ five basis points lower than last quarter's all-time-low, according to a May 21 portfolio research strategy report by Goldman Sachs.",https://www.businessinsider.com/faamg-stocks-mutual-funds-facebook-amazon-apple-microsoft-alphabet-2021-5,businessinsider.com,7,mutual fund year nearrecordlow exposure facebook amazon apple microsoft alphabet google compared factor resulted higher return far general mutual fund underweight faamg basis point beginning second quarter five basis point lower last quarter alltimelow according may portfolio research strategy report goldman sachs,-0.128,-0.0896,0.1579055556,-0.247505556,Negative Impact
25/05/2021,163.3335,163.99,160.69,162.95,162.95,65222000,3.3,50.56966791,1.192,0,13.66057312,0.8419472675,0.2413396506,0.06,269.195,13657.16992,16390.18945,7029.799805,6390.27002,3581.340088,50637.53125,19564.09961,162.59189,160.5022324,162.7304711,155.1867177,164.0102257,173.6087073,154.411744,48.91725468,-0.829595075,-0.64721702,-0.182378055,3.43221392,156.3684998,10595292000,64.70128686,49.30230899,18.84000015,"Deep Dive: Amazon and Facebook as defensive plays? Yes, along with these other stocks that are cash-flow winners","Among the largest U.S. companies, Amazon and Facebook have grown their cash flow rapidly, which helps investors play it safe.",https://www.marketwatch.com/story/amazon-and-facebook-as-defensive-plays-yes-along-with-these-other-stocks-that-are-cash-flow-winners-11621954848,marketwatch.com,8,among largest u company amazon facebook grown cash flow rapidly help investor play safe,0.8271,0.66168,0.1041267857,0.5575532143,Positive Impact
26/05/2021,163.7295,164.79,162.93,163.26,163.26,47680000,3.3,50.56966791,1.192,0,13.66057312,0.8419472675,0.2413396506,0.06,269.195,13738,16451.96094,7026.899902,6391.600098,3593.360107,51017.51953,19745.5,162.7651898,160.5314823,162.7511584,155.267029,163.5268753,172.1602449,154.8935058,45.88615134,-0.693123831,-0.656398382,-0.036725449,3.325141907,156.5209497,10642972000,67.70341314,61.38147623,17.36000061,Retail ETFs in Focus Post Q1 Earnings,"Total earnings from 64.7% of the sector's total market capitalization reported so far are up 61.2% on 12.7% higher revenues, with 90.9% beating EPS estimates and 81.8% beating top-line estimates.",https://www.zacks.com/stock/news/1609287/retail-etfs-in-focus-post-q1-earnings,zacks.com,8,total earnings sector total market capitalization reported far higher revenue beating eps estimate beating topline estimate,-0.7184,-0.57472,0.2314475472,-0.806167547,Negative Impact
27/05/2021,162.8,163.02,161.50,161.51,161.51,51224000,3.3,50.56966791,1.192,0,13.66057312,0.8419472675,0.2413396506,0.06,269.195,13736.28027,16531.94922,7019.700195,6435.709961,3608.850098,51115.21875,19774.40039,162.8595697,160.5688423,162.7023087,155.3291032,162.9238747,170.1798162,155.6679331,44.09967349,-0.718103834,-0.668739473,-0.049364361,3.301213946,156.8515717,10591748000,55.64631832,62.68367277,16.73999977,AWS erÃÂÃÂ¶ffnet Datenzentren in den VAE,"SEATTLE (USA)--(BUSINESS WIRE)--Amazon Web Services (AWS), ein Unternehmen von Amazon.com (NASDAQ: AMZN), gab heute bekannt, dass es plant, im ersten Halbjahr 2022 eine Infrastrukturregion in den Vereinigten Arabischen Emiraten (VAE) zu erÃÂÃÂ¶ffnen. Die neue Region AWS Middle East (VAE) wird aus drei VerfÃÂÃÂ¼gbarkeitszonen bestehen und mit der bestehenden AWS-Region in Bahrain die zweite Region von AWS im Nahen Osten sein. Dadurch erhalten Kunden mehr Auswahl und FlexibilitÃÂÃÂ¤t, um fortschrittliche Technologien aus der weltweit fÃÂÃÂ¼hrenden Cloud zu nutzen. Weltweit verfÃÂÃÂ¼gt AWS ÃÂÃÂ¼ber 80 VerfÃÂÃÂ¼gbarkeitszonen in 25 geografischen Regionen. Es ist geplant, 18 weitere VerfÃÂÃÂ¼gbarkeitszonen und sechs weitere AWS-Regionen in Australien, Indien, Indonesien, Spanien, der Schweiz und den Vereinigten Arabischen Emiraten einzurichten. Weitere Informationen zur weltweiten AWS Infrastruktur erhalten Sie unter: https://aws.amazon.com/about-aws/global-infrastructure/. ÃÂÃÂWir freuen uns, auf der groÃÂÃÂen Dynamik der Cloud-EinfÃÂÃÂ¼hrung im Nahen Osten aufzubauen, indem wir Kunden in den VAE mehr AuswahlmÃÂÃÂ¶glichkeiten bieten, um Anwendungen auszufÃÂÃÂ¼hren und Daten lokal zu speichernÃÂÃÂ, sagte Peter DeSantis, Senior Vice President of Global Infrastructure bei AWS. ÃÂÃÂDie neue AWS-Region unterstÃÂÃÂ¼tzt den Fokus der VAE auf die FÃÂÃÂ¶rderung von technologischen Innovationen, die sie zu einem florierenden globalen Zentrum fÃÂÃÂ¼r Unternehmer, E-Government und multinationale Unternehmen gemacht haben. Mit der neuen Region kÃÂÃÂ¶nnen Unternehmen jeder GrÃÂÃÂ¶ÃÂÃÂe schneller innovieren und Endbenutzer mit noch geringerer Latenz in der gesamten Region bedienen.ÃÂÃÂ Seine Exzellenz Mohammed Ali Al Shorafa, Vorsitzender der Abteilung fÃÂÃÂ¼r wirtschaftliche Entwicklung in Abu Dhabi, sagte: ÃÂÃÂDie Expansion von AWS in die VAE ist ein Beweis fÃÂÃÂ¼r unser schnell wachsendes InnovationsÃÂÃÂ¶kosystem, das vom Zugang zur weltweit fÃÂÃÂ¼hrenden Cloud-Plattform und ihren fortschrittlichen Technologien und LÃÂÃÂ¶sungen profitieren wird. Aufbauend auf der intelligenten Infrastruktur und der digitalen Transformation von Abu Dhabi wird die Investition von AWS Innovatoren und Unternehmen mit global relevanten LÃÂÃÂ¶sungen in die Lage versetzen, neue MÃÂÃÂ¶glichkeiten in den VAE und darÃÂÃÂ¼ber hinaus zu realisieren.ÃÂÃÂ AWS-Regionen bestehen aus VerfÃÂÃÂ¼gbarkeitszonen, in denen die Infrastruktur an getrennten und unterschiedlichen geografischen Standorten mit ausreichender Entfernung platziert wird, um das Risiko zu reduzieren, dass ein einzelnes Ereignis die GeschÃÂÃÂ¤ftskontinuitÃÂÃÂ¤t beeintrÃÂÃÂ¤chtigt, jedoch nah genug sind, um geringe Latenzzeiten fÃÂÃÂ¼r hochverfÃÂÃÂ¼gbare Anwendungen zu bieten. Jede VerfÃÂÃÂ¼gbarkeitszone verfÃÂÃÂ¼gt ÃÂÃÂ¼ber eine unabhÃÂÃÂ¤ngige Stromversorgung, KÃÂÃÂ¼hlung und physische Sicherheit. Die Zonen sind ÃÂÃÂ¼ber redundante Netzwerke mit ultra-geringer Latenz miteinander verbunden. AWS-Kunden, die sich auf HochverfÃÂÃÂ¼gbarkeit konzentrieren, kÃÂÃÂ¶nnen ihre Anwendungen so gestalten, dass sie in mehreren VerfÃÂÃÂ¼gbarkeitszonen und in mehreren Regionen ausgefÃÂÃÂ¼hrt werden, um eine noch grÃÂÃÂ¶ÃÂÃÂere Fehlertoleranz zu erzielen. Durch die HinzufÃÂÃÂ¼gung der Region AWS Middle East (VAE) kÃÂÃÂ¶nnen lokale Kunden mit Datenresidenzanforderungen ihre Daten in den VAE speichern und gleichzeitig die Latenz im ganzen Land noch verringern. Unternehmen, die diese Region nutzen, kÃÂÃÂ¶nnen auch auf fortschrittliche Technologien aus der breitesten und tiefsten Suite von Cloud-Diensten zugreifen, um Innovationen voranzutreiben, darunter Computer, Speicher, Netzwerk, Datenbank, Analyse, maschinelles Lernen, Internet der Dinge (IoT), mobile Dienste und mehr. Seine Exzellenz Dr. Tariq Bin Hendi, Generaldirektor des Abu Dhabi Investment Office (ADIO), sagte: ÃÂÃÂWir begrÃÂÃÂ¼ÃÂÃÂen die kommende AWS-Region, die den Vereinigten Arabischen Emiraten eine fortschrittliche Cloud-Infrastruktur bringen wird. Dies steht im Einklang mit unserem Ziel, Investitionen anzuziehen, die die technologischen FÃÂÃÂ¤higkeiten steigern. Dies ist ein weiteres Beispiel fÃÂÃÂ¼r die wachsende Partnerschaft zwischen dem ÃÂÃÂ¶ffentlichen und dem privaten Sektor im Emirat, die darauf abzielt, DurchbrÃÂÃÂ¼che zu beschleunigen und die groÃÂÃÂ angelegte digitale Transformation voranzutreiben und Abu Dhabis Position als globale Drehscheibe fÃÂÃÂ¼r Innovation zu stÃÂÃÂ¤rken. Wir freuen uns auf die Zusammenarbeit mit AWS in der gesamten wissensbasierten Wirtschaft, einschlieÃÂÃÂlich Bildungsinitiativen, Cloud-Skills-Training und Startup-Enablement-Programmen.ÃÂÃÂ Kunden und AWS-Partner begrÃÂÃÂ¼ÃÂÃÂen die Neuigkeiten aus der Region AWS Middle East (VAE) Millionen aktiver Kunden nutzen AWS jeden Monat in ÃÂÃÂ¼ber 190 LÃÂÃÂ¤ndern weltweit, darunter Zehntausende von Kunden im Nahen Osten und in Nordafrika (Middle East and North Africa, MENA). Unternehmen entscheiden sich fÃÂÃÂ¼r AWS, um agiler und innovativer zu werden. Dazu gehÃÂÃÂ¶ren die Al Tayer Group, Aramex, AXA Gulf, Axiom Telecom, Emirates NBD, Flydubai, Gulf News, die MBC Group, OSN, die Seera Group, Virgin Middle East und viele mehr. MENA-Organisationen des ÃÂÃÂ¶ffentlichen Sektors nutzen AWS, um Kosteneinsparungen zu erzielen, Innovationen zu beschleunigen und den BÃÂÃÂ¼rgern der Region einen besseren Service zu bieten. Dazu gehÃÂÃÂ¶ren die RegulierungsbehÃÂÃÂ¶rde fÃÂÃÂ¼r Kommunikation und Informationstechnologie in Kuwait (Communications and Information Technology Regulatory Authority, CITRA), die Dubai Expo 2020, das ÃÂÃÂ¤gyptische Ministerium fÃÂÃÂ¼r Kommunikation und Informationstechnologie, die Regierung der bahrainischen Ministerien, die Hamdan Bin Mohammed Smart University, die UniversitÃÂÃÂ¤t von Bahrain und viele mehr. Zu den MENA-Start-ups, die ihre GeschÃÂÃÂ¤fte auf AWS aufbauen, um schnell zu skalieren und weltweit zu expandieren, gehÃÂÃÂ¶ren Alef Education, Anghami, Careem, Dubizzle, EKar, Fetchr, Haraj, Health at Hand, Maestro Pizza, Mawdoo3.com, Property Finder, Sarwa, Souqalmal, StarzPlay und Yallacompare. AWS-Kunden begrÃÂÃÂ¼ÃÂÃÂten die Neuigkeiten der AWS-Region in den Vereinigten Arabischen Emiraten, einschlieÃÂÃÂlich globaler Kunden, die die Region nutzen kÃÂÃÂ¶nnen, um neue Zielgruppen zu bedienen, wie z. B. Salesforce, der globale MarktfÃÂÃÂ¼hrer fÃÂÃÂ¼r Kundenbeziehungsmanagement (customer relationship management, CRM). ÃÂÃÂSalesforce ermÃÂÃÂ¶glicht digitale Transformationen fÃÂÃÂ¼r unseren globalen Kundenstamm, die die modernen Unternehmensfunktionen von AWS erfordernÃÂÃÂ, sagte Srinivas Tallapragada, President und Chief Engineering Officer von Salesforce. ÃÂÃÂWir freuen uns, mit Amazon zusammenzuarbeiten und unsere vertrauenswÃÂÃÂ¼rdige Plattform in neue MÃÂÃÂ¤rkte zu bringen, damit Kunden von ÃÂÃÂ¼berall aus erfolgreich sein kÃÂÃÂ¶nnen, indem sie Hyperforce und alle Vorteile des ÃÂÃÂ¶ffentlichen Cloud-Computings nutzen.ÃÂÃÂ Die First Abu Dhabi Bank (FAB) ist die grÃÂÃÂ¶ÃÂÃÂte Bank der VAE mit einer Bilanzsumme von 955 Mrd. AED (260 Mrd. USD) und einem der stÃÂÃÂ¤rksten Ratings aller Banken im Nahen Osten und in Nordafrika. ÃÂÃÂUnser Cloud-Ansatz ist seit Anfang letzten Jahres eines der Grundprinzipien unserer Technologiestrategie. Wir haben AWS Outposts sowohl fÃÂÃÂ¼r Entwicklungs- als auch fÃÂÃÂ¼r Test- und Produktions-Workloads verwendetÃÂÃÂ, sagte Yuri Misnik, Chief Technology Officer von FAB. ÃÂÃÂDies hat unsere digitale Transformation in der Cloud und vor Ort beschleunigt und die MarkteinfÃÂÃÂ¼hrungszeit um 50 % verkÃÂÃÂ¼rzt. Wir haben auch festgestellt, dass die ProduktivitÃÂÃÂ¤t von Entwicklern und Infrastrukturteams um 60 % gesteigert wurde, indem dieselbe Infrastruktur, dieselben Services, APIs und Tools in der Cloud und vor Ort eingesetzt wurden. Wir begrÃÂÃÂ¼ÃÂÃÂen die bevorstehende AWS-Region in den VAE, die uns dabei helfen wird, unsere Cloud-Ambitionen effektiv und sicher zu verwirklichen und gleichzeitig die lokalen Vorschriften vollstÃÂÃÂ¤ndig einzuhalten.ÃÂÃÂ Im Februar startete das Mohammed Bin Rashid Space Center (MBRSC) erfolgreich die Hope Probe, die erste interplanetare Mission fÃÂÃÂ¼r die VAE. AWS unterstÃÂÃÂ¼tzt die Datenreise der Mission und ermÃÂÃÂ¶glicht die Verarbeitung und Analyse von Daten von den Instrumenten der Sonde aus, auf die die globale wissenschaftliche Gemeinschaft in weniger als 20 Minuten zugreifen kann. ÃÂÃÂDas Mohammed Bin Rashid Space Centre hat immer versucht, innovative LÃÂÃÂ¶sungen anzubieten, die der wissenschaftlichen Gemeinschaft zugute kommen. Durch unsere Projekte spielen wir eine wichtige Rolle bei der globalen Weltraumforschung, und die AWS-Cloud-Technologie hat maÃÂÃÂgeblich dazu beigetragen, viele dieser Funktionen zu nutzenÃÂÃÂ, sagte Salem AlMarri, Assistant Director General for Scientific and Technical Affairs bei MBRSC. ÃÂÃÂMBRSC hat immer die Zusammenarbeit mit privaten Unternehmen unterstÃÂÃÂ¼tzt, um Investitionen in den Raumfahrtsektor der VAE zu fÃÂÃÂ¶rdern, weitere arabische Erfolge in diesem Bereich zu erzielen und mit dem fortschrittlichen Ansatz einiger der technologisch und wissenschaftlich am weitesten entwickelten LÃÂÃÂ¤nder Schritt zu halten.ÃÂÃÂ Majid Al Futtaim ist der fÃÂÃÂ¼hrende Pionier fÃÂÃÂ¼r Einkaufszentren, Gemeinden, Einzelhandel und Freizeit im Nahen Osten, in Afrika und in Zentralasien. ÃÂÃÂWir haben vor einigen Jahren mit unserer digitalen Transformation begonnen und erkannt, dass wir uns ganz auf Daten konzentrieren mÃÂÃÂ¼ssen, um den aktuellen Trends immer einen Schritt voraus zu sein. AWS hat es uns ermÃÂÃÂ¶glicht, eine zentralisierte Datenverwaltungsplattform aufzubauen, die dazu beitrÃÂÃÂ¤gt, unsere Leistung zu verbessern, indem wir unseren Betrieb und unseren Kundenstamm ÃÂÃÂ¼ber eine einzige Datenquelle in den verschiedenen GeschÃÂÃÂ¤ftsbereichen des Unternehmens miteinander verbindenÃÂÃÂ, sagte Guillaume Thfoin, Head of Data and Analytics bei Majid Al Futtaim Holding. ÃÂÃÂMithilfe fortschrittlicher Analyse- und maschineller Lerndienste wie Amazon SageMaker haben wir Vorhersagemodelle verwendet, um neue Erkenntnisse zu gewinnen, die zu Leistungsverbesserungen und einem verbesserten Kundenerlebnis fÃÂÃÂ¼hren. Die neue Plattform hat uns dabei geholfen, agiler zu werden. Eine kÃÂÃÂ¼rzlich durchgefÃÂÃÂ¼hrte Fallstudie zu unserer Datentransformation ergab eine Verbesserung der MarkteinfÃÂÃÂ¼hrungsgeschwindigkeit um 80 % und trug zu den in den nÃÂÃÂ¤chsten fÃÂÃÂ¼nf Jahren prognostizierten Kosteneinsparungen in HÃÂÃÂ¶he von mehreren Millionen Dollar bei. Wir freuen uns auf die Ankunft einer AWS-Region im nÃÂÃÂ¤chsten Jahr, die das Potenzial unserer AWS-Plattform erweitert und gleichzeitig die Einhaltung der anstehenden gesetzlichen Anforderungen sicherstellt.ÃÂÃÂ GE Healthcare ist ein weltweit fÃÂÃÂ¼hrender Innovator fÃÂÃÂ¼r Medizintechnik, Diagnostik und digitale LÃÂÃÂ¶sungen. Jedes Jahr werden weltweit zwei Milliarden diagnostische Scans an GEHC-GerÃÂÃÂ¤ten durchgefÃÂÃÂ¼hrt. ÃÂÃÂDa die VAE als wichtige globale Drehscheibe fÃÂÃÂ¼r das Gesundheitswesen wachsen wollen, wird die kommende AWS-Region einen erheblichen Einfluss auf die Steigerung des Innovationstempos in der Branche habenÃÂÃÂ, sagte Summer Nasief, General Manager von GE Healthcare Digital. ÃÂÃÂDie Edison Health Services-Plattform von GE Healthcare, eine der grÃÂÃÂ¶ÃÂÃÂten Plattformen fÃÂÃÂ¼r kÃÂÃÂ¼nstliche Intelligenz im Gesundheitswesen, die zum Verbinden von Daten von Millionen von BildgebungsgerÃÂÃÂ¤ten entwickelt wurde, verwendet Amazon SageMaker, um Algorithmen fÃÂÃÂ¼r maschinelles Lernen in einem breiten Portfolio intelligenter GerÃÂÃÂ¤te und Unternehmenssoftwareanwendungen zu erstellen, zu trainieren und bereitzustellen. Mit der neuen AWS-Region kann ein grÃÂÃÂ¶ÃÂÃÂeres ÃÂÃÂkosystem regionaler Entwickler und Anbieter die Edison-Plattform nutzen, um Daten sicher zu aggregieren und zu analysieren, um Vorhersagemodelle fÃÂÃÂ¼r die BevÃÂÃÂ¶lkerung zu erstellen, mit denen die klinischen Ergebnisse proaktiv verwaltet, eine personalisierte Patientenversorgung eingerichtet und die Kosten fÃÂÃÂ¼r die Versorgung gesenkt werden kÃÂÃÂ¶nnen.ÃÂÃÂ Anghami ist die fÃÂÃÂ¼hrende Musik-Streaming-Plattform in der MENA-Region mit mehr als 70? Millionen Benutzern, die sofort auf ÃÂÃÂ¼ber 57 Millionen Songs zugreifen kÃÂÃÂ¶nnen. ÃÂÃÂWir haben unsere Infrastruktur seit dem ersten Tag auf AWS gehostet und sind von einem winzigen Startup mit groÃÂÃÂen TrÃÂÃÂ¤umen zur Streaming-Plattform Nummer eins im Nahen Osten gewachsenÃÂÃÂ, sagte Raja Baz, stellvertretender CTO bei Anghami. ÃÂÃÂAufbauend auf AWS kÃÂÃÂ¶nnen wir einen zuverlÃÂÃÂ¤ssigen Service mit der FlexibilitÃÂÃÂ¤t bereitstellen, mit bis zu 300 Prozent erhÃÂÃÂ¶htem Datenverkehr beim Start neuer Musik fertig zu werden. Es gibt uns auch die MÃÂÃÂ¶glichkeit, Innovationen zu entwickeln und ÃÂÃÂ¼ber Audio hinaus auf andere Unterhaltungsformen wie Video zu expandieren, das auf ÃÂÃÂ¼ber 50.000 tÃÂÃÂ¤gliche Streams angewachsen ist. Dies wÃÂÃÂ¤re ohne die UnterstÃÂÃÂ¼tzung von AWS nicht mÃÂÃÂ¶glich gewesen. Heute nÃÂÃÂ¤hern wir uns mit einer Notierung an der NASDAQ unserer nÃÂÃÂ¤chsten Wachstumsphase und werden das erste arabische Technologieunternehmen, das dies tut. Die fortgesetzten Investitionen von AWS in die Region sind ein Beweis fÃÂÃÂ¼r das Potenzial, das wir hier haben. Wir haben kÃÂÃÂ¼rzlich unseren Hauptsitz und unser Forschungs- und Entwicklungszentrum nach Abu Dhabi verlegt, um von seinem schnell wachsenden Innovationszentrum zu profitieren. Mit der neuen AWS-Region freuen wir uns, dass es schneller floriert.ÃÂÃÂ Die Hamdan Bin Mohammed Smart University (HBMSU) wurde 2002 in Dubai unter der PrÃÂÃÂ¤sidentschaft von H. H. Scheich Hamdan Bin Mohammed Bin Rashid Al Maktoum, dem Kronprinzen von Dubai, gegrÃÂÃÂ¼ndet und ist die erste akkreditierte Smart University der VAE. ÃÂÃÂIm vergangenen Jahr hat HBMSU die vollstÃÂÃÂ¤ndige Migration unserer Systeme und Anwendungen von lokalen Rechenzentren zu AWS erfolgreich abgeschlossen. Dies bot unmittelbare Vorteile wie Sicherheit, Skalierbarkeit, FlexibilitÃÂÃÂ¤t und direkte Kosteneinsparungen von bis zu 30 %ÃÂÃÂ, sagte Dr. Mansoor Al Awar, Kanzler der HBMSU. ÃÂÃÂWir haben die LeistungsfÃÂÃÂ¤higkeit des Cloud Computing bei der FÃÂÃÂ¶rderung der Hochschulbildung immer verstanden, und die kommende AWS-Region in den VAE ist ein wertvolles Kapital fÃÂÃÂ¼r den lokalen Bildungssektor. Es wird auch die ExpansionsplÃÂÃÂ¤ne von HBMSU und die FÃÂÃÂ¤higkeit unterstÃÂÃÂ¼tzen, auf die Nachfrage nach unserem einzigartigen Modell fÃÂÃÂ¼r intelligentes Lernen in anderen MÃÂÃÂ¤rkten im Nahen Osten und in Afrika zu reagieren.ÃÂÃÂ Sarwa ist eine Plattform fÃÂÃÂ¼r Investitionen und persÃÂÃÂ¶nliche Finanzen, die innovative Technologie und menschliches Know-how kombiniert, um das Investieren fÃÂÃÂ¼r alle einfach und erschwinglich zu machen. ÃÂÃÂSarwa wurde 2017 in der AWS Cloud geboren und ist allein im letzten Jahr um das Vierfache gewachsen und hat Hunderttausende von Transaktionen verarbeitetÃÂÃÂ, sagte Nadine Mezher, MitbegrÃÂÃÂ¼nderin und CMO von Sarwa. ÃÂÃÂMit AWS kÃÂÃÂ¶nnen wir schnell innovieren, um allen in dieser Region zu helfen, ihr VermÃÂÃÂ¶gen zu steigern und in Unternehmen zu investieren, an die sie glauben. Wir haben kÃÂÃÂ¼rzlich die Sarwa-App verÃÂÃÂ¶ffentlicht, die in drei Monaten vom Design auf den Markt gebracht wurde, und wir haben gerade die Warteliste fÃÂÃÂ¼r Sarwa Trade mit einer Beta-Plattform gestartet, die in einem Zeitraum von sechs Monaten verÃÂÃÂ¶ffentlicht werden soll. Die Nachricht von einer bevorstehenden AWS-Region in den VAE ist sehr aufregend und wird ein wichtiger Meilenstein fÃÂÃÂ¼r das Wachstum des FinTech-Sektors in den VAE sein.ÃÂÃÂ Die im Nahen Osten ansÃÂÃÂ¤ssigen AWS Partner Network (APN) Partner begrÃÂÃÂ¼ÃÂÃÂten auch die Neuigkeiten der geplanten Region AWS Middle East (VAE). Das APN umfasst Zehntausende von unabhÃÂÃÂ¤ngigen Softwareanbietern (Independent Software Vendors, ISVs) und Systemintegratoren (Systems Integrators, SIs) auf der ganzen Welt. AWS-Partner entwickeln innovative LÃÂÃÂ¶sungen und Dienstleistungen auf AWS und das APN hilft durch UnterstÃÂÃÂ¼tzung in den Bereichen Business, Technik, Marketing und Go-to-Market. APN-SIs, ISVs und Beratungspartner im Nahen Osten unterstÃÂÃÂ¼tzen Kunden aus Unternehmen und dem ÃÂÃÂ¶ffentlichen Sektor bei der Migration zu AWS, stellen geschÃÂÃÂ¤ftskritische Anwendungen bereit und bieten eine umfassende Palette von ÃÂÃÂberwachungs-, Automatisierungs- und Verwaltungsservices fÃÂÃÂ¼r die AWS-Umgebungen der Kunden. Beispiele fÃÂÃÂ¼r AWS Middle East-Partner sind Accenture, Deloitte, Bespin Global MEA, Citrus Consulting, Cloud4c, Crayon, Du, Etisalat, F5, Integra Technologies, Keplerworx, Palo Alto Networks, Rackspace, Redington, SAP, Splunk, TCS, Trend Micro, VMWare, Wipro und Zero & One. Deloitte ist AWS Premier Consulting Partner und strategischer globaler Systemintegrator. Durch eine strategische Zusammenarbeit ermÃÂÃÂ¶glichen AWS und Deloitte Kunden, ihr GeschÃÂÃÂ¤ft zu transformieren und schneller zu innovieren, indem sie AWS-Technologien mit der umfassenden Branchenerfahrung von Deloitte kombinieren. Richard Hurley, Kunden- und BranchenfÃÂÃÂ¼hrer von Deloitte Middle East Consulting, sagte: ÃÂÃÂDie BemÃÂÃÂ¼hungen der VAE um digitale Transformation sind klar und in Bewegung, sowohl fÃÂÃÂ¼r private Unternehmen als auch fÃÂÃÂ¼r Organisationen des ÃÂÃÂ¶ffentlichen Sektors. Wir gehen davon aus, dass eine AWS-Region in den VAE die Cloud-Migration und die Modernisierung von Anwendungen erheblich beschleunigen wird, was bedeutende wirtschaftliche Auswirkungen haben wird. Die neue Region wird Deloitte dabei helfen, die BedÃÂÃÂ¼rfnisse unserer Kunden in den VAE in vielen Branchen ÃÂÃÂ einschlieÃÂÃÂlich digitaler Bankplattformen, intelligenter Fabriken und konvergierter Gesundheit ÃÂÃÂ weiter zu erfÃÂÃÂ¼llen, um eine digitale Transformation zu erreichen, die eine zuverlÃÂÃÂ¤ssige und sichere Infrastruktur mit der FÃÂÃÂ¤higkeit zur lokalen Datenverarbeitung erfordert.ÃÂÃÂ UnterstÃÂÃÂ¼tzung von Start-ups, FÃÂÃÂ¤higkeiten und Studenten Die neue Region AWS Middle East Region (VAE) baut auf den bestehenden Investitionen von AWS im Land auf, zu denen zwei AWS Direct Connect-Standorte und zwei Amazon CloudFront Edge-Standorte gehÃÂÃÂ¶ren, die 2018 eingefÃÂÃÂ¼hrt wurden. AWS baut auch weiterhin Teams aus Kundenbetreuern, technischen Kundenbetreuern, Partnermanagern, Systemingenieuren, LÃÂÃÂ¶sungsarchitekten, professionellen Services und weiteren Rollen auf, um Kunden jeder GrÃÂÃÂ¶ÃÂÃÂe bei der Umstellung auf AWS zu unterstÃÂÃÂ¼tzen. Neben der Infrastruktur investiert AWS weiterhin in Bildungsinitiativen, Schulungen und Start-up-Programme, um die PlÃÂÃÂ¤ne der VAE zur digitalen Transformation und wirtschaftlichen Entwicklung zu unterstÃÂÃÂ¼tzen. Um das Unternehmertum und das Wachstum neuer Unternehmen in den VAE zu fÃÂÃÂ¶rdern, wird AWS das AWS Activate-Programm weiter ausbauen, um die Start-ups und KMUs der VAE zu unterstÃÂÃÂ¼tzen. Im Rahmen der AWS-Schulungs- und Zertifizierungsprogramme wird AWS auch mit staatlichen Stellen zusammenarbeiten, um die Qualifizierung und Umschulung der Belegschaft mit dem neuesten Cloud-Computing-Schulungscurriculum zu unterstÃÂÃÂ¼tzen. FÃÂÃÂ¼r Studenten und PÃÂÃÂ¤dagogen bietet AWS Hochschuleinrichtungen und ihren PÃÂÃÂ¤dagogen Cloud-Computing-Kurse an, um die Studenten auf branchenweit anerkannte Zertifizierungen und Karrieren im Cloud-Computing vorzubereiten. ÃÂÃÂber Amazon Web Services Seit mehr als 15 Jahren war Amazon Web Services die weltweit umfassendste und weitlÃÂÃÂ¤ufig angenommene Cloud-Plattform. AWS hat seine Services kontinuierlich erweitert, um nahezu jeden Cloud-Workload zu unterstÃÂÃÂ¼tzen, und verfÃÂÃÂ¼gt jetzt ÃÂÃÂ¼ber mehr als 200 voll ausgestattete Services fÃÂÃÂ¼r Computing, Speicher, Datenbanken, Networking, Analytik, maschinelles Lernen und kÃÂÃÂ¼nstliche Intelligenz (KI), Internet der Dinge (Internet of Things, IoT), mobile Technologien, Sicherheit, hybride Technologien, virtuelle und erweiterte RealitÃÂÃÂ¤t (VR und AR), Medien sowie Anwendungsentwicklung, -bereitstellung und -management in 80 VerfÃÂÃÂ¼gbarkeitszonen innerhalb von 25 geografischen Regionen, mit angekÃÂÃÂ¼ndigten PlÃÂÃÂ¤nen fÃÂÃÂ¼r 18 weitere VerfÃÂÃÂ¼gbarkeitszonen und sechs weitere AWS-Regionen in Australien, Indien, Indonesien, Spanien, der Schweiz und den Vereinigten Arabischen Emiraten. Millionen von Kunden ÃÂÃÂ darunter die wachstumsstÃÂÃÂ¤rksten Start-ups, die grÃÂÃÂ¶ÃÂÃÂten Konzerne und fÃÂÃÂ¼hrende RegierungsbehÃÂÃÂ¶rden ÃÂÃÂ verlassen sich auf AWS, um ihre Infrastruktur anzutreiben, agiler zu werden und Kosten zu senken. Mehr Informationen zu AWS erhalten Sie unter aws.amazon.com. Die Ausgangssprache, in der der Originaltext verÃÂÃÂ¶ffentlicht wird, ist die offizielle und autorisierte Version. ÃÂÃÂbersetzungen werden zur besseren VerstÃÂÃÂ¤ndigung mitgeliefert. Nur die Sprachversion, die im Original verÃÂÃÂ¶ffentlicht wurde, ist rechtsgÃÂÃÂ¼ltig. Gleichen Sie deshalb ÃÂÃÂbersetzungen mit der originalen Sprachversion der VerÃÂÃÂ¶ffentlichung ab.",https://www.businesswire.com/news/home/20210527005712/de/,businesswire.com,5,seattle usabusiness wireamazon web service aws ein unternehmen von amazoncom nasdaq amzn gab heute bekannt das e plant im ersten halbjahr eine infrastrukturregion den vereinigten arabischen emiraten vae zu erffnen die neue region aws middle east vae wird au drei verfgbarkeitszonen bestehen und mit der bestehenden awsregion bahrain die zweite region von aws im nahen osten sein dadurch erhalten kunden mehr auswahl und flexibilitt um fortschrittliche technologien au der weltweit fhrenden cloud zu nutzen weltweit verfgt aws ber verfgbarkeitszonen geografischen regionen e ist geplant weitere verfgbarkeitszonen und sechs weitere awsregionen australien indien indonesien spanien der schweiz und den vereinigten arabischen emiraten einzurichten weitere informationen zur weltweiten aws infrastruktur erhalten sie unter wir freuen un auf der groen dynamik der cloudeinfhrung im nahen osten aufzubauen indem wir kunden den vae mehr auswahlmglichkeiten bieten um anwendungen auszufhren und daten lokal zu speichern sagte peter desantis senior vice president global infrastructure bei aws die neue awsregion untersttzt den fokus der vae auf die frderung von technologischen innovationen die sie zu einem florierenden globalen zentrum fr unternehmer egovernment und multinationale unternehmen gemacht haben mit der neuen region knnen unternehmen jeder gre schneller innovieren und endbenutzer mit noch geringerer latenz der gesamten region bedienen seine exzellenz mohammed ali al shorafa vorsitzender der abteilung fr wirtschaftliche entwicklung abu dhabi sagte die expansion von aws die vae ist ein beweis fr unser schnell wachsendes innovationskosystem da vom zugang zur weltweit fhrenden cloudplattform und ihren fortschrittlichen technologien und lsungen profitieren wird aufbauend auf der intelligenten infrastruktur und der digitalen transformation von abu dhabi wird die investition von aws innovatoren und unternehmen mit global relevanten lsungen die lage versetzen neue mglichkeiten den vae und darber hinaus zu realisieren awsregionen bestehen au verfgbarkeitszonen denen die infrastruktur getrennten und unterschiedlichen geografischen standorten mit ausreichender entfernung platziert wird um da risiko zu reduzieren das ein einzelnes ereignis die geschftskontinuitt beeintrchtigt jedoch nah genug sind um geringe latenzzeiten fr hochverfgbare anwendungen zu bieten jede verfgbarkeitszone verfgt ber eine unabhngige stromversorgung khlung und physische sicherheit die zonen sind ber redundante netzwerke mit ultrageringer latenz miteinander verbunden awskunden die sich auf hochverfgbarkeit konzentrieren knnen ihre anwendungen gestalt das sie mehreren verfgbarkeitszonen und mehreren regionen ausgefhrt werden um eine noch grere fehlertoleranz zu erzielen durch die hinzufgung der region aws middle east vae knnen lokale kunden mit datenresidenzanforderungen ihre daten den vae speichern und gleichzeitig die latenz im ganzen land noch verringern unternehmen die diese region nutzen knnen auch auf fortschrittliche technologien au der breitesten und tiefsten suite von clouddiensten zugreifen um innovationen voranzutreiben darunter computer speicher netzwerk datenbank analyse maschinelles lernen internet der dinge iot mobile dienste und mehr seine exzellenz dr tariq bin hendi generaldirektor de abu dhabi investment office adio sagte wir begren die kommende awsregion die den vereinigten arabischen emiraten eine fortschrittliche cloudinfrastruktur bringen wird dy steht im einklang mit unserem ziel investitionen anzuziehen die die technologischen fhigkeiten steigern dy ist ein weiteres beispiel fr die wachsende partnerschaft zwischen dem ffentlichen und dem privaten sektor im emirat die darauf abzielt durchbrche zu beschleunigen und die gro angelegte digitale transformation voranzutreiben und abu dhabis position al globale drehscheibe fr innovation zu strken wir freuen un auf die zusammenarbeit mit aws der gesamten wissensbasierten wirtschaft einschlielich bildungsinitiativen cloudskillstraining und startupenablementprogrammen kunden und awspartner begren die neuigkeiten au der region aws middle east vae millionen aktiver kunden nutzen aws jeden monat ber lndern weltweit darunter zehntausende von kunden im nahen osten und nordafrika middle east north africa mena unternehmen entscheiden sich fr aws um agiler und innovativer zu werden dazu gehren die al tayer group aramex axa gulf axiom telecom emirate nbd flydubai gulf news die mbc group osn die seera group virgin middle east und viele mehr menaorganisationen de ffentlichen sektors nutzen aws um kosteneinsparungen zu erzielen innovationen zu beschleunigen und den brgern der region einen besseren service zu bieten dazu gehren die regulierungsbehrde fr kommunikation und informationstechnologie kuwait communication information technology regulatory authority citra die dubai expo da gyptische ministerium fr kommunikation und informationstechnologie die regierung der bahrainischen ministerien die hamdan bin mohammed smart university die universitt von bahrain und viele mehr zu den menastartups die ihre geschfte auf aws aufbauen um schnell zu skalieren und weltweit zu expandieren gehren alef education anghami careem dubizzle ekar fetchr haraj health hand maestro pizza mawdoocom property finder sarwa souqalmal starzplay und yallacompare awskunden begrten die neuigkeiten der awsregion den vereinigten arabischen emiraten einschlielich globaler kunden die die region nutzen knnen um neue zielgruppen zu bedienen wie z b salesforce der globale marktfhrer fr kundenbeziehungsmanagement customer relationship management crm salesforce ermglicht digitale transformationen fr unseren globalen kundenstamm die die modernen unternehmensfunktionen von aws erfordern sagte srinivas tallapragada president und chief engineering officer von salesforce wir freuen un mit amazon zusammenzuarbeiten und unsere vertrauenswrdige plattform neue mrkte zu bringen damit kunden von berall au erfolgreich sein knnen indem sie hyperforce und alle vorteile de ffentlichen cloudcomputings nutzen die first abu dhabi bank fab ist die grte bank der vae mit einer bilanzsumme von mrd aed mrd usd und einem der strksten rating aller banken im nahen osten und nordafrika unser cloudansatz ist seit anfang letzten jahres eines der grundprinzipien unserer technologiestrategie wir haben aws outpost sowohl fr entwicklungs al auch fr test und produktionsworkloads verwendet sagte yuri misnik chief technology officer von fab dy hat unsere digitale transformation der cloud und vor ort beschleunigt und die markteinfhrungszeit um verkrzt wir haben auch festgestellt das die produktivitt von entwicklern und infrastrukturteams um gesteigert wurde indem dieselbe infrastruktur dieselben service apis und tool der cloud und vor ort eingesetzt wurden wir begren die bevorstehende awsregion den vae die un dabei helfen wird unsere cloudambitionen effektiv und sicher zu verwirklichen und gleichzeitig die lokalen vorschriften vollstndig einzuhalten im februar startete da mohammed bin rashid space center mbrsc erfolgreich die hope probe die erste interplanetare mission fr die vae aws untersttzt die datenreise der mission und ermglicht die verarbeitung und analyse von daten von den instrumenten der sonde au auf die die globale wissenschaftliche gemeinschaft weniger al minuten zugreifen kann da mohammed bin rashid space centre hat immer versucht innovative lsungen anzubieten die der wissenschaftlichen gemeinschaft zugute kommen durch unsere projekte spielen wir eine wichtige rolle bei der globalen weltraumforschung und die awscloudtechnologie hat mageblich dazu beigetragen viele dieser funktionen zu nutzen sagte salem almarri assistant director general scientific technical affair bei mbrsc mbrsc hat immer die zusammenarbeit mit privaten unternehmen untersttzt um investitionen den raumfahrtsektor der vae zu frdern weitere arabische erfolge diesem bereich zu erzielen und mit dem fortschrittlichen ansatz einiger der technologisch und wissenschaftlich weitesten entwickelten lnder schritt zu halten majid al futtaim ist der fhrende pionier fr einkaufszentren gemeinden einzelhandel und freizeit im nahen osten afrika und zentralasien wir haben vor einigen jahren mit unserer digitalen transformation begonnen und erkannt das wir un ganz auf daten konzentrieren mssen um den aktuellen trend immer einen schritt voraus zu sein aws hat e un ermglicht eine zentralisierte datenverwaltungsplattform aufzubauen die dazu beitrgt unsere leistung zu verbessern indem wir unseren betrieb und unseren kundenstamm ber eine einzige datenquelle den verschiedenen geschftsbereichen de unternehmens miteinander verbinden sagte guillaume thfoin head data analytics bei majid al futtaim holding mithilfe fortschrittlicher analyse und maschineller lerndienste wie amazon sagemaker haben wir vorhersagemodelle verwendet um neue erkenntnisse zu gewinnen die zu leistungsverbesserungen und einem verbesserten kundenerlebnis fhren die neue plattform hat un dabei geholfen agiler zu werden eine krzlich durchgefhrte fallstudie zu unserer datentransformation ergab eine verbesserung der markteinfhrungsgeschwindigkeit um und trug zu den den nchsten fnf jahren prognostizierten kosteneinsparungen hhe von mehreren millionen dollar bei wir freuen un auf die ankunft einer awsregion im nchsten jahr die da potenzial unserer awsplattform erweitert und gleichzeitig die einhaltung der anstehenden gesetzlichen anforderungen sicherstellt ge healthcare ist ein weltweit fhrender innovator fr medizintechnik diagnostik und digitale lsungen jedes jahr werden weltweit zwei milliarden diagnostische scan gehcgerten durchgefhrt da die vae al wichtige globale drehscheibe fr da gesundheitswesen wachsen wollen wird die kommende awsregion einen erheblichen einfluss auf die steigerung de innovationstempos der branche haben sagte summer nasief general manager von ge healthcare digital die edison health servicesplattform von ge healthcare eine der grten plattformen fr knstliche intelligenz im gesundheitswesen die zum verbinden von daten von millionen von bildgebungsgerten entwickelt wurde verwendet amazon sagemaker um algorithmen fr maschinelles lernen einem breiten portfolio intelligenter gerte und unternehmenssoftwareanwendungen zu erstellen zu trainieren und bereitzustellen mit der neuen awsregion kann ein greres kosystem regionaler entwickler und anbieter die edisonplattform nutzen um daten sicher zu aggregieren und zu analysieren um vorhersagemodelle fr die bevlkerung zu erstellen mit denen die klinischen ergebnisse proaktiv verwaltet eine personalisierte patientenversorgung eingerichtet und die kosten fr die versorgung gesenkt werden knnen anghami ist die fhrende musikstreamingplattform der menaregion mit mehr al millionen benutzern die sofort auf ber millionen song zugreifen knnen wir haben unsere infrastruktur seit dem ersten tag auf aws gehostet und sind von einem winzigen startup mit groen truman zur streamingplattform nummer eins im nahen osten gewachsen sagte raja baz stellvertretender cto bei anghami aufbauend auf aws knnen wir einen zuverlssigen service mit der flexibilitt bereitstellen mit bi zu prozent erhhtem datenverkehr beim start neuer musik fertig zu werden e gibt un auch die mglichkeit innovationen zu entwickeln und ber audio hinaus auf andere unterhaltungsformen wie video zu expandieren da auf ber tgliche stream angewachsen ist dy wre ohne die untersttzung von aws nicht mglich gewesen heute nhern wir un mit einer notierung der nasdaq unserer nchsten wachstumsphase und werden da erste arabische technologieunternehmen da dy tut die fortgesetzten investitionen von aws die region sind ein beweis fr da potenzial da wir hier haben wir haben krzlich unseren hauptsitz und unser forschungs und entwicklungszentrum nach abu dhabi verlegt um von seinem schnell wachsenden innovationszentrum zu profitieren mit der neuen awsregion freuen wir un das e schneller floriert die hamdan bin mohammed smart university hbmsu wurde dubai unter der prsidentschaft von h h scheich hamdan bin mohammed bin rashid al maktoum dem kronprinzen von dubai gegrndet und ist die erste akkreditierte smart university der vae im vergangenen jahr hat hbmsu die vollstndige migration unserer systeme und anwendungen von lokalen rechenzentren zu aws erfolgreich abgeschlossen dy bot unmittelbare vorteile wie sicherheit skalierbarkeit flexibilitt und direkte kosteneinsparungen von bi zu sagte dr mansoor al awar kanzler der hbmsu wir haben die leistungsfhigkeit de cloud computing bei der frderung der hochschulbildung immer verstanden und die kommende awsregion den vae ist ein wertvolles kapital fr den lokalen bildungssektor e wird auch die expansionsplne von hbmsu und die fhigkeit untersttzen auf die nachfrage nach unserem einzigartigen modell fr intelligentes lernen anderen mrkten im nahen osten und afrika zu reagieren sarwa ist eine plattform fr investitionen und persnliche finanzen die innovative technologie und menschliches knowhow kombiniert um da investieren fr alle einfach und erschwinglich zu machen sarwa wurde der aws cloud geboren und ist allein im letzten jahr um da vierfache gewachsen und hat hunderttausende von transaktionen verarbeitet sagte nadine mezher mitbegrnderin und cmo von sarwa mit aws knnen wir schnell innovieren um allen dieser region zu helfen ihr vermgen zu steigern und unternehmen zu investieren die sie glauben wir haben krzlich die sarwaapp verffentlicht die drei monaten vom design auf den markt gebracht wurde und wir haben gerade die warteliste fr sarwa trade mit einer betaplattform gestartet die einem zeitraum von sechs monaten verffentlicht werden soll die nachricht von einer bevorstehenden awsregion den vae ist sehr aufregend und wird ein wichtiger meilenstein fr da wachstum de fintechsektors den vae sein die im nahen osten ansssigen aws partner network apn partner begrten auch die neuigkeiten der geplanten region aws middle east vae da apn umfasst zehntausende von unabhngigen softwareanbietern independent software vendor isvs und systemintegratoren system integrator si auf der ganzen welt awspartner entwickeln innovative lsungen und dienstleistungen auf aws und da apn hilft durch untersttzung den bereichen business technik marketing und gotomarket apnsis isvs und beratungspartner im nahen osten untersttzen kunden au unternehmen und dem ffentlichen sektor bei der migration zu aws stellen geschftskritische anwendungen bereit und bieten eine umfassende palette von berwachungs automatisierungs und verwaltungsservices fr die awsumgebungen der kunden beispiele fr aws middle eastpartner sind accenture deloitte bespin global mea citrus consulting cloudc crayon du etisalat f integra technology keplerworx palo alto network rackspace redington sap splunk tc trend micro vmware wipro und zero one deloitte ist aws premier consulting partner und strategischer globaler systemintegrator durch eine strategische zusammenarbeit ermglichen aws und deloitte kunden ihr geschft zu transformieren und schneller zu innovieren indem sie awstechnologien mit der umfassenden branchenerfahrung von deloitte kombinieren richard hurley kunden und branchenfhrer von deloitte middle east consulting sagte die bemhungen der vae um digitale transformation sind klar und bewegung sowohl fr private unternehmen al auch fr organisationen de ffentlichen sektors wir gehen davon au das eine awsregion den vae die cloudmigration und die modernisierung von anwendungen erheblich beschleunigen wird bedeutende wirtschaftliche auswirkungen haben wird die neue region wird deloitte dabei helfen die bedrfnisse unserer kunden den vae vielen branchen einschlielich digitaler bankplattformen intelligenter fabriken und konvergierter gesundheit weiter zu erfllen um eine digitale transformation zu erreichen die eine zuverlssige und sichere infrastruktur mit der fhigkeit zur lokalen datenverarbeitung erfordert untersttzung von startup fhigkeiten und studenten die neue region aws middle east region vae baut auf den bestehenden investitionen von aws im land auf zu denen zwei aws direct connectstandorte und zwei amazon cloudfront edgestandorte gehren die eingefhrt wurden aws baut auch weiterhin team au kundenbetreuern technischen kundenbetreuern partnermanagern systemingenieuren lsungsarchitekten professionellen service und weiteren rollen auf um kunden jeder gre bei der umstellung auf aws zu untersttzen neben der infrastruktur investiert aws weiterhin bildungsinitiativen schulungen und startupprogramme um die plne der vae zur digitalen transformation und wirtschaftlichen entwicklung zu untersttzen um da unternehmertum und da wachstum neuer unternehmen den vae zu frdern wird aws da aws activateprogramm weiter ausbauen um die startup und kmus der vae zu untersttzen im rahmen der awsschulungs und zertifizierungsprogramme wird aws auch mit staatlichen stellen zusammenarbeiten um die qualifizierung und umschulung der belegschaft mit dem neuesten cloudcomputingschulungscurriculum zu untersttzen fr studenten und pdagogen bietet aws hochschuleinrichtungen und ihren pdagogen cloudcomputingkurse um die studenten auf branchenweit anerkannte zertifizierungen und karrieren im cloudcomputing vorzubereiten ber amazon web service seit mehr al jahren war amazon web service die weltweit umfassendste und weitlufig angenommene cloudplattform aws hat seine service kontinuierlich erweitert um nahezu jeden cloudworkload zu untersttzen und verfgt jetzt ber mehr al voll ausgestattete service fr computing speicher datenbanken networking analytik maschinelles lernen und knstliche intelligenz ki internet der dinge internet thing iot mobile technologien sicherheit hybride technologien virtuelle und erweiterte realitt vr und ar medien sowie anwendungsentwicklung bereitstellung und management verfgbarkeitszonen innerhalb von geografischen regionen mit angekndigten plnen fr weitere verfgbarkeitszonen und sechs weitere awsregionen australien indien indonesien spanien der schweiz und den vereinigten arabischen emiraten millionen von kunden darunter die wachstumsstrksten startup die grten konzerne und fhrende regierungsbehrden verlassen sich auf aws um ihre infrastruktur anzutreiben agiler zu werden und kosten zu senken mehr informationen zu aws erhalten sie unter awsamazoncom die ausgangssprache der der originaltext verffentlicht wird ist die offizielle und autorisierte version bersetzungen werden zur besseren verstndigung mitgeliefert nur die sprachversion die im original verffentlicht wurde ist rechtsgltig gleichen sie deshalb bersetzungen mit der originalen sprachversion der verffentlichung ab,-0.9999,-0.49995,0.236225,-0.736175,Negative Impact
28/05/2021,162.1,162.40,160.99,161.15,161.15,46596000,3.3,50.56966791,1.192,0,13.66057312,0.8419472675,0.2413396506,0.06,269.195,13748.74023,16555.66016,7022.600098,6484.109863,3600.780029,51422.87891,19852.19922,163.0546497,160.5840498,162.6415713,155.3870575,162.3129997,167.6758278,156.9501717,53.81427328,-0.757570495,-0.686505677,-0.071064818,3.039356777,157.1689688,10545152000,51.83340055,58.39437734,16.76000023,"New Bill To Impose Counterfeit Goods Sale Liability On Amazon, eBay: Bloomberg","A new U.S. bill will impose higher liability from Amazon.com Inc (NASDAQ: AMZN) and eBay Inc's (NASDAQ: EBAY) e-commerce platforms for the hazardous counterfeit sale of health risk products like exploding Apple Inc (NASDAQ: AAPL) iPhone chargers or defective personal protective equipment by third-party vendors, Bloomberg reports. The platforms will have to validate manufacturer identity and permanently ban serial offenders from gaining liability immunity.",https://www.benzinga.com/news/21/05/21343645/new-bill-to-impose-counterfeit-goods-sale-liability-on-amazon-ebay-bloomberg,benzinga.com,5,new u bill impose higher liability amazoncom inc nasdaq amzn ebay inc nasdaq ebay ecommerce platform hazardous counterfeit sale health risk product like exploding apple inc nasdaq aapl iphone charger defective personal protective equipment thirdparty vendor bloomberg report platform validate manufacturer identity permanently ban serial offender gaining liability immunity,-0.7964,-0.3982,0.1985866667,-0.596786667,Negative Impact
01/06/2021,162.175,162.55,160.45,160.93,160.93,48600000,3.3,50.56966791,1.192,0,13.66057312,0.8419472675,0.2413396506,0.08,271.696,13736.48047,16643.32031,7080.5,6489.399902,3624.709961,51934.87891,19976,163.1983395,160.5984573,162.5745487,155.442236,161.8933998,166.1442972,157.6425024,49.33932728,-0.797488679,-0.708702277,-0.088786401,2.793963841,157.47367,10496552000,47.84911039,51.77627642,17.89999962,"Amazon warehouse workers injured at higher rates than rival companies, study finds",Amazon CEO Jeff Bezos recently admitted the company needs to do a better job for employees.,https://www.cnbc.com/2021/06/01/study-amazon-workers-injured-at-higher-rates-than-rival-companies.html,cnbc.com,9,amazon ceo jeff bezos recently admitted company need better job employee,0.6124,0.55116,0.266138,0.285022,Positive Impact
02/06/2021,161.155,161.75,160.40,161.70,161.70,40290000,3.3,50.56966791,1.192,0,13.66057312,0.8419472675,0.2413396506,0.08,271.696,13756.33008,16673.96094,7108,6521.52002,3597.139893,51849.48047,19971.19922,163.3214594,160.6199498,162.5402328,155.5044972,161.6986992,165.5763479,157.8210504,62.0149205,-0.75849037,-0.718659896,-0.039830474,2.566071647,157.7661831,10536842000,56.41891201,52.03380765,17.47999954,Amazon shifts policy on controversial worker monitoring system,"Amazon shifted policy on a controversial employee productivity monitoring system Tuesday as a coalition of US labor unions took aim at the firm, saying a need for speed in warehouses led to injuries.",https://techxplore.com/news/2021-06-amazon-shifts-policy-controversial-worker.html,techxplore.com,5,amazon shifted policy controversial employee productivity monitoring system tuesday coalition u labor union took aim firm saying need speed warehouse led injury,-0.4404,-0.2202,0.20449625,-0.42469625,Negative Impact
03/06/2021,160.2115,160.72,159.20,159.35,159.35,47966000,3.3,50.56966791,1.192,0,13.66057312,0.8419472675,0.2413396506,0.08,271.696,13614.50977,16632.33984,7064.399902,6507.919922,3584.209961,52232.42969,19941.40039,163.3709692,160.6210998,162.415145,155.5427658,161.4898743,165.4026337,157.5771148,53.3702648,-0.906676912,-0.756263299,-0.150413613,2.491498675,158.0469958,10488876000,3.108528819,35.79218374,18.04000092,Heritage dispute engulfs site chosen for Amazon's new African HQ,For the Khoi and San - South Africa's first inhabitants - a verdant patch of land in Cape Town embodies victory and tragedy.,https://www.reuters.com/world/africa/heritage-dispute-engulfs-site-chosen-amazons-new-african-hq-2021-06-03/,reuters.com,10,khoi san south africa first inhabitant verdant patch land cape town embodies victory tragedy,-0.6597,-0.6597,0.1899907692,-0.849690769,Negative Impact
04/06/2021,160.6,161.05,159.94,160.31,160.31,44994000,3.3,50.56966791,1.192,0,13.66057312,0.8419472675,0.2413396506,0.08,271.696,13814.49023,16708.74023,7069,6515.660156,3591.840088,52100.05078,20029.19922,163.4901193,160.5945323,162.3326297,155.590211,161.2394997,164.7398348,157.7391645,47.52287142,-0.935823078,-0.792175255,-0.143647823,2.372214181,158.3165759,10533870000,17.35947033,25.62897039,16.42000008,"Alphabet Inches Past Amazon in Market Cap. Only Apple, Microsoft Are Ahead.","The shift reflects a change in how the market sees companies viewed as having gained a lot from the pandemic, relative to those that win from the reopening.",https://www.barrons.com/articles/alphabet-amazon-apple-market-cap-51622838619,barrons.com,9,shift reflects change market see company viewed gained lot pandemic relative win reopening,0.7506,0.67554,0.2206066667,0.4549333333,Positive Impact
07/06/2021,159.8665,160.40,158.61,159.90,159.90,44316000,3.3,50.56966791,1.192,0,13.66057312,0.8419472675,0.2413396506,0.08,271.696,13881.71973,16709.30078,7077.200195,6543.560059,3599.540039,52328.51172,20035.30078,163.6418692,160.5789148,162.237252,155.6330994,161.0054993,164.1755608,157.8354377,37.83120117,-0.980740756,-0.829888355,-0.150852401,2.250607082,158.5753728,10489554000,18.46202878,12.97667598,16.42000008,5 Supercharged Stocks That Are Going to the Moon,"These innovative, high-quality businesses should reward long-term investors with monster gains.",https://www.fool.com/investing/2021/06/07/5-supercharged-stocks-that-are-going-to-the-moon/,fool.com,7,innovative highquality business reward longterm investor monster gain,0.875,0.6125,0.2116076923,0.4008923077,Positive Impact
08/06/2021,161.1305,163.98,160.90,163.21,163.21,68334000,3.3,50.56966791,1.192,0,13.66057312,0.8419472675,0.2413396506,0.08,271.696,13924.91016,16685.48047,7095.100098,6551.009766,3580.110107,52275.57031,20065.90039,163.8539493,160.5705998,162.2752227,155.7084468,161.1895493,164.424338,157.9547605,54.89107039,-0.74110878,-0.81213244,0.07102366024,2.250213623,158.6100006,10557888000,74.40307523,36.74152478,17.06999969,Alibaba expands cloud products with livestream shopping in its battle against Amazon,Alibaba trails Amazon and Microsoft in the global cloud computing market and hopes new products such as livestreaming e-commerce can help it stand out.,https://www.cnbc.com/2021/06/08/https//wwwcnbccom/2021/06/08/apple-wwdc-new-private-relay-feature-will-not-be-available-in-chinahtml.html,cnbc.com,9,alibaba trail amazon microsoft global cloud computing market hope new product livestreaming ecommerce help stand,0.743,0.6687,0.2064544444,0.4622455556,Positive Impact
09/06/2021,163.6435,164.88,163.54,164.06,164.06,49110000,3.3,50.56966791,1.192,0,13.66057312,0.8419472675,0.2413396506,0.08,271.696,13911.75,16620,7081,6563.450195,3591.399902,51941.64063,20002.30078,164.0593692,160.5697073,162.3451157,155.7915219,161.3326492,164.8124814,157.852817,57.21596213,-0.476952251,-0.745096402,0.268144151,2.188498361,158.6100006,10606998000,86.89578795,59.92029732,17.88999939,Factbox: How Amazon trained GameStop's new chiefs in e-commerce,Videogame retailer GameStop Corp on Wednesday tapped executives who cut their teeth at Amazon.com Inc to lead the transition of its business to e-commerce. Here's a look at their time at the world's largest online retailer:,https://www.reuters.com/article/us-gamestop-ceo-amazon-com-factbox/factbox-how-amazon-trained-gamestops-new-chiefs-in-e-commerce-idUSKCN2DL2S9,reuters.com,10,videogame retailer gamestop corp wednesday tapped executive cut teeth amazoncom inc lead transition business ecommerce here look time world largest online retailer,-0.2732,-0.2732,0.2619508333,-0.535150833,Negative Impact
10/06/2021,164.1005,167.55,164.06,167.48,167.48,69530000,3.3,50.56966791,1.192,0,13.66057312,0.8419472675,0.2413396506,0.08,271.696,14020.33008,16651.42969,7088.200195,6546.490234,3610.860107,52300.46875,20049.5,164.3537292,160.5802548,162.5465817,155.90785,161.8269241,165.840015,157.8138333,62.92164987,0.008662961674,-0.59434453,0.6030074913,2.338391985,158.9861404,10676528000,99.24491203,86.84792507,16.10000038,"U.S. senator slams Apple, Amazon, Nike, for enabling forced labor in China","A U.S. senator on Thursday slammed American companies, including Amazon.com Inc, Apple Inc and Nike Inc, for turning a blind eye to allegations of forced labor in China, arguing they were making American consumers complicit in Beijing's repressive policies.",https://www.reuters.com/article/us-usa-china-xinjiang/u-s-senator-slams-apple-amazon-nike-for-enabling-forced-labor-in-china-idUSKCN2DM2L7,reuters.com,10,u senator thursday slammed american company including amazoncom inc apple inc nike inc turning blind eye allegation forced labor china arguing making american consumer complicit beijing repressive policy,-0.8779,-0.8779,0.1982437143,-1.076143714,Negative Impact
11/06/2021,167.4825,168.33,166.67,167.34,167.34,56348000,3.3,50.56966791,1.192,0,13.66057312,0.8419472675,0.2413396506,0.08,271.696,14069.41992,16694.92969,7134.100098,6600.660156,3589.75,52474.76172,20138.40039,164.6064795,160.5803399,162.734618,156.0216177,162.2903244,166.6073876,157.9732612,70.37331469,0.3777848359,-0.399918657,0.7777034924,2.24356951,159.6712495,10620180000,89.83960913,91.99343637,15.64999962,"Amazon und der National Safety Council bilden die erste Partnerschaft, um die am hÃÂÃÂ¤ufigsten auftretenden ArbeitsunfÃÂÃÂ¤lle in den USA zu beheben","SEATTLE und CHICAGO--(BUSINESS WIRE)--Heute verkÃÂÃÂ¼ndeten Amazon (NASDAQ:AMZN) und das National Safety Council (NSC) eine fÃÂÃÂ¼nfjÃÂÃÂ¤hrige Partnerschaft, um neue Wege zu finden, mit denen die grÃÂÃÂ¶ÃÂÃÂte Kategorie von Verletzungen am Arbeitsplatz in den USA, nÃÂÃÂ¤mlich muskuloskelettale Erkrankungen (musculoskeletal disorders, MSDs), verhindert werden kÃÂÃÂ¶nnen. Schon seit Monaten arbeiten Amazon und NSC gemeinsam an dieser erstmaligen Kooperation. ÃÂÃÂDurch diese Partnerschaft werden wir Probleme lÃÂÃÂ¶sen kÃÂÃÂ¶nnen, mit denen Menschen tagtÃÂÃÂ¤glich konfrontiert sind, damit sie ihr Leben in vollen ZÃÂÃÂ¼gen genieÃÂÃÂen kÃÂÃÂ¶nnenÃÂÃÂ, sagte Lorraine Martin, President und CEO des National Safety Council. ÃÂÃÂEs sollte ein positives, lohnendes und sicheres Erlebnis sein, zur Arbeit zu gehen. Wir sind dankbar fÃÂÃÂ¼r die umfangreiche UnterstÃÂÃÂ¼tzung von Amazon, um Unternehmen auf der ganzen Welt bei der LÃÂÃÂ¶sung dieses wichtigen Problems zu helfen und gleichzeitig unsere gemeinnÃÂÃÂ¼tzige Mission fÃÂÃÂ¼r die Sicherheit der Mitarbeiter am Arbeitsplatz zu stÃÂÃÂ¤rken.ÃÂÃÂ ÃÂÃÂAls Teil des Sicherheitsteams von Amazon vor Ort habe ich das Ziel, alles in meiner Macht Stehende zu tun, um meine Kollegen bei der Arbeit gesund zu halten, damit wir alle sicher zu unseren Freunden und Familien nach Hause gehen kÃÂÃÂ¶nnenÃÂÃÂ, sagte Chelsea Weimer, eine stundenweise Angestellte im Fulfillment Center von Amazon in Baltimore, MD. ÃÂÃÂAmazon hat einen hohen Sicherheitsstandard; diese Partnerschaft beweist das einmal mehr, und ich kann es kaum erwarten, die Arbeit zu sehen, die geleistet wird, um MSDs zu verringern.ÃÂÃÂ Die Partnerschaft wird das Ziel haben, Muskel- und Skeletterkrankungen in einer Reihe von Branchen zu verhindern, indem wichtige Stakeholder beteiligt werden, Forschung betrieben wird, neue Technologien und Prozesse entwickelt werden und die Ergebnisse skaliert werden. Durch Amazons Beitrag in HÃÂÃÂ¶he von 12 Millionen USD, dem grÃÂÃÂ¶ÃÂÃÂten Beitrag eines Unternehmens in der Geschichte des NSC, wird die Zusammenarbeit mÃÂÃÂ¶glich und umfasst fÃÂÃÂ¼nf SchlÃÂÃÂ¼sselkomponenten: Beirat: Einrichtung eines internationalen Beirats, um Sicherheitsexperten, Unternehmen und Forscher aus dem ÃÂÃÂ¶ffentlichen und privaten Sektor zusammenzufÃÂÃÂ¼hren. Der Beirat wird gemeinsam die erfolgversprechendsten AnsÃÂÃÂ¤tze zur EBA-PrÃÂÃÂ¤vention untersuchen, die Entwicklung von Partnerschaftskomponenten mitgestalten und externe Parteien zur EBA-PrÃÂÃÂ¤vention einbinden. Bahnbrechende Forschung: DurchfÃÂÃÂ¼hrung von Forschungsarbeiten mithilfe von kÃÂÃÂ¼nstlicher Intelligenz der nÃÂÃÂ¤chsten Generation, natÃÂÃÂ¼rlicher Sprachverarbeitung und Machine-Learning-Tools zur Erkundung aktueller und zukÃÂÃÂ¼nftiger EBA-Innovationen und -Trends. Die Ergebnisse der Forschung werden allen Branchen zugÃÂÃÂ¤nglich sein, um sie zu erforschen und Erkenntnisse zu gewinnen. FÃÂÃÂ¶rdermittel fÃÂÃÂ¼r kleine Unternehmen und UniversitÃÂÃÂ¤ten: Bereitstellung von FÃÂÃÂ¶rdermitteln fÃÂÃÂ¼r kleine Unternehmen, UniversitÃÂÃÂ¤ten und UniversitÃÂÃÂ¤tsstudenten. Forschung und Innovation werden durch diese FÃÂÃÂ¶rdermittel finanziert, die Unternehmen aller GrÃÂÃÂ¶ÃÂÃÂenordnungen dabei helfen, etwas zu erreichen. Innovations-Challenge: Entwicklung und FÃÂÃÂ¶rderung innovativer und praktischer LÃÂÃÂ¶sungen fÃÂÃÂ¼r EBA durch Innovation-Challenge-Wettbewerbe. Diese Wettbewerbe werden Experten zusammenfÃÂÃÂ¼hren, um zusammenzuarbeiten, zu iterieren und Techniken und Ideen zu teilen. Aufruf der Branche zur Handlung ÃÂÃÂ Der MSD Pledge: Amazon und NSC werden LÃÂÃÂ¶sungen teilen, die im Rahmen der Partnerschaft entdeckt wurden, um VerÃÂÃÂ¤nderungen durch die Schaffung des MSD Pledge zu inspirieren und andere Unternehmen dazu aufzurufen, sich ebenfalls an den BemÃÂÃÂ¼hungen zu beteiligen, um: Proaktive Indikatoren fÃÂÃÂ¼r Verletzungen zu verfolgen, um eine angemessene Risikominderung sicherzustellen und PrÃÂÃÂ¤ventionsstrategien basierend auf Daten zu implementieren. Ein EBA-PrÃÂÃÂ¤ventionsprogramm zu implementieren, das die AufklÃÂÃÂ¤rung von Mitarbeitern und Arbeitgebern ÃÂÃÂ¼ber VerletzungsprÃÂÃÂ¤vention beinhaltet. Innovative LÃÂÃÂ¶sungen zur PrÃÂÃÂ¤vention von Muskel- und Skeletterkrankungen voranzutreiben und Best Practices mit anderen Organisationen weltweit auszutauschen. Die Partnerschaft beginnt im Juni wÃÂÃÂ¤hrend des Nationalen Sicherheitsmonats und wird sich im ersten Jahr auf die GrÃÂÃÂ¼ndung des Beirats, die Identifizierung von Forschungspartnern, die Analyse bestehender Daten und die Entwicklung der Zuschuss- und Innovation-Challenge-Programme fokussieren. ÃÂÃÂNichts ist so wichtig wie die Sicherheit unserer Mitarbeiter, und diese Partnerschaft wird es uns erlauben, tief in die beste Methode zur Reduzierung von Muskel- und Skeletterkrankungen einzutauchenÃÂÃÂ, sagte Heather MacDougall, Amazons Vice President of Worldwide Workplace Health and Safety. ÃÂÃÂDer National Safety Council blickt auf eine lange Geschichte bei der FÃÂÃÂ¶rderung sicherer Praktiken am Arbeitsplatz zurÃÂÃÂ¼ck, und wir freuen uns darauf, mit ihm sowie mit vielen anderen Unternehmen, Experten und Studenten weltweit zusammenzuarbeiten, um Innovationen und LÃÂÃÂ¶sungen fÃÂÃÂ¼r dieses wichtige Thema zu entwickeln.ÃÂÃÂ Die Zusammenarbeit mit dem NSC ist ein nÃÂÃÂ¤chster Schritt in Amazons langfristiger Mission, weltweit der sicherste Arbeitsplatz zu sein, was eine Investition von ÃÂÃÂ¼ber 300 Millionen USD in Sicherheitsprojekte im Jahr 2021 sowie das Ziel beinhaltet, die Quote der meldepflichtigen UnfÃÂÃÂ¤lle bis 2025 um 50 % zu reduzieren. Amazon arbeitet tÃÂÃÂ¤glich eng mit Gesundheits- und Sicherheitsexperten zusammen, fÃÂÃÂ¼hrt in jedem GebÃÂÃÂ¤ude Tausende von Sicherheitsinspektionen durch und holt aktiv das Feedback der Mitarbeiter ein, um deren Wohlbefinden am Arbeitsplatz zu verbessern. Wenn Sie einen Blick in den Arbeitsplatz von Amazon werfen und mehr ÃÂÃÂ¼ber das Team und die Technologie erfahren mÃÂÃÂ¶chten, melden Sie sich unter www.amazon.com/FCtours fÃÂÃÂ¼r eine Tour durch das Fulfillment Center an. Der National Safety Council ist Amerikas fÃÂÃÂ¼hrender gemeinnÃÂÃÂ¼tziger Rechtsbeistand fÃÂÃÂ¼r Sicherheit ÃÂÃÂ und das schon seit mehr als 100 Jahren. Als Organisation, die auf einer Mission basiert, arbeitet sie daran, die Hauptursachen fÃÂÃÂ¼r vermeidbare TodesfÃÂÃÂ¤lle und Verletzungen zu beseitigen, und konzentriert ihre BemÃÂÃÂ¼hungen auf den Arbeitsplatz, den StraÃÂÃÂenverkehr und BeeintrÃÂÃÂ¤chtigungen. Sie schafft eine Sicherheitskultur, um die Menschen nicht nur bei der Arbeit, sondern auch auÃÂÃÂerhalb des Arbeitsplatzes besser zu schÃÂÃÂ¼tzen. FÃÂÃÂ¼r weitere Informationen ÃÂÃÂ¼ber die Sicherheit der Mitarbeiter bei Amazon besuchen Sie www.amazon.com/employee-safety. FÃÂÃÂ¼r weitere Informationen ÃÂÃÂ¼ber die Partnerschaft besuchen Sie www.nsc.org/amazonpartnership. Die Ausgangssprache, in der der Originaltext verÃÂÃÂ¶ffentlicht wird, ist die offizielle und autorisierte Version. ÃÂÃÂbersetzungen werden zur besseren VerstÃÂÃÂ¤ndigung mitgeliefert. Nur die Sprachversion, die im Original verÃÂÃÂ¶ffentlicht wurde, ist rechtsgÃÂÃÂ¼ltig. Gleichen Sie deshalb ÃÂÃÂbersetzungen mit der originalen Sprachversion der VerÃÂÃÂ¶ffentlichung ab.",https://www.businesswire.com/news/home/20210611005131/de/,businesswire.com,5,seattle und chicagobusiness wireheute verkndeten amazon nasdaqamzn und da national safety council nsc eine fnfjhrige partnerschaft um neue wege zu finden mit denen die grte kategorie von verletzungen arbeitsplatz den usa nmlich muskuloskelettale erkrankungen musculoskeletal disorder msds verhindert werden knnen schon seit monaten arbeiten amazon und nsc gemeinsam dieser erstmaligen kooperation durch diese partnerschaft werden wir probleme lsen knnen mit denen menschen tagtglich konfrontiert sind damit sie ihr leben vollen zgen genieen knnen sagte lorraine martin president und ceo de national safety council e sollte ein positive lohnendes und sicheres erlebnis sein zur arbeit zu gehen wir sind dankbar fr die umfangreiche untersttzung von amazon um unternehmen auf der ganzen welt bei der lsung diesis wichtigen problem zu helfen und gleichzeitig unsere gemeinntzige mission fr die sicherheit der mitarbeiter arbeitsplatz zu strken al teil de sicherheitsteams von amazon vor ort habe ich da ziel alles meiner macht stehende zu tun um meine kollegen bei der arbeit gesund zu halten damit wir alle sicher zu unseren freunden und familien nach hause gehen knnen sagte chelsea weimer eine stundenweise angestellte im fulfillment center von amazon baltimore md amazon hat einen hohen sicherheitsstandard diese partnerschaft beweist da einmal mehr und ich kann e kaum erwarten die arbeit zu sehen die geleistet wird um msds zu verringern die partnerschaft wird da ziel haben muskel und skeletterkrankungen einer reihe von branchen zu verhindern indem wichtige stakeholder beteiligt werden forschung betrieben wird neue technologien und prozesse entwickelt werden und die ergebnisse skaliert werden durch amazon beitrag hhe von millionen usd dem grten beitrag eines unternehmens der geschichte de nsc wird die zusammenarbeit mglich und umfasst fnf schlsselkomponenten beirat einrichtung eines internationalen beirats um sicherheitsexperten unternehmen und forscher au dem ffentlichen und privaten sektor zusammenzufhren der beirat wird gemeinsam die erfolgversprechendsten anstze zur ebaprvention untersuchen die entwicklung von partnerschaftskomponenten mitgestalten und externe parteien zur ebaprvention einbinden bahnbrechende forschung durchfhrung von forschungsarbeiten mithilfe von knstlicher intelligenz der nchsten generation natrlicher sprachverarbeitung und machinelearningtools zur erkundung aktueller und zuknftiger ebainnovationen und trend die ergebnisse der forschung werden allen branchen zugnglich sein um sie zu erforschen und erkenntnisse zu gewinnen frdermittel fr kleine unternehmen und universitten bereitstellung von frdermitteln fr kleine unternehmen universitten und universittsstudenten forschung und innovation werden durch diese frdermittel finanziert die unternehmen aller grenordnungen dabei helfen etwas zu erreichen innovationschallenge entwicklung und frderung innovativer und praktischer lsungen fr eba durch innovationchallengewettbewerbe diese wettbewerbe werden experten zusammenfhren um zusammenzuarbeiten zu iterieren und techniken und ideen zu teilen aufruf der branche zur handlung der msd pledge amazon und nsc werden lsungen teilen die im rahmen der partnerschaft entdeckt wurden um vernderungen durch die schaffung de msd pledge zu inspirieren und andere unternehmen dazu aufzurufen sich ebenfalls den bemhungen zu beteiligen um proaktive indikatoren fr verletzungen zu verfolgen um eine angemessene risikominderung sicherzustellen und prventionsstrategien basierend auf daten zu implementieren ein ebaprventionsprogramm zu implementieren da die aufklrung von mitarbeitern und arbeitgebern ber verletzungsprvention beinhaltet innovative lsungen zur prvention von muskel und skeletterkrankungen voranzutreiben und best practice mit anderen organisationen weltweit auszutauschen die partnerschaft beginnt im juni whrend de nationalen sicherheitsmonats und wird sich im ersten jahr auf die grndung de beirats die identifizierung von forschungspartnern die analyse bestehender daten und die entwicklung der zuschuss und innovationchallengeprogramme fokussieren nichts ist wichtig wie die sicherheit unserer mitarbeiter und diese partnerschaft wird e un erlauben tief die beste methode zur reduzierung von muskel und skeletterkrankungen einzutauchen sagte heather macdougall amazon vice president worldwide workplace health safety der national safety council blickt auf eine lange geschichte bei der frderung sicherer praktiken arbeitsplatz zurck und wir freuen un darauf mit ihm sowie mit vielen anderen unternehmen experten und studenten weltweit zusammenzuarbeiten um innovationen und lsungen fr diesis wichtige thema zu entwickeln die zusammenarbeit mit dem nsc ist ein nchster schritt amazon langfristiger mission weltweit der sicherste arbeitsplatz zu sein eine investition von ber millionen usd sicherheitsprojekte im jahr sowie da ziel beinhaltet die quote der meldepflichtigen unflle bi um zu reduzieren amazon arbeitet tglich eng mit gesundheits und sicherheitsexperten zusammen fhrt jedem gebude tausende von sicherheitsinspektionen durch und holt aktiv da feedback der mitarbeiter ein um deren wohlbefinden arbeitsplatz zu verbessern wenn sie einen blick den arbeitsplatz von amazon werfen und mehr ber da team und die technologie erfahren mchten melden sie sich unter fr eine tour durch da fulfillment center der national safety council ist amerikas fhrender gemeinntziger rechtsbeistand fr sicherheit und da schon seit mehr al jahren al organisation die auf einer mission basiert arbeitet sie daran die hauptursachen fr vermeidbare todesflle und verletzungen zu beseitigen und konzentriert ihre bemhungen auf den arbeitsplatz den straenverkehr und beeintrchtigungen sie schafft eine sicherheitskultur um die menschen nicht nur bei der arbeit sondern auch auerhalb de arbeitsplatzes besser zu schtzen fr weitere informationen ber die sicherheit der mitarbeiter bei amazon besuchen sie fr weitere informationen ber die partnerschaft besuchen sie die ausgangssprache der der originaltext verffentlicht wird ist die offizielle und autorisierte version bersetzungen werden zur besseren verstndigung mitgeliefert nur die sprachversion die im original verffentlicht wurde ist rechtsgltig gleichen sie deshalb bersetzungen mit der originalen sprachversion der verffentlichung ab,-0.9986,-0.4993,0.1947320513,-0.694032051,Negative Impact
14/06/2021,167.3415,169.25,166.78,169.19,169.19,51394000,3.3,50.56966791,1.192,0,13.66057312,0.8419472675,0.2413396506,0.08,271.696,14174.13965,16662.41992,7146.700195,6616.350098,3589.75,52551.53125,20157.69922,164.8293494,160.5658449,162.9879073,156.1526812,162.692749,167.9569085,157.4285896,69.95861636,0.810414719,-0.157851981,0.9682667004,2.224391392,160.537024,10671574000,99.46895396,96.18449171,16.38999939,"Google, Facebook, Amazon and more urge SEC to mandate regular climate reports","The tech industry has been a been vocal on climate issues in the past, even as employees have pressed the companies themselves to do better.",https://www.cnbc.com/2021/06/14/google-facebook-amazon-and-more-urge-sec-to-mandate-regular-climate-reports.html,cnbc.com,9,tech industry vocal climate issue past even employee pressed company better,0.4404,0.39636,0.3323425,0.0640175,Positive Impact
15/06/2021,169.2,169.85,168.16,169.16,169.16,48524000,3.3,50.56966791,1.192,0,13.66057312,0.8419472675,0.2413396506,0.08,271.696,14072.86035,16655.81055,7172.5,6639.52002,3556.560059,52773.05078,20231.30078,164.9857492,160.5616273,163.2298127,156.2820724,162.9745987,168.976997,156.9722004,68.54153119,1.137182489,0.1011549126,1.036027576,2.109463283,161.5825811,10623050000,93.83417143,94.38091151,17.02000046,4 Best Long-Term Stocks to Buy to Profit From Life-Changing Trends,"Many trends were accelerated by the Covid-19 health crisis and have now become entrenched in our everyday lives. Looking forward, there are a number of companies that are at the forefront of these life-changing trends.",https://investorplace.com/2021/06/4-best-long-term-stocks-to-buy-to-profit-from-life-changing-trends/,investorplace.com,6,many trend accelerated covid health crisis become entrenched everyday life looking forward number company forefront lifechanging trend,-0.5859,-0.35154,0.07851352941,-0.430053529,Negative Impact
16/06/2021,169.6,171.32,168.03,170.76,170.76,84056000,3.3,50.56966791,1.192,0,13.66057312,0.8419472675,0.2413396506,0.08,271.696,14039.67969,16542.75977,7185,6652.649902,3518.330078,52501.98047,20231,165.1771793,160.5649899,163.5252121,156.4261562,163.4320236,170.325989,156.5380582,70.81057202,1.508351963,0.3825943226,1.12575764,2.211606707,162.7399501,10707106000,95.63243952,96.31185497,18.14999962,Google And Amazon Face Antitrust Accusations On The Hill,"Last week U.S. lawmakers fired a shot across Big Tech's bow, introducing five new bills designed to curb what lawmakers have described as ÃÂÃÂunregulated powerÃÂÃÂ held by the firms of Silicon Valley. If enacted, the legislation would mark the biggest changes to U.S. antitrust law in decades.",https://www.pymnts.com/antitrust/2021/google-and-amazon-face-antitrust-accusations-on-the-hill/,pymnts.com,5,last week u lawmaker fired shot across big tech bow introducing five new bill designed curb lawmaker described unregulated power held firm silicon valley enacted legislation would mark biggest change u antitrust law decade,-0.5574,-0.2787,0.3177927778,-0.596492778,Negative Impact
17/06/2021,170.159,174.86,170.05,174.46,174.46,102730000,3.3,50.56966791,1.192,0,13.66057312,0.8419472675,0.2413396506,0.08,271.696,14161.34961,16411.65039,7153.399902,6666.259766,3525.600098,52323.32813,20144,165.3870294,160.5745599,163.954106,156.6056174,164.0756241,172.4828279,155.6684203,82.42774849,2.077082561,0.7214919704,1.355590591,2.429749625,164.1123589,10809836000,97.55080003,95.67247033,17.75,Is Amazon Stock Overvalued? What To Consider,AMZN is a great company that operates in attractive industries and that has a huge moat and excellent management.,https://seekingalpha.com/article/4435357-is-amazon-stock-overvalued,seekingalpha.com,6,amzn great company operates attractive industry huge moat excellent management,0.9186,0.55116,0.2650736364,0.2860863636,Positive Impact
18/06/2021,173.9995,175.35,173.69,174.35,174.35,104954000,3.3,50.56966791,1.192,0,13.66057312,0.8419472675,0.2413396506,0.08,271.696,14030.37988,16143.9502,7017.5,6569.160156,3525.100098,52344.44922,19999.59961,165.5746295,160.5715049,164.361592,156.7821287,164.673674,174.2012557,155.1460923,83.40884464,2.489665072,1.075126591,1.414538482,2.447606768,166.0469344,10704882000,93.99638857,95.72654271,20.70000076,"Ferrari, Amazon's AWS enter agreement on data","Ferrari and Amazon Web Services (AWS) have entered an agreement to make Amazon's cloud computing unit the luxury carmaker's cloud storage, machine learning, and artificial intelligence provider, AWS said on Friday.",https://www.reuters.com/article/us-ferrari-amazon-data/ferrari-amazons-aws-enter-agreement-on-data-idUSKCN2DU115,reuters.com,10,ferrari amazon web service aws entered agreement make amazon cloud computing unit luxury carmaker cloud storage machine learning artificial intelligence provider aws said friday,0.8271,0.8271,0.2366076923,0.5904923077,Positive Impact
21/06/2021,173.821,174.10,171.70,172.70,172.70,65542000,3.3,50.56966791,1.192,0,13.66057312,0.8419472675,0.2413396506,0.08,271.696,14141.48047,16411.98047,7062.299805,6602.540039,3529.179932,52574.46094,20156.40039,165.6563895,160.5521324,164.6885099,156.9404955,165.3008736,175.2192262,155.382521,77.79009587,2.653156358,1.390732544,1.262423814,2.486821856,167.9075487,10639340000,84.15766316,91.90161726,17.88999939,Markets Bouncing Back from Rough Friday,"The Dow now looks to break its four-day losing streak, trading up 215 points in today's pre-market. The Nasdaq, which has not fared quite as badly of late, is up 28 points while the S&P 500 is +17.",https://www.zacks.com/stock/news/1742210/markets-bouncing-back-from-rough-friday,zacks.com,8,dow look break fourday losing streak trading point today premarket nasdaq fared quite badly late point sp,-0.7178,-0.57424,0.2239378788,-0.798177879,Negative Impact
22/06/2021,172.903,176.19,172.80,175.27,175.27,66902000,3.3,50.56966791,1.192,0,13.66057312,0.8419472675,0.2413396506,0.08,271.696,14253.26953,16449.00977,7090,6611.5,3557.409912,52588.71094,20200.69922,165.7824396,160.5864925,165.1035489,157.1228986,165.9519989,176.701867,155.2021308,79.53688724,2.956346164,1.703855268,1.252490896,2.639749799,169.3960402,10706242000,94.78359144,90.97921439,16.65999985,Amazon sees Prime Day sales boost amid supply chain snags,Amazon Prime Day saw strong online sales growth in the United States on Monday even as supply chain snafus and a robust spending appetite limited the level of discounts on popular products like electronics.,https://www.reuters.com/article/us-amazon-com-primeday/amazon-sees-prime-day-sales-boost-amid-supply-chain-snags-idUSKCN2DY22C,reuters.com,10,amazon prime day saw strong online sale growth united state monday even supply chain snafu robust spending appetite limited level discount popular product like electronics,0.8934,0.8934,0.1925376,0.7008624,Positive Impact
23/06/2021,175.25,176.05,174.16,175.19,175.19,56266000,3.3,50.56966791,1.192,0,13.66057312,0.8419472675,0.2413396506,0.08,271.696,14271.73047,16437.63086,7074.100098,6551.069824,3566.219971,52306.07813,20164.40039,165.8862595,160.6387924,165.499135,157.3026806,166.5639236,177.9682755,155.1595718,88.24815469,3.15373523,1.993831261,1.15990397,2.596322196,170.7546312,10649976000,94.32276354,91.08800605,16.31999969,Amazon wird grÃÂÃÂ¶ÃÂÃÂter Abnehmer erneuerbarer Energien in den USA,"SEATTLE, USA--(BUSINESS WIRE)--Amazon (NASDAQ: AMZN) hat heute 14 neue Projekte fÃÂÃÂ¼r erneuerbare Energien in den USA, Kanada, Finnland und Spanien angekÃÂÃÂ¼ndigt, um sein ehrgeiziges Ziel zu erreichen, bis 2025 100 % der UnternehmensaktivitÃÂÃÂ¤ten mit erneuerbarer Energie zu betreiben ÃÂÃÂ fÃÂÃÂ¼nf Jahre vor dem ursprÃÂÃÂ¼nglichen Ziel von 2030. Die neuen Projekte bringen Amazons bisherige Gesamtinvestition in erneuerbare Energien auf 10 Gigawatt (GW) StromproduktionskapazitÃÂÃÂ¤t ÃÂÃÂ genug, um 2,5 Millionen US-Haushalte mit Strom zu versorgen. Amazon ist heute der grÃÂÃÂ¶ÃÂÃÂte UnternehmenskÃÂÃÂ¤ufer von erneuerbarer Energie in den USA und der Welt. Die neuesten Solar- und Windprojekte im VersorgungsmaÃÂÃÂstab werden erneuerbare Energie fÃÂÃÂ¼r die UnternehmensbÃÂÃÂ¼ros, Fulfillment-Zentren und Amazon Web Services (AWS)-Rechenzentren von Amazon liefern, die Millionen von Kunden weltweit unterstÃÂÃÂ¼tzen. Diese Projekte werden Amazon auch dabei helfen, seiner Verpflichtung nachzukommen, genÃÂÃÂ¼gend erneuerbare Energie zu produzieren, um den Stromverbrauch aller verwendeten Echo-GerÃÂÃÂ¤te zu decken. Diese neuen Projekte unterstÃÂÃÂ¼tzen Hunderte von ArbeitsplÃÂÃÂ¤tzen und stellen gleichzeitig Hunderte Millionen Dollar an Investitionen in die lokalen Gemeinschaften bereit. ÃÂÃÂWir arbeiten hart daran, The Climate Pledge zu erfÃÂÃÂ¼llen ÃÂÃÂ unsere Verpflichtung, bis 2040, also 10 Jahre vor dem Pariser Abkommen, Netto-Null-CO2-Emissionen zu erreichenÃÂÃÂ, sagte Jeff Bezos, GrÃÂÃÂ¼nder und CEO von Amazon. ÃÂÃÂUnsere Investitionen in Wind- und Solarenergie in den USA und weltweit senden ein Signal, dass Investitionen in grÃÂÃÂ¼ne Technologien fÃÂÃÂ¼r den Planeten, die BÃÂÃÂ¼rger und den langfristigen Erfolg von Unternehmen aller GrÃÂÃÂ¶ÃÂÃÂen und Branchen weltweit das Richtige sind.ÃÂÃÂ Amazon wird nun weltweit ÃÂÃÂ¼ber insgesamt 232 erneuerbare Energieprojekte verfÃÂÃÂ¼gen, darunter 85 Wind- und Solarprojekte im VersorgermaÃÂÃÂstab und 147 SolardÃÂÃÂ¤cher in Einrichtungen und GeschÃÂÃÂ¤ften weltweit. Zu den 14 neuen Wind- und Solarprojekten in den USA, Kanada, Finnland und Spanien gehÃÂÃÂ¶ren: Neue Projekte in den USA: Zu den heute angekÃÂÃÂ¼ndigten elf US-amerikanischen Projekten gehÃÂÃÂ¶ren die ersten Solarprojekte von Amazon in Arkansas, Mississippi und Pennsylvania sowie weitere Projekte in Illinois, Kentucky, Indiana und Ohio. Insgesamt hat Amazon in den USA durch 54 Projekte mehr als 6 GW an erneuerbarer Energie ermÃÂÃÂ¶glicht. Unser grÃÂÃÂ¶ÃÂÃÂtes erneuerbares Energieprojekt in Kanada: Amazons zweites erneuerbares Energieprojekt in Alberta ist ein 375-Megawatt (MW) Solarpark ÃÂÃÂ der auch der grÃÂÃÂ¶ÃÂÃÂte des Landes ist. Wenn es 2022 online geht, wird der Solarpark die KapazitÃÂÃÂ¤t von Amazon in Kanada auf mehr als 1 Million Megawattstunden (MWh) bringen, genug, um mehr als 100.000 kanadische Haushalte mit Strom zu versorgen. Unser erstes erneuerbares Energieprojekt in Finnland: Amazons erstes Projekt in Finnland ist ein 52-MW-Windpark nahe der WestkÃÂÃÂ¼ste des Landes. Das Projekt soll 2022 mit der Energiegewinnung beginnen. ZusÃÂÃÂ¤tzliche Investitionen in Spanien: Das fÃÂÃÂ¼nfte Solarprojekt von Amazon in Spanien wird 152 MW erzeugen, wenn es 2023 Strom ins Netz einbringt, was die GesamtkapazitÃÂÃÂ¤t des Landes auf mehr als 520 MW erhÃÂÃÂ¶ht. Um die erneuerbaren Energieprojekte von Amazon auf der ganzen Welt zu sehen, besuchen Sie unsere interaktive Karte. ÃÂÃÂAmazons Engagement fÃÂÃÂ¼r saubere Energie ist sehr lobenswert und es ist die Art von Investition, von der wir mehr sehen mÃÂÃÂ¼ssen, um den kritischen Energie- und Klimabedarf der Welt zu deckenÃÂÃÂ, sagte Abigail Ross Hopper, PrÃÂÃÂ¤sidentin und CEO der Solar Energy Industries Association (SEIA). ÃÂÃÂEs wird immer deutlicher, dass Unternehmen wie Amazon Solarenergie und andere erneuerbare Ressourcen als den Weg in die Zukunft sehen, um ihren Energie- und GeschÃÂÃÂ¤ftsbedarf zu decken, und wir sind bereit, Amazon und andere Unternehmen jeder GrÃÂÃÂ¶ÃÂÃÂe bei ihrer Entscheidung fÃÂÃÂ¼r Solarenergie zu unterstÃÂÃÂ¼tzen.ÃÂÃÂ ÃÂÃÂUm die Dekarbonisierung des Stromsystems zu beschleunigen, sind neue Ambitionen im gesamten Privatsektor erforderlich. Die fÃÂÃÂ¼hrende Rolle von Amazon bei Investitionen und der EinfÃÂÃÂ¼hrung erneuerbarer Energien auf der ganzen Welt ebnet den Weg fÃÂÃÂ¼r neue Innovationen und die FÃÂÃÂ¤higkeit, in dem Tempo zu skalieren, das erforderlich ist, um die tatsÃÂÃÂ¤chlichen Bedrohungen des Planeten, der Menschen und der Unternehmen durch den Klimawandel zu bewÃÂÃÂ¤ltigenÃÂÃÂ, sagte Miranda Ballentine, CEO der Renewable Energy Buyers Alliance (REBA). ÃÂÃÂMit beeindruckenden 10 Gigawatt erneuerbarer EnergiekapazitÃÂÃÂ¤t in seinem Portfolio und dem Weg, sein Ziel von 100 % erneuerbarer Energie fÃÂÃÂ¼nf Jahre frÃÂÃÂ¼her als geplant zu erreichen, geht Amazon weiterhin den richtigen Weg, wenn es um die FÃÂÃÂ¼hrung von Unternehmen im Bereich saubere Energie gehtÃÂÃÂ, sagte Gregory Wetstone, PrÃÂÃÂ¤sident und CEO des American Council on Renewable Energy (ACORE). ÃÂÃÂDie erneuerbaren Projekte, die das Unternehmen heute angekÃÂÃÂ¼ndigt hat, werden den Gemeinden gut bezahlte ArbeitsplÃÂÃÂ¤tze und den erschwinglichen, schadstofffreien Strom bieten, den wir zur BekÃÂÃÂ¤mpfung der Klimakrise benÃÂÃÂ¶tigen.ÃÂÃÂ Im Jahr 2019 riefen Amazon und Global Optimism gemeinsam das Klimaschutzversprechen ÃÂÃÂThe Climate PledgeÃÂÃÂ ins Leben, eine Verpflichtung, die Vorgaben des Pariser Abkommens zehn Jahre frÃÂÃÂ¼her zu erreichen und bis 2040 klimaneutral zu sein. Das Klimaversprechen hat jetzt 108 Unterzeichner, darunter IBM, Unilever, PepsiCo, Visa, Verizon, Siemens, Microsoft und Best Buy. Um sein Ziel zu erreichen, wird Amazon die Emissionen in allen Bereichen seiner GeschÃÂÃÂ¤ftstÃÂÃÂ¤tigkeit weiter reduzieren, indem es echte GeschÃÂÃÂ¤ftsmaÃÂÃÂnahmen ergreift. Zu diesem Zweck wird das Unternehmen einen Weg finden, seinen Betrieb zu 100 % mit erneuerbaren Energien zu versorgen, fÃÂÃÂ¼nf Jahre vor dem ursprÃÂÃÂ¼nglichen Ziel des Unternehmens bis 2030; es wird seine ÃÂÃÂShipment ZeroÃÂÃÂ-Vision verwirklichen, wonach alle Lieferungen bis 2030 zu 50 % netto und letztlich ganz kohlenstofffrei sein sollen; und es wird 100.000 elektrische Lieferfahrzeuge kaufen, die bisher grÃÂÃÂ¶ÃÂÃÂte Bestellung von elektrischen Lieferfahrzeugen. Weiterhin sollen ÃÂÃÂ¼ber den Klimafonds (Climate Pledge Fund) 2 Mrd. US-Dollar in die Entwicklung von Diensten und LÃÂÃÂ¶sungen zur Kohlenstoffreduktion investiert werden. Weitere Informationen finden Sie unter https://sustainability.aboutamazon.com/. ÃÂÃÂber Amazon Amazon orientiert sich an vier GrundsÃÂÃÂ¤tzen: Orientierung am Kunden statt an der Konkurrenz, Leidenschaft fÃÂÃÂ¼r Neuerungen, Einsatz fÃÂÃÂ¼r betriebliche Optimierung sowie langfristiges Denken. Amazon strebt danach, das kundenorientierteste Unternehmen der Welt, der beste Arbeitgeber der Welt und der sicherste Arbeitsplatz der Welt zu sein. Kundenrezensionen, 1-Klick-EinkÃÂÃÂ¤ufe, personalisierte Empfehlungen, Prime, Versand durch Amazon, AWS, Kindle Direct Publishing, Kindle, Career Choice, Fire-Tablets, Fire TV, Amazon Echo, Alexa, Just Walk Out-Technologie, Amazon Studios und The Climate Pledge sind einige der Pionierleistungen von Amazon. FÃÂÃÂ¼r weitere Informationen besuchen Sie amazon.com/about und folgen Sie @AmazonNews. ÃÂÃÂber Amazon Web Services Seit 15 Jahren ist Amazon Web Services die umfassendste und am weitesten verbreitete Cloud-Plattform der Welt. AWS hat seine Services kontinuierlich erweitert, um nahezu jeden Cloud-Workload zu unterstÃÂÃÂ¼tzen, und verfÃÂÃÂ¼gt heute ÃÂÃÂ¼ber mehr als 200 voll funktionsfÃÂÃÂ¤hige Services in den Bereichen Rechenleistung, Speicherung, Datenbanken, Netzwerke, Analytik, maschinelles Lernen und kÃÂÃÂ¼nstliche Intelligenz (KI), Internet der Dinge (IoT), Mobile, Sicherheit, Hybrid, Virtual und Augmented Reality (VR und AR), Medien sowie Anwendungsentwicklung, -bereitstellung und -verwaltung aus 81 VerfÃÂÃÂ¼gbarkeitszonen in 25 geografischen Regionen, mit der AnkÃÂÃÂ¼ndigung von 21 weiteren VerfÃÂÃÂ¼gbarkeitszonen (Availability Zones, AZs) und sieben weiteren AWS-Regionen in Australien, Indien, Indonesien, Israel, Spanien, der Schweiz und den Vereinigten Arabischen Emiraten. Millionen von Kunden ÃÂÃÂ darunter die wachstumsstÃÂÃÂ¤rksten Start-ups, die grÃÂÃÂ¶ÃÂÃÂten Konzerne und fÃÂÃÂ¼hrende RegierungsbehÃÂÃÂ¶rden ÃÂÃÂ verlassen sich auf AWS, um ihre Infrastruktur anzutreiben, agiler zu werden und Kosten zu senken. Mehr Informationen zu AWS erhalten Sie unter aws.amazon.com. Die Ausgangssprache, in der der Originaltext verÃÂÃÂ¶ffentlicht wird, ist die offizielle und autorisierte Version. ÃÂÃÂbersetzungen werden zur besseren VerstÃÂÃÂ¤ndigung mitgeliefert. Nur die Sprachversion, die im Original verÃÂÃÂ¶ffentlicht wurde, ist rechtsgÃÂÃÂ¼ltig. Gleichen Sie deshalb ÃÂÃÂbersetzungen mit der originalen Sprachversion der VerÃÂÃÂ¶ffentlichung ab.",https://www.businesswire.com/news/home/20210623005936/de/,businesswire.com,5,seattle usabusiness wireamazon nasdaq amzn hat heute neue projekte fr erneuerbare energien den usa kanada finnland und spanien angekndigt um sein ehrgeiziges ziel zu erreichen bi der unternehmensaktivitten mit erneuerbarer energie zu betreiben fnf jahre vor dem ursprnglichen ziel von die neuen projekte bringen amazon bisherige gesamtinvestition erneuerbare energien auf gigawatt gw stromproduktionskapazitt genug um millionen ushaushalte mit strom zu versorgen amazon ist heute der grte unternehmenskufer von erneuerbarer energie den usa und der welt die neuesten solar und windprojekte im versorgungsmastab werden erneuerbare energie fr die unternehmensbros fulfillmentzentren und amazon web service awsrechenzentren von amazon liefern die millionen von kunden weltweit untersttzen diese projekte werden amazon auch dabei helfen seiner verpflichtung nachzukommen gengend erneuerbare energie zu produzieren um den stromverbrauch aller verwendeten echogerte zu decken diese neuen projekte untersttzen hunderte von arbeitspltzen und stellen gleichzeitig hunderte millionen dollar investitionen die lokalen gemeinschaften bereit wir arbeiten hart daran climate pledge zu erfllen unsere verpflichtung bi also jahre vor dem pariser abkommen nettonullcoemissionen zu erreichen sagte jeff bezos grnder und ceo von amazon unsere investitionen wind und solarenergie den usa und weltweit senden ein signal das investitionen grne technologien fr den planeten die brger und den langfristigen erfolg von unternehmen aller gren und branchen weltweit da richtige sind amazon wird nun weltweit ber insgesamt erneuerbare energieprojekte verfgen darunter wind und solarprojekte im versorgermastab und solardcher einrichtungen und geschften weltweit zu den neuen wind und solarprojekten den usa kanada finnland und spanien gehren neue projekte den usa zu den heute angekndigten elf usamerikanischen projekten gehren die ersten solarprojekte von amazon arkansas mississippi und pennsylvania sowie weitere projekte illinois kentucky indiana und ohio insgesamt hat amazon den usa durch projekte mehr al gw erneuerbarer energie ermglicht unser grtes erneuerbares energieprojekt kanada amazon zweites erneuerbares energieprojekt alberta ist ein megawatt mw solarpark der auch der grte de landes ist wenn e online geht wird der solarpark die kapazitt von amazon kanada auf mehr al million megawattstunden mwh bringen genug um mehr al kanadische haushalte mit strom zu versorgen unser erstes erneuerbares energieprojekt finnland amazon erstes projekt finnland ist ein mwwindpark nahe der westkste de landes da projekt soll mit der energiegewinnung beginnen zustzliche investitionen spanien da fnfte solarprojekt von amazon spanien wird mw erzeugen wenn e strom in netz einbringt die gesamtkapazitt de landes auf mehr al mw erhht um die erneuerbaren energieprojekte von amazon auf der ganzen welt zu sehen besuchen sie unsere interaktive karte amazon engagement fr saubere energie ist sehr lobenswert und e ist die art von investition von der wir mehr sehen mssen um den kritischen energie und klimabedarf der welt zu decken sagte abigail ross hopper prsidentin und ceo der solar energy industry association seia e wird immer deutlicher das unternehmen wie amazon solarenergie und andere erneuerbare ressourcen al den weg die zukunft sehen um ihren energie und geschftsbedarf zu decken und wir sind bereit amazon und andere unternehmen jeder gre bei ihrer entscheidung fr solarenergie zu untersttzen um die dekarbonisierung de stromsystems zu beschleunigen sind neue ambitionen im gesamten privatsektor erforderlich die fhrende rolle von amazon bei investitionen und der einfhrung erneuerbarer energien auf der ganzen welt ebnet den weg fr neue innovationen und die fhigkeit dem tempo zu skalieren da erforderlich ist um die tatschlichen bedrohungen de planeten der menschen und der unternehmen durch den klimawandel zu bewltigen sagte miranda ballentine ceo der renewable energy buyer alliance reba mit beeindruckenden gigawatt erneuerbarer energiekapazitt seinem portfolio und dem weg sein ziel von erneuerbarer energie fnf jahre frher al geplant zu erreichen geht amazon weiterhin den richtigen weg wenn e um die fhrung von unternehmen im bereich saubere energie geht sagte gregory wetstone prsident und ceo de american council renewable energy acore die erneuerbaren projekte die da unternehmen heute angekndigt hat werden den gemeinden gut bezahlte arbeitspltze und den erschwinglichen schadstofffreien strom bieten den wir zur bekmpfung der klimakrise bentigen im jahr riefen amazon und global optimism gemeinsam da klimaschutzversprechen climate pledge in leben eine verpflichtung die vorgaben de pariser abkommens zehn jahre frher zu erreichen und bi klimaneutral zu sein da klimaversprechen hat jetzt unterzeichner darunter ibm unilever pepsico visa verizon siemens microsoft und best buy um sein ziel zu erreichen wird amazon die emissionen allen bereichen seiner geschftsttigkeit weiter reduzieren indem e echte geschftsmanahmen ergreift zu diesem zweck wird da unternehmen einen weg finden seinen betrieb zu mit erneuerbaren energien zu versorgen fnf jahre vor dem ursprnglichen ziel de unternehmens bi e wird seine shipment zerovision verwirklichen wonach alle lieferungen bi zu netto und letztlich ganz kohlenstofffrei sein sollen und e wird elektrische lieferfahrzeuge kaufen die bisher grte bestellung von elektrischen lieferfahrzeugen weiterhin sollen ber den klimafonds climate pledge fund mrd usdollar die entwicklung von diensten und lsungen zur kohlenstoffreduktion investiert werden weitere informationen finden sie unter ber amazon amazon orientiert sich vier grundstzen orientierung kunden statt der konkurrenz leidenschaft fr neuerungen einsatz fr betriebliche optimierung sowie langfristiges denken amazon strebt danach da kundenorientierteste unternehmen der welt der beste arbeitgeber der welt und der sicherste arbeitsplatz der welt zu sein kundenrezensionen klickeinkufe personalisierte empfehlungen prime versand durch amazon aws kindle direct publishing kindle career choice firetablets fire tv amazon echo alexa walk outtechnologie amazon studio und climate pledge sind einige der pionierleistungen von amazon fr weitere informationen besuchen sie amazoncomabout und folgen sie amazonnews ber amazon web service seit jahren ist amazon web service die umfassendste und weitesten verbreitete cloudplattform der welt aws hat seine service kontinuierlich erweitert um nahezu jeden cloudworkload zu untersttzen und verfgt heute ber mehr al voll funktionsfhige service den bereichen rechenleistung speicherung datenbanken netzwerke analytik maschinelles lernen und knstliche intelligenz ki internet der dinge iot mobile sicherheit hybrid virtual und augmented reality vr und ar medien sowie anwendungsentwicklung bereitstellung und verwaltung au verfgbarkeitszonen geografischen regionen mit der ankndigung von weiteren verfgbarkeitszonen availability zone az und sieben weiteren awsregionen australien indien indonesien israel spanien der schweiz und den vereinigten arabischen emiraten millionen von kunden darunter die wachstumsstrksten startup die grten konzerne und fhrende regierungsbehrden verlassen sich auf aws um ihre infrastruktur anzutreiben agiler zu werden und kosten zu senken mehr informationen zu aws erhalten sie unter awsamazoncom die ausgangssprache der der originaltext verffentlicht wird ist die offizielle und autorisierte version bersetzungen werden zur besseren verstndigung mitgeliefert nur die sprachversion die im original verffentlicht wurde ist rechtsgltig gleichen sie deshalb bersetzungen mit der originalen sprachversion der verffentlichung ab,-0.9975,-0.49875,0.2203807317,-0.719130732,Negative Impact
24/06/2021,175.382,176.24,171.54,172.45,172.45,76640000,3.3,50.56966791,1.192,0,13.66057312,0.8419472675,0.2413396506,0.08,271.696,14369.70996,16558.61914,7110,6631.149902,3566.649902,52699,20215.09961,166.0023395,160.7136024,165.7718746,157.45344,167.0237236,178.6069861,155.4404611,77.00359617,3.054108638,2.205886736,0.8482219019,2.810678755,176.1889954,10573336000,78.51186747,89.20607415,15.97000027,"Amazon has spent billions to get within a 1-hour delivery distance of many U.S. customers, but Walmart and Target are still winning that race",Walmart and Target are among the retailers that have turned their brick-and-mortar locations into assets after e-commerce threatened to make stores a liability.,https://www.marketwatch.com/story/amazon-has-spent-billions-to-get-within-a-1-hour-delivery-distance-of-many-u-s-customers-but-walmart-and-target-are-still-winning-that-race-11624565328,marketwatch.com,8,walmart target among retailer turned brickandmortar location asset ecommerce threatened make store liability,-0.3182,-0.25456,0.2349551852,-0.489515185,Negative Impact
25/06/2021,173.2,173.24,169.71,170.07,170.07,78820000,3.3,50.56966791,1.192,0,13.66057312,0.8419472675,0.2413396506,0.08,271.696,14360.38965,16658.78906,7136.100098,6622.870117,3607.560059,52925.03906,20230.30078,166.0247095,160.7468149,165.9405461,157.5790077,167.4520988,178.8075423,156.0966554,70.7988202,2.7513119,2.314971769,0.4363401308,2.93510764,176.2429962,10494516000,59.78491993,77.53985031,15.61999989,4 Stocks to Track Amid Growing Demand for PaaS,"PaaS is witnessing rapid adoption, owing to advantages like reduced time and scalability, making it wise to look at names like Alphabet (GOOGL), Microsoft (MSFT), Amazon (AMZN) and Oracle (ORCL).",https://www.zacks.com/stock/news/1754107/4-stocks-to-track-amid-growing-demand-for-paas,zacks.com,8,paas witnessing rapid adoption owing advantage like reduced time scalability making wise look name like alphabet googl microsoft msft amazon amzn oracle orcl,0.8689,0.69512,0.040893,0.654227,Positive Impact
28/06/2021,170.8,172.40,170.68,172.19,172.19,44856000,3.3,50.56966791,1.192,0,13.66057312,0.8419472675,0.2413396506,0.08,271.696,14500.50977,16573.7207,7073,6558.02002,3606.370117,52735.58984,20145.30078,166.0691595,160.8140099,166.1857993,157.7244355,168.0041489,179.1417275,156.8665702,69.3137253,2.651960931,2.382369601,0.2695913296,2.810178484,176.2429962,10539372000,68.14215609,68.81298116,15.76000023,"Big tech and healthcare stocks stand to lose most from potential Biden tax hikes, BlackRock says","Another potential pain point could come with a domestic tax hike, as the Biden administration considers funding options for its infrastructure package.",https://markets.businessinsider.com/news/stocks/stock-market-impact-biden-tax-hike-big-tech-healthcare-blackrock-2021-06,markets.businessinsider.com,5,another potential pain point could come domestic tax hike biden administration considers funding option infrastructure package,-0.5106,-0.2553,0.319324,-0.574624,Negative Impact
29/06/2021,171.941,172.80,171.15,172.41,172.41,41968000,3.3,50.56966791,1.192,0,13.66057312,0.8419472675,0.2413396506,0.08,271.696,14528.33008,16547.57031,7087.600098,6567.430176,3573.179932,52549.66016,20171,166.1452896,160.8969899,166.4297679,157.8705307,168.577874,179.3580747,157.7976733,68.44662714,2.560851156,2.418065912,0.1427852437,2.808500017,175.9816364,10581340000,68.51997711,65.48235104,16.02000046,Amazon competitor Shopify cuts app store fees for developers on first $1 million in revenue,"The decision follows similar moves by Apple, Google and others who have reduced app store fees amid growing criticism from developers and regulators.",https://www.cnbc.com/2021/06/29/shopify-cuts-app-store-fees-for-developers-on-first-1-million-in-revenue.html,cnbc.com,9,decision follows similar move apple google others reduced app store fee amid growing criticism developer regulator,-0.296,-0.2664,0.2354541667,-0.501854167,Negative Impact
30/06/2021,172.053,173.58,171.75,172.01,172.01,48080000,3.3,50.56966791,1.192,0,13.66057312,0.8419472675,0.2413396506,0.08,271.696,14503.9502,16555.34961,7037.5,6507.830078,3591.199951,52482.71094,20165.59961,166.2507596,160.9812874,166.6485219,158.011202,169.0932991,179.4668567,158.7197415,61.54138911,2.428456139,2.420143958,0.008312181653,2.689749581,175.7307309,10533260000,55.74941168,64.13718163,15.82999992,Amazon Wants FTC Chair Lina Khan to Recuse Herself From Antitrust Matters,"The tech giant made the request in a petition to the agency, citing Khan's history of criticizing it as a threat to competition.",https://www.barrons.com/articles/amazon-wants-ftc-chair-lina-khan-to-recuse-herself-on-antitrust-matters-51625078762,barrons.com,9,tech giant made request petition agency citing khan history criticizing threat competition,-0.7096,-0.63864,0.1058318182,-0.744471818,Negative Impact
01/07/2021,171.7305,172.85,170.47,171.65,171.65,40742000,3.3,50.56966791,1.192,0,13.66057312,0.8419472675,0.2413396506,0.1,273.003,14522.37988,16640.96094,7125.200195,6553.819824,3588.780029,52318.60156,20165.59961,166.3217096,161.0504974,166.8445994,158.1468965,169.7081993,179.057509,160.3588896,60.86306282,2.268375307,2.389790227,-0.12141492,2.741358076,175.4898616,10492518000,51.47342041,58.5809364,15.47999954,Online Grocery Delivery Demand to Prevail: 4 Stocks to Watch,"To capitalize on flourishing online demand for grocery, companies are steadily bolstering their delivery capabilities to offer a convenient shopping experience.",https://www.zacks.com/stock/news/1756533/online-grocery-delivery-demand-to-prevail-4-stocks-to-watch,zacks.com,8,capitalize flourishing online demand grocery company steadily bolstering delivery capability offer convenient shopping experience,-0.128,-0.1024,0.207114375,-0.309514375,Negative Impact
02/07/2021,172.582,175.59,171.85,175.55,175.55,63388000,3.3,50.56966791,1.192,0,13.66057312,0.8419472675,0.2413396506,0.1,273.003,14639.33008,16674.84961,7123.299805,6552.859863,3518.76001,52484.67188,20226.09961,166.5236496,161.1587173,167.1859483,158.3200517,170.4700989,179.0466076,161.8935902,64.52849722,2.428256213,2.397483425,0.03077278873,2.845821926,169.7089996,10555906000,91.5535697,66.2588006,15.06999969,Japanischer rekordverdÃÂÃÂ¤chtiger Anime-Blockbuster-Film EVANGELION:3.0+1.01 THRICE UPON A TIME startet am 13. August exklusiv auf Amazon Prime Video,"LONDON, Vereinigtes KÃÂÃÂ¶nigreich--(BUSINESS WIRE)--Amazon Prime Video kÃÂÃÂ¼ndigte heute die exklusive Weltpremiere (auÃÂÃÂerhalb Japans) des mit Spannung erwarteten japanischen Anime-Blockbusters EVANGELION:3.0+1.01 THRICE UPON A TIME am 13. August an. EVANGELION:3.0+1.01 THRICE UPON A TIME ist die vierte und letzte Episode der neuen Kinofassung von Evangelion. Der Anime-Film ÃÂÃÂ der umsatzstÃÂÃÂ¤rkste aller Filme von Chefregisseur Hideaki Anno und meistgesehene Film in den japanischen Kinos im Jahr 2021 ÃÂÃÂ wurde von den Regisseuren Kazuya Tsurumaki, Katsuichi Nakayama und Mahiro Maeda sowie dem legendÃÂÃÂ¤ren SchÃÂÃÂ¶pfer, Drehbuchautor und Chefregisseur Hideaki Anno (Shin Godzilla) produziert. Um das Finale des Franchise gebÃÂÃÂ¼hrend zu feiern, wird Prime Video zusÃÂÃÂ¤tzlich die drei vorherigen Filme, EVANGELION:1.11 YOU ARE (NOT) ALONE., EVANGELION:2.22 YOU CAN (NOT) ADVANCE., EVANGELION:3.33 YOU CAN (NOT) REDO. , fÃÂÃÂ¼r Fans in mehr als 240 LÃÂÃÂ¤ndern und Regionen verÃÂÃÂ¶ffentlichen. Das Blockbuster-Franchise ist ein japanisches Anime-Popkultur-PhÃÂÃÂ¤nomen, das auf der Geschichte von Evangelion, einem synthetischen Menschen und einer humanoiden Mehrzweckwaffe, und den Angels, einer unbekannten Lebensform, basiert. Die Geschichte spielt, nachdem die Erde durch ein katastrophales Ereignis erschÃÂÃÂ¼ttert wurde. Der Film ist mit allen Original-Synchronsprechern besetzt, darunter Megumi Ogata, Megumi Hayashibara, YÃÂÃÂ»ko Miyamura, und nutzt die neueste Bildtechnik, um die PersÃÂÃÂ¶nlichkeiten und Beziehungen der einzigartigen Charaktere im Kampf ums ÃÂÃÂberleben zu zeigen. Er wird in 10 Sprachen vertont sein, darunter Englisch, FranzÃÂÃÂ¶sisch, Deutsch, Portugiesisch, Spanisch und Italienisch, und bietet Untertitel in 28 Sprachen. Seit der ersten Ausstrahlung der TV-Serie im Jahr 1995 hat das Evangelion-Franchise einen maÃÂÃÂgeblichen Einfluss auf die japanische Popkultur und hat das Anime-Genre weltweit bekannt gemacht. Das legendÃÂÃÂ¤re Anime-Franchise wurde dann als neue Filmreihe wiedergeboren Evangelion: New Theatrical Edition im Jahr 2007 und dieser vierte und letzte Film, der im MÃÂÃÂ¤rz in den japanischen Kinos anlief, brach Rekorde, sowohl in Bezug auf die Filme von Hideaki Anno als auch als meistgesehener Kinofilm des Jahres in Japan. EVANGELION:3.0+1.01 THRICE UPON A TIME auf Amazon Prime Video wird die neueste Version des Films sein, die auch ÃÂÃÂ¼berarbeitete Szenen enthÃÂÃÂ¤lt und jetzt in Japan in die Kinos kommt. ÃÂÃÂDie EVANGELION-Filme begeistern die Fans seit Jahren und wir sind uns sicher, dass es weltweit einen riesigen Appetit auf das Finale gibtÃÂÃÂ, sagte Brad Beale, Vice President fÃÂÃÂ¼r den Bereich ÃÂÃÂWorldwide Content Licensing Prime VideoÃÂÃÂ. ÃÂÃÂIch freue mich sehr darÃÂÃÂ¼ber, dass Prime-Mitglieder weltweit endlich die MÃÂÃÂ¶glichkeit haben, das Anime-Meisterwerk EVANGELION:3.0+1.01 THRICE UPON A TIME, sowie die drei vorherigen Filme zu sehen.ÃÂÃÂ ÃÂÃÂIch mÃÂÃÂ¶chte mich bei jedem Eva-Fan weltweit fÃÂÃÂ¼r die anhaltende UnterstÃÂÃÂ¼tzung bedankenÃÂÃÂ, sagte Hideaki Anno, SchÃÂÃÂ¶pfer, Drehbuchautor und Chef-Regisseur. ÃÂÃÂWir haben nach der besten MÃÂÃÂ¶glichkeit gesucht, den Fans in ÃÂÃÂbersee in einer schwierigen Situation mit Kinos zur Zeit von COVID-19 den Film so frÃÂÃÂ¼h wie mÃÂÃÂ¶glich anzubieten, und sind froh, Prime Video als Partner fÃÂÃÂ¼r das weltweite Streaming des Films gefunden zu haben. Wir kÃÂÃÂ¶nnen nur empfehlen, den Film auf einem groÃÂÃÂen TV-Bildschirm anzuschauen, um das beste Filmerlebnis zu haben.ÃÂÃÂ ÃÂÃÂBEREVANGELION:3.0+1.01 THRICE UPON A TIME Die vierte und letzte Folge von ÃÂÃÂRebuild of EvangelionÃÂÃÂ. Misato und ihre Anti-Nerv-Gruppe Wille erreichen Paris, eine Stadt, die nun rot von der Core-ization ist. Die Crew des Flaggschiffs Wunder landet auf einem Sicherheitsturm. Sie haben nur 720 Sekunden Zeit, um die Stadt wiederaufzubauen. Als eine Horde von Nerv-Evas erscheint, muss die verbesserte Eva-Einheit 8 von Mari sie abfangen. In der Zwischenzeit streifen Shinji, Asuka und Rei (vorlÃÂÃÂ¤ufiger Name) durch Japan. Studio: khara, Inc. Chef-Regisseur: Hideaki Anno, Regie: Kazuya Tsurumaki, Katsuichi Nakayama und Mahiro Maeda, Drehbuchautor: Hideaki Anno ÃÂÃÂBER DIE DREI VORANGEHENDEN FILME EVANGELION:1.11 YOU ARE (NOT) ALONE. Durch den Second Impact gezeichnet, greift der vierte Engel Tokio III an und das Schicksal der Menschheit liegt in den HÃÂÃÂ¤nden der SonderregierungsbehÃÂÃÂ¶rde Nerv. Der junge Shinji Ikari wird gezwungen, EVA-01 zu steuern. Er und die EVA-00-Pilotin Rei Ayanami werden beauftragt, zu kÃÂÃÂ¤mpfen, aber EVA-01 wird vom Sechsten Engel beschÃÂÃÂ¤digt. Misato Katsuragi entwickelt einen Plan, um die gesamte ElektrizitÃÂÃÂ¤t Japans in der Positronenkanone von EVA-01 zu bÃÂÃÂ¼ndeln, um den Engel zu besiegen. Studio: khara, Inc. Chef-Regisseur: Hideaki Anno, Regie: Masayuki und Kazuya Tsurumaki, Drehbuchautor: Hideaki Anno EVANGELION:2.22 YOU CAN (NOT) ADVANCE. Mari Illustrious-Makinami steuert die Provisional Unit-05, um den ausgehobenen Dritten Engel zu besiegen. Asuka Langley-Shikinami und EVA-02 besiegen den Siebten Engel. Der Achte Engel tritt in Erscheinung und greift das Hauptquartier von Nerv an. EVA-03 wird wÃÂÃÂ¤hrend des Tests vom Neunten Engel in Beschlag genommen und Shinji macht sich auf, um ihn zu stoppen, erfÃÂÃÂ¤hrt aber, dass Asuka an Bord ist. Gendo schaltet die Steuerung von EVA-01 auf das Dummy-System um und beginnt mit dem Kampf gegen EVA-03. Studio: khara, Inc. Chef-Regisseur: Hideaki Anno, Regie: Masayuki und Kazuya Tsurumaki, Drehbuchautor: Hideaki Anno EVANGELION:3.33 YOU CAN (NOT) REDO. Shinji wacht nach 14 Jahren an Bord des Schlachtschiffs AAA Wunder auf, das zu einer von ehemaligen Nerv-Mitgliedern gegrÃÂÃÂ¼ndeten Anti-Nerv-Organisation gehÃÂÃÂ¶rt. Shinji hÃÂÃÂ¶rt Reis Stimme aus EVA Mark.09, entsandt um ihn zu retten, also verlÃÂÃÂ¤sst er Wunder und geht zu Nerv. Kaworu Nagisa zeigt Shinji das transformierte Land. Er erfÃÂÃÂ¤hrt, dass die Rettung von Rei den Near Third Impact ausgelÃÂÃÂ¶st hat, der den verheerenden Schaden auf der Erde verursacht hat. Studio: khara, Inc. Chef-Regisseur: Hideaki Anno, Regie: Masayuki, Mahiro Maeda und Kazuya Tsurumaki, Drehbuchautor: Hideaki Anno EVANGELION:3.0+1.01 THRICE UPON A TIME wird sich zu den vielen tausend TV-Shows und Filmen im Prime-Video-Katalog gesellen, darunter preisgekrÃÂÃÂ¶nte und von Kritikern hochgelobte weltweite Amazon Originals wie Borat Anschluss Moviefilm, Tom Clancys Jack Ryan, The Boys, Hunters, Fleabag, und The Marvelous Mrs. Maisel. All das ist auf Prime Video verfÃÂÃÂ¼gbar, ohne zusÃÂÃÂ¤tzliche Kosten fÃÂÃÂ¼r Prime-Mitglieder. Prime-Mitglieder kÃÂÃÂ¶nnen EVANGELION:3.0+1.01 THRICE UPON A TIME ÃÂÃÂ¼berall und jederzeit in der Prime-Video-App fÃÂÃÂ¼r Smart-TVs, MobilgerÃÂÃÂ¤te, Fire TV, Fire TV-Stick, Fire-Tablets sowie Apple TV sehen und online streamen. In der Prime-Video-App kÃÂÃÂ¶nnen Prime-Mitglieder Episoden auf ihre MobilgerÃÂÃÂ¤te und Tablets herunterladen und sie ÃÂÃÂ¼berall offline ansehen. Amazon Amazon orientiert sich an vier GrundsÃÂÃÂ¤tzen: Orientierung am Kunden statt an der Konkurrenz, Leidenschaft fÃÂÃÂ¼r Neuerungen, Einsatz fÃÂÃÂ¼r betriebliche Optimierung sowie langfristiges Denken. Kundenrezensionen, 1-Klick-EinkÃÂÃÂ¤ufe, persÃÂÃÂ¶nliche Empfehlungen, Prime, Versand durch Amazon, AWS, Kindle Direct Publishing, Kindle, Fire-Tablets, Fire TV, Amazon Echo und Alexa sind nur einige der von Amazon angebotenen Produkte und Dienstleistungen. FÃÂÃÂ¼r weitere Informationen besuchen Sie amazon.com/about und folgen Sie @AmazonNews. Die Ausgangssprache, in der der Originaltext verÃÂÃÂ¶ffentlicht wird, ist die offizielle und autorisierte Version. ÃÂÃÂbersetzungen werden zur besseren VerstÃÂÃÂ¤ndigung mitgeliefert. Nur die Sprachversion, die im Original verÃÂÃÂ¶ffentlicht wurde, ist rechtsgÃÂÃÂ¼ltig. Gleichen Sie deshalb ÃÂÃÂbersetzungen mit der originalen Sprachversion der VerÃÂÃÂ¶ffentlichung ab.",https://www.businesswire.com/news/home/20210702005321/de/,businesswire.com,5,london vereinigtes knigreichbusiness wireamazon prime video kndigte heute die exklusive weltpremiere auerhalb japan de mit spannung erwarteten japanischen animeblockbusters evangelion thrice upon time august evangelion thrice upon time ist die vierte und letzte episode der neuen kinofassung von evangelion der animefilm der umsatzstrkste aller filme von chefregisseur hideaki anno und meistgesehene film den japanischen kino im jahr wurde von den regisseuren kazuya tsurumaki katsuichi nakayama und mahiro maeda sowie dem legendren schpfer drehbuchautor und chefregisseur hideaki anno shin godzilla produziert um da finale de franchise gebhrend zu feiern wird prime video zustzlich die drei vorherigen filme evangelion alone evangelion advance evangelion redo fr fan mehr al lndern und regionen verffentlichen da blockbusterfranchise ist ein japanisches animepopkulturphnomen da auf der geschichte von evangelion einem synthetischen menschen und einer humanoiden mehrzweckwaffe und den angel einer unbekannten lebensform basiert die geschichte spielt nachdem die erde durch ein katastrophales ereignis erschttert wurde der film ist mit allen originalsynchronsprechern besetzt darunter megumi ogata megumi hayashibara yko miyamura und nutzt die neueste bildtechnik um die persnlichkeiten und beziehungen der einzigartigen charaktere im kampf ums berleben zu zeigen er wird sprachen vertont sein darunter englisch franzsisch deutsch portugiesisch spanisch und italienisch und bietet untertitel sprachen seit der ersten ausstrahlung der tvserie im jahr hat da evangelionfranchise einen mageblichen einfluss auf die japanische popkultur und hat da animegenre weltweit bekannt gemacht da legendre animefranchise wurde dann al neue filmreihe wiedergeboren evangelion new theatrical edition im jahr und dieser vierte und letzte film der im mrz den japanischen kino anlief brach rekorde sowohl bezug auf die filme von hideaki anno al auch al meistgesehener kinofilm de jahres japan evangelion thrice upon time auf amazon prime video wird die neueste version de film sein die auch berarbeitete szenen enthlt und jetzt japan die kino kommt die evangelionfilme begeistern die fan seit jahren und wir sind un sicher das e weltweit einen riesigen appetit auf da finale gibt sagte brad beale vice president fr den bereich worldwide content licensing prime video ich freue mich sehr darber das primemitglieder weltweit endlich die mglichkeit haben da animemeisterwerk evangelion thrice upon time sowie die drei vorherigen filme zu sehen ich mchte mich bei jedem evafan weltweit fr die anhaltende untersttzung bedanken sagte hideaki anno schpfer drehbuchautor und chefregisseur wir haben nach der besten mglichkeit gesucht den fan bersee einer schwierigen situation mit kino zur zeit von covid den film frh wie mglich anzubieten und sind froh prime video al partner fr da weltweite streaming de film gefunden zu haben wir knnen nur empfehlen den film auf einem groen tvbildschirm anzuschauen um da beste filmerlebnis zu haben berevangelion thrice upon time die vierte und letzte folge von rebuild evangelion misato und ihre antinervgruppe wille erreichen paris eine stadt die nun rot von der coreization ist die crew de flaggschiffs wunder landet auf einem sicherheitsturm sie haben nur sekunden zeit um die stadt wiederaufzubauen al eine horde von nervevas erscheint mus die verbesserte evaeinheit von mari sie abfangen der zwischenzeit streifen shinji asuka und rei vorlufiger name durch japan studio khara inc chefregisseur hideaki anno regie kazuya tsurumaki katsuichi nakayama und mahiro maeda drehbuchautor hideaki anno ber die drei vorangehenden filme evangelion alone durch den second impact gezeichnet greift der vierte engel tokio iii und da schicksal der menschheit liegt den hnden der sonderregierungsbehrde nerv der junge shinji ikari wird gezwungen eva zu steuern er und die evapilotin rei ayanami werden beauftragt zu kmpfen aber eva wird vom sechsten engel beschdigt misato katsuragi entwickelt einen plan um die gesamte elektrizitt japan der positronenkanone von eva zu bndeln um den engel zu besiegen studio khara inc chefregisseur hideaki anno regie masayuki und kazuya tsurumaki drehbuchautor hideaki anno evangelion advance mari illustriousmakinami steuert die provisional unit um den ausgehobenen dritten engel zu besiegen asuka langleyshikinami und eva besiegen den siebten engel der achte engel tritt erscheinung und greift da hauptquartier von nerv eva wird whrend de test vom neunten engel beschlag genommen und shinji macht sich auf um ihn zu stoppen erfhrt aber das asuka bord ist gendo schaltet die steuerung von eva auf da dummysystem um und beginnt mit dem kampf gegen eva studio khara inc chefregisseur hideaki anno regie masayuki und kazuya tsurumaki drehbuchautor hideaki anno evangelion redo shinji wacht nach jahren bord de schlachtschiffs aaa wunder auf da zu einer von ehemaligen nervmitgliedern gegrndeten antinervorganisation gehrt shinji hrt real stimme au eva mark entsandt um ihn zu retten also verlsst er wunder und geht zu nerv kaworu nagisa zeigt shinji da transformierte land er erfhrt das die rettung von rei den near third impact ausgelst hat der den verheerenden schaden auf der erde verursacht hat studio khara inc chefregisseur hideaki anno regie masayuki mahiro maeda und kazuya tsurumaki drehbuchautor hideaki anno evangelion thrice upon time wird sich zu den vielen tausend tvshows und filmen im primevideokatalog gesellen darunter preisgekrnte und von kritikern hochgelobte weltweite amazon original wie borat anschluss moviefilm tom clancys jack ryan boy hunter fleabag und marvelous mr maisel da ist auf prime video verfgbar ohne zustzliche kosten fr primemitglieder primemitglieder knnen evangelion thrice upon time berall und jederzeit der primevideoapp fr smarttvs mobilgerte fire tv fire tvstick firetablets sowie apple tv sehen und online streamen der primevideoapp knnen primemitglieder episoden auf ihre mobilgerte und tablet herunterladen und sie berall offline ansehen amazon amazon orientiert sich vier grundstzen orientierung kunden statt der konkurrenz leidenschaft fr neuerungen einsatz fr betriebliche optimierung sowie langfristiges denken kundenrezensionen klickeinkufe persnliche empfehlungen prime versand durch amazon aws kindle direct publishing kindle firetablets fire tv amazon echo und alexa sind nur einige der von amazon angebotenen produkte und dienstleistungen fr weitere informationen besuchen sie amazoncomabout und folgen sie amazonnews die ausgangssprache der der originaltext verffentlicht wird ist die offizielle und autorisierte version bersetzungen werden zur besseren verstndigung mitgeliefert nur die sprachversion die im original verffentlicht wurde ist rechtsgltig gleichen sie deshalb bersetzungen mit der originalen sprachversion der verffentlichung ab,-0.999,-0.4995,0.1473028571,-0.646802857,Negative Impact
06/07/2021,176.5055,184.27,176.45,183.79,183.79,134896000,3.3,50.56966791,1.192,0,13.66057312,0.8419472675,0.2413396506,0.1,273.003,14663.63965,16542.75,7100.899902,6507.47998,3530.26001,52861.17969,20300,166.8585095,161.3254699,167.83697,158.5734542,171.6644241,180.6847354,162.6441128,74.3245595,3.183009515,2.554588643,0.6284208725,3.34803663,169.8265396,10690802000,97.00261834,80.00986949,16.44000053,Nobody wins as DoD finally pulls the plug on controversial $10B JEDI contract,"After several years of fighting and jockeying for position by the biggest cloud infrastructure companies in the world, the Pentagon finally pulled the plug on the controversial winner-take-all $10 billion JEDI contract today. In the end, nobody won.",https://techcrunch.com/2021/07/06/nobody-wins-as-dod-finally-pulls-the-plug-on-controversial-10b-jedi-contract/,techcrunch.com,5,several year fighting jockeying position biggest cloud infrastructure company world pentagon finally pulled plug controversial winnertakeall billion jedi contract today end nobody,-0.5106,-0.2553,0.2388604348,-0.494160435,Negative Impact
07/07/2021,185.869,186.71,183.95,184.83,184.83,106562000,3.3,50.56966791,1.192,0,13.66057312,0.8419472675,0.2413396506,0.1,273.003,14665.05957,16559.31055,7151,6527.720215,3553.719971,53054.76172,20290.59961,167.1460895,161.5108874,168.503324,158.8347033,172.7455986,182.6383117,162.8528855,73.83382904,3.821188721,2.807908658,1.013280063,3.321751186,170.4044381,10797364000,88.93587919,92.49735574,16.20000076,Internet Stocks Boost E-commerce Game: Is Amazon Under Threat?,"Growing e-commerce initiatives by companies like Etsy, Shopify, Facebook and Google to challenge Amazon's (AMZN) dominance in the online retail space.",https://www.zacks.com/stock/news/1758598/internet-stocks-boost-e-commerce-game-is-amazon-under-threat,zacks.com,8,growing ecommerce initiative company like etsy shopify facebook google challenge amazon amzn dominance online retail space,0.7184,0.57472,0.254565,0.320155,Positive Impact
08/07/2021,182.178,188.00,181.06,186.57,186.57,103612000,3.3,50.56966791,1.192,0,13.66057312,0.8419472675,0.2413396506,0.1,273.003,14559.78027,16359.7002,7030.700195,6396.72998,3525.5,52568.94141,20061.19922,167.4600693,161.7036224,169.2118405,159.1106814,173.8712486,184.6822109,163.0602864,71.9742736,4.416563509,3.129639629,1.286923881,3.474143982,171.3827722,10900976000,92.18719498,92.70856417,19,Major banks still tagged for funding Amazon destruction,"Some banks are shifting away from financing development of the vulnerable Amazon rainforest but most in the financial sector are still playing some role, their critics say, in fueling corruption, human rights violations and environmental harms despite commitments that increasingly part of the popular Environmental, Social and Governance (ESG) investing movement.",https://www.marketwatch.com/story/major-banks-still-tagged-for-funding-amazon-destruction-11625717044,marketwatch.com,8,bank shifting away financing development vulnerable amazon rainforest financial sector still playing role critic say fueling corruption human right violation environmental harm despite commitment increasingly part popular environmental social governance esg investing movement,-0.7639,-0.61112,0.1699073333,-0.781027333,Negative Impact
09/07/2021,186.126,187.40,184.67,185.97,185.97,74964000,3.3,50.56966791,1.192,0,13.66057312,0.8419472675,0.2413396506,0.1,273.003,14701.91992,16633.30078,7121.899902,6529.419922,3524.090088,52386.19141,20258,167.7209091,161.8512099,169.8689054,159.3779084,174.7954735,186.4354447,163.1555022,70.72542625,4.78455155,3.460622013,1.323929537,3.550250462,172.7121102,10826012000,88.88766533,90.00357983,16.18000031,U.S. judge ends Amazon challenge to $10 billion cloud contract after Pentagon cancellation,A U.S. judge on Friday dismissed Amazon.com's legal challenge to the 2019 U.S. Defense Department decision to award a $10 billion JEDI cloud-computing project to rival Microsoft Corp after the Pentagon canceled the contract.,https://www.reuters.com/legal/government/us-judge-ends-amazon-challenge-10-bln-cloud-contract-after-pentagon-cancellation-2021-07-09/,reuters.com,10,u judge friday dismissed amazoncoms legal challenge u defense department decision award billion jedi cloudcomputing project rival microsoft corp pentagon canceled contract,0.7003,0.7003,0.1864642857,0.5138357143,Positive Impact
12/07/2021,187.2,187.86,184.84,185.93,185.93,51432000,3.3,50.56966791,1.192,0,13.66057312,0.8419472675,0.2413396506,0.1,273.003,14733.24023,16673.14063,7125.399902,6559.25,3547.840088,52372.69141,20233.09961,167.9681491,162.0308824,170.4986544,159.6420835,175.7247734,187.8179291,163.6316177,75.02697516,5.015186286,3.771534867,1.243651418,3.577393668,173.9351011,10774580000,88.67176225,89.91554085,16.17000008,Carbon Capture And Storage Companies To Consider,Carbon Capture And Storage Companies To Consider,https://seekingalpha.com/article/4438777-carbon-capture-and-storage-companies-to-consider,seekingalpha.com,6,carbon capture storage company consider,0,0,0.34078,-0.34078,Negative Impact
13/07/2021,185.105,188.65,183.57,183.87,183.87,76918000,3.3,50.56966791,1.192,0,13.66057312,0.8419472675,0.2413396506,0.1,273.003,14677.65039,16575.76953,7124.700195,6558.470215,3566.52002,52769.73047,20270.69922,168.178089,162.1952749,171.0229423,159.8831373,176.4584984,188.6633156,164.2536811,66.58433578,4.974438558,4.012115606,0.9623229521,3.691466195,175.0602527,10697662000,74.73735079,84.09892612,17.12000084,"Google is in the hottest antitrust seat, but Apple and the rest of Big Tech shouldn't breathe easy","Now facing a fifth government antitrust lawsuit, Google appears to be the biggest target in the wave of Big Tech investigations around the world. But the internet giant is far from alone.",https://www.marketwatch.com/story/google-is-in-the-hottest-antitrust-seat-but-apple-and-the-rest-of-big-tech-shouldnt-breathe-easy-11626189078,marketwatch.com,8,facing fifth government antitrust lawsuit google appears biggest target wave big tech investigation around world internet giant far alone,-0.4404,-0.35232,0.1768322222,-0.529152222,Negative Impact
14/07/2021,185.4425,185.88,183.04,184.08,184.08,65932000,3.3,50.56966791,1.192,0,13.66057312,0.8419472675,0.2413396506,0.1,273.003,14644.9502,16543.7793,7091.200195,6558.379883,3528.5,52904.05078,20147.19922,168.4732791,162.3419124,171.5351406,160.1239419,177.2048737,189.3551252,165.0546221,67.06845634,4.903055983,4.190303681,0.7127523018,3.759429932,176.4196281,10763594000,75.87751091,79.76220798,16.32999992,2 Tech Stocks to Buy at Discounts and Hold for Long-Term Growth,Some tech names with impressive growth outlooks are still trading at discounts. Let's dive into two of these stocks investors might want to consider as long-term buy and hold candidates.,https://www.zacks.com/stock/news/1761741/2-tech-stocks-to-buy-at-discounts-and-hold-for-long-term-growth,zacks.com,8,tech name impressive growth outlook still trading discount let dive two stock investor might want consider longterm buy hold candidate,0.7351,0.58808,0.2737422222,0.3143377778,Positive Impact
15/07/2021,184.71,184.77,181.05,181.56,181.56,63706000,3.3,50.56966791,1.192,0,13.66057312,0.8419472675,0.2413396506,0.1,273.003,14543.12988,16499.06055,7012,6493.359863,3564.590088,53158.85156,20183.69922,168.7926089,162.4561999,171.9282723,160.337236,177.7447487,189.6467122,165.8427851,67.6213401,4.589909287,4.270224802,0.319684485,3.689679827,177.643066,10699888000,62.55472865,71.05653012,17.01000023,5 Spectacular FAANG Stock Earnings Charts,4 out of the 5 FAANG stocks are hitting all-time highs. Is this the best it will ever be for big cap tech?,https://www.zacks.com/stock/news/1762085/5-spectacular-faang-stock-earnings-charts,zacks.com,8,faang stock hitting alltime high best ever big cap tech,0.6369,0.50952,0.2366584615,0.2728615385,Positive Impact
16/07/2021,181.6655,182.30,178.52,178.68,178.68,80874000,3.3,50.56966791,1.192,0,13.66057312,0.8419472675,0.2413396506,0.1,273.003,14427.24023,16364.66016,7008.100098,6460.080078,3539.300049,53140.05859,19985.5,169.0956992,162.5633874,172.1931049,160.519766,177.9557236,189.7618807,166.1495664,66.34392148,4.062636302,4.228707102,-0.1660708,3.707394191,188.654007,10619014000,45.15483677,61.19569211,18.45000076,Why the Vanguard Russell 1000 Growth Index ETF Returned 13% in the First Half of 2021,This exchange-traded fund is a play on large-cap U.S. growth stocks.,https://www.fool.com/investing/2021/07/16/why-the-vanguard-russell-1000-growth-index-etf-ret/,fool.com,7,exchangetraded fund play largecap u growth stock,0.6124,0.42868,0.2258757143,0.2028042857,Positive Impact
19/07/2021,176.629,177.51,174.96,177.48,177.48,75692000,3.3,50.56966791,1.192,0,13.66057312,0.8419472675,0.2413396506,0.1,273.003,14274.98047,16052.70996,6844.399902,6295.970215,3539.120117,52553.39844,19726.5,169.3389194,162.6636024,172.4004148,160.6885197,178.1124489,189.7994061,166.4254916,60.39700732,3.507347129,4.084435107,-0.577087979,3.807145255,188.4513867,10543322000,38.54429434,48.75128659,22.5,AWS Announces General Availability of Amazon EBS io2 Block Express Volumes,SEATTLE--(BUSINESS WIRE)-- #aws--AWS Announces General Availability of Amazon EBS io2 Block Express Volumes,https://www.businesswire.com/news/home/20210719005806/en/AWS-Announces-General-Availability-of-Amazon-EBS-io2-Block-Express-Volumes/,businesswire.com,5,seattlebusiness wire awsaws announces general availability amazon eb io block express volume,-0.296,-0.148,0.3080957143,-0.456095714,Negative Impact
20/07/2021,178.366,179.60,175.90,178.66,178.66,65114000,3.3,50.56966791,1.192,0,13.66057312,0.8419472675,0.2413396506,0.1,273.003,14498.87988,16321.94043,6881.100098,6346.850098,3536.790039,52198.51172,19942.69922,169.6204993,162.7515849,172.6458691,160.8673354,178.410524,189.8167514,167.0042965,61.84927371,3.12645221,3.892838528,-0.766386318,3.953575134,187.911651,10608436000,45.03382727,42.91098613,19.72999954,Amazon Earnings on July 29: Will They Crush Expectations Again?,Investors will soon learn how the early stages of the broad reopening of the U.S. economy affected the e-commerce titan's results for the second quarter of 2021.,https://www.fool.com/investing/2021/07/20/amazon-earnings-on-july-29-will-they-crush-expecta/,fool.com,7,investor soon learn early stage broad reopening u economy affected ecommerce titan result second quarter,-0.1531,-0.10717,0.267825,-0.374995,Negative Impact
21/07/2021,178.819,179.32,177.18,179.26,179.26,46380000,3.3,50.56966791,1.192,0,13.66057312,0.8419472675,0.2413396506,0.1,273.003,14631.9502,16503.4707,6998.299805,6464.47998,3562.660889,52198.51172,20110.09961,170.015209,162.8666349,172.9052466,161.0503469,178.6099236,189.9241968,167.2956503,63.63928041,2.840303867,3.682331596,-0.842027729,3.975752694,187.3935046,10654816000,48.3363292,43.97148361,17.90999985,"Got $5,000? 5 Brand-Name Stocks That'll Make You Richer in July (and Beyond)","Buying time-tested, well-known businesses is an easy way to build wealth.",https://www.fool.com/investing/2021/07/21/got-5000-5-brand-name-stocks-make-you-richer-july/,fool.com,7,buying timetested wellknown business easy way build wealth,0.7269,0.50883,0.128445,0.380385,Positive Impact
22/07/2021,179.3615,182.00,179.11,181.90,181.90,65308000,3.3,50.56966791,1.192,0,13.66057312,0.8419472675,0.2413396506,0.1,273.003,14684.59961,16455.91992,6968.299805,6481.589844,3574.733887,52837.21094,20097.5,170.4293292,162.9763424,173.258041,161.2578212,178.9454491,190.2307873,167.6601108,67.75904985,2.794464181,3.504758113,-0.710293932,4.012074062,186.8960841,10720124000,59.82569699,51.06528449,17.69000053,Hells Bells - 2 Strong Sells,"On Wall Street, fortunes are made by ""buying right and holding on."" However, if you grossly overpay for even the world's highest quality companies, you court disaster.",https://seekingalpha.com/article/4440757-hells-bells-2-strong-sells,seekingalpha.com,6,wall street fortune made buying right holding however grossly overpay even world highest quality company court disaster,-0.7184,-0.43104,0.224472,-0.655512,Negative Impact
23/07/2021,182,183.31,181.10,182.83,182.83,48726000,3.3,50.56966791,1.192,0,13.66057312,0.8419472675,0.2413396506,0.1,273.003,14836.99023,16552.38086,7027.600098,6568.819824,3550.399902,52975.80078,20188.40039,170.9340292,163.1155124,173.6334904,161.4724896,179.4643494,190.4431398,168.4855589,64.06149006,2.80093177,3.363992844,-0.563061074,3.888216291,186.4185605,10768850000,57.49123757,55.21775458,17.20000076,Housing Prices Are Absurd. Don't Get Mad ÃÂÃÂ Get Even.,"The current situation around housing prices is not ideal. But if you play your cards right, you can profit from real estate moonshots.",https://investorplace.com/2021/07/housing-prices-are-absurd-dont-get-mad-get-even/,investorplace.com,6,current situation around housing price ideal play card right profit real estate moonshots,0.8271,0.49626,0.1183754545,0.3778845455,Positive Impact
26/07/2021,183.6585,185.60,182.36,184.99,184.99,58002000,3.3,50.56966791,1.192,0,13.66057312,0.8419472675,0.2413396506,0.1,273.003,14840.70996,16565.31055,7025.399902,6578.600098,3467.439941,52852.26953,20165,171.4723792,163.2415449,174.0788828,161.7065046,180.2102493,190.5084838,169.9120148,53.03763269,2.946307167,3.280455709,-0.334148542,3.496537345,185.9601378,10826852000,73.25492267,63.52395241,17.57999992,Amazon (AMZN) to Report Q2 Earnings: What's in the Cards?,"Amazon's (AMZN) second-quarter results are likely to reflect strong momentum across Prime, AWS, streaming services and the smart device portfolio.",https://www.zacks.com/stock/news/1767801/amazon-amzn-to-report-q2-earnings-what-s-in-the-cards,zacks.com,8,amazon amzn secondquarter result likely reflect strong momentum across prime aws streaming service smart device portfolio,0.7717,0.61736,0.162801,0.454559,Positive Impact
27/07/2021,184.925,184.93,179.31,181.32,181.32,82638000,3.3,50.56966791,1.192,0,13.66057312,0.8419472675,0.2413396506,0.1,273.003,14660.58008,16520.96094,6996.100098,6531.919922,3381.179932,52578.76172,20173.40039,171.8758691,163.3505049,174.3628288,161.9016588,180.6664993,190.2534394,171.0795592,42.18288404,2.733746445,3.171113856,-0.437367411,3.693715777,185.6040039,10744214000,46.44790114,59.06468713,19.36000061,"Why Nvidia, Facebook, Amazon, and Pinduoduo Fell Today","These tech companies suffered from broader market weakness, earnings reports from peers, and uncertainty around China-based stocks.",https://www.fool.com/investing/2021/07/27/why-nvidia-facebook-amazon-and-pinduoduo-fell-toda/,fool.com,7,tech company suffered broader market weakness earnings report peer uncertainty around chinabased stock,-0.8126,-0.56882,0.1206369231,-0.689456923,Negative Impact
28/07/2021,181.689,182.92,180.05,181.52,181.52,59988000,3.3,50.56966791,1.192,0,13.66057312,0.8419472675,0.2413396506,0.1,273.003,14762.58008,16573.56055,7016.600098,6609.310059,3361.590088,52443.71094,20230.40039,172.2357993,163.4364224,174.6433455,162.0968265,181.1219498,189.886992,172.3569075,37.90935603,2.551731889,3.047237463,-0.495505574,3.402823312,185.6040039,10804202000,47.88264471,55.86182284,18.30999947,Amazon Reports Earnings Thursday. Here's What to Expect.,The Street consensus calls for $115.4 billion in sales and $7.8 billion in operating income. There are several reasons why the estimates might be too low.,https://www.barrons.com/articles/amazon-reports-earnings-thursday-heres-what-to-expect-51627497584,barrons.com,9,street consensus call billion sale billion operating income several reason estimate might low,-0.2732,-0.24588,0.137446,-0.383326,Negative Impact
29/07/2021,181.3875,181.90,179.00,180.00,180.00,110400000,3.3,50.56966791,1.192,0,13.66057312,0.8419472675,0.2413396506,0.1,273.003,14778.25977,16697.14063,7078.399902,6633.77002,3411.719971,52653.07031,20311.80078,172.6034393,163.4756699,174.8532536,162.2749277,181.5213501,189.1981987,173.8445015,36.31697798,2.258794424,2.889548855,-0.630754431,3.414752415,185.1781635,10693802000,36.78449434,43.7050134,17.70000076,"TotalEnergies, Amazon form partnership on electricity supply and online strategy","TotalEnergies and Internet giant Amazon announced a collaboration, whereby French energy company would supply renewable electricity to the U.S. online retail giant, while Amazon would help TotalEnergies' digital strategy.",https://www.reuters.com/business/totalenergies-amazon-form-partnership-electricity-supply-online-strategy-2021-07-29/,reuters.com,10,totalenergies internet giant amazon announced collaboration whereby french energy company would supply renewable electricity u online retail giant amazon would help totalenergies digital strategy,0.7351,0.7351,0.2376408333,0.4974591667,Positive Impact
30/07/2021,167.3975,168.41,165.35,166.38,166.38,199312000,3.3,50.56966791,1.192,0,13.66057312,0.8419472675,0.2413396506,0.1,273.003,14672.67969,16602.28906,7032.299805,6612.759766,3397.360107,52586.83984,20287.80078,172.6992294,163.4466599,174.5209496,162.3157692,181.2579002,190.552503,171.9632975,22.38670145,0.9173271751,2.495104519,-1.577777344,4.244894845,184.7693566,10494490000,4.421806344,29.69631513,18.23999977,"Stocks open lower, with Nasdaq down 0.9% after Amazon results disappoint","Stocks opened lower Friday, with the tech-heavy Nasdaq Composite leading major averages to the downside after disappointing quarterly results from online-retailing juggernaut Amazon.com Inc. The Dow Jones Industrial Average was down 64 points, or 0.2%, at 35,021, while the S&P 500 declined 0.6% to 4,393.34. The Nasdaq dropped 0.9% to 14,645.47.",https://www.marketwatch.com/story/stocks-open-lower-with-nasdaq-down-09-after-amazon-results-disappoint-2021-07-30,marketwatch.com,8,stock opened lower friday techheavy nasdaq composite leading major average downside disappointing quarterly result onlineretailing juggernaut amazoncom inc dow jones industrial average point sp declined nasdaq dropped,-0.7506,-0.60048,0.04809489362,-0.648574894,Negative Impact
02/08/2021,167.655,167.95,165.85,166.57,166.57,67078000,3.3,50.56966791,1.192,0,13.66057312,0.8419472675,0.2413396506,0.09,273.567,14681.07031,16576.21094,7081.700195,6675.899902,3464.290039,52950.62891,20287.80078,172.7830295,163.4386024,174.2093047,162.3581398,180.8091507,191.9479729,169.6703285,24.21192935,-0.128617828,1.970360049,-2.098977878,4.031179156,183.6041352,10561568000,5.965746116,15.7240156,19.45999908,Amazon Adds Delivery Fee For Prime Customers Ordering From Whole Foods,"Amazon will be adding a delivery fee for customers on Prime shopping at Whole Foods, which shows the difficulty of the grocery market even for the world's largest online retailer, according to Bloomberg. Shoppers were recently informed of a $9.95 service delivery fee for deliveries starting Aug. 30, in the areas of Boston; Chicago; Manchester, [ÃÂÃÂ]",https://www.pymnts.com/amazon-delivery/2021/amazon-adds-delivery-fee-prime-customers-ordering-whole-foods/,pymnts.com,5,amazon adding delivery fee customer prime shopping whole food show difficulty grocery market even world largest online retailer according bloomberg shopper recently informed service delivery fee delivery starting aug area boston chicago manchester,-0.1779,-0.08895,0.2229036364,-0.311853636,Negative Impact
03/08/2021,167.036,169.55,164.99,168.31,168.31,83146000,3.3,50.56966791,1.192,0,13.66057312,0.8419472675,0.2413396506,0.09,273.567,14761.29004,16713.46094,7105.700195,6723.810059,3447.98999,53823.35938,20365.90039,172.9461893,163.4455,173.9780377,162.4173821,180.0354004,192.3871395,167.6836613,27.50262055,-0.807981496,1.41469174,-2.222673236,4.154037476,182.508827,10644714000,16.12136563,8.836306029,18.04000092,"Amazon interfered with union elections, says U.S. labor board","E-commerce giant Amazon.com Inc interfered with union election by installing a mailbox, threatening employees and hiring additional police, according to a report by the National Labor Relations Board's hearing officer.",https://www.reuters.com/article/us-amazon-com-unions/amazon-interfered-with-union-elections-says-u-s-labor-board-idUSKBN2F41MN,reuters.com,10,ecommerce giant amazoncom inc interfered union election installing mailbox threatening employee hiring additional police according report national labor relation board hearing officer,-0.5267,-0.5267,0.121391,-0.648091,Negative Impact
04/08/2021,168.9675,169.44,167.28,167.74,167.74,43678000,3.3,50.56966791,1.192,0,13.66057312,0.8419472675,0.2413396506,0.09,273.567,14780.53027,16594.48047,7123.899902,6746.22998,3477.219971,54369.76953,20329.69922,173.0559192,163.4660024,173.7332517,162.4703036,179.1807503,192.4660748,165.8954257,29.12095864,-1.376987751,0.8563558422,-2.233343593,4.042751857,181.1072004,10601036000,13.3273331,11.80481495,17.96999931,"Democrats urge Amazon, Facebook to stop campaigning for FTC Chair Khan's recusal in antitrust cases","The lawmakers said the petitions ""add to the perception that you are attempting to bully your regulators.""",https://www.cnbc.com/2021/08/04/democrats-urge-amazon-facebook-to-stop-campaigning-for-ftc-chairs-recusal.html,cnbc.com,9,lawmaker said petition add perception attempting bully regulator,-0.4939,-0.44451,0.2385936364,-0.683103636,Negative Impact
05/08/2021,167.811,169.45,167.05,168.80,168.80,48670000,3.3,50.56966791,1.192,0,13.66057312,0.8419472675,0.2413396506,0.09,273.567,14895.12012,16695.5,7120.399902,6781.189941,3466.550049,54492.83984,20375.5,173.1728592,163.5081974,173.5397712,162.5332807,178.2922005,191.870402,164.7139989,34.20900303,-1.722260032,0.3406326673,-2.062892699,3.944465637,179.817704,10649706000,18.48610496,15.9782679,17.28000069,"Amazon, Google and other tech companies join government effort to fight ransomware",Cyber attacks have become a more regular threat to U.S. organizations.,https://www.cnbc.com/2021/08/05/amazon-google-join-government-effort-to-fight-ransomware.html,cnbc.com,9,cyber attack become regular threat u organization,-0.7579,-0.68211,0.1175372222,-0.799647222,Negative Impact
06/08/2021,168.75,168.75,166.45,167.25,167.25,52752000,3.3,50.56966791,1.192,0,13.66057312,0.8419472675,0.2413396506,0.09,273.567,14835.75977,16748.08008,7123,6816.959961,3458.22998,54277.71875,20475.40039,173.2526392,163.5401799,173.2929956,162.5801833,177.3562004,191.2832138,163.429187,33.83003985,-2.0969922,-0.146892306,-1.950099894,3.846179417,178.6313673,10596954000,10.95534019,14.25625942,16.14999962,Amazon orders employees to wear masks regardless of vaccination status - Bloomberg News,"Amazon.com Inc has ordered employees to start wearing masks at work regardless of vaccination status, as a precautionary measure to fight the highly infectious COVID-19 Delta variant, Bloomberg News reported on Friday.",https://www.reuters.com/business/amazon-orders-employees-wear-masks-regardless-vaccination-status-bloomberg-news-2021-08-06/,reuters.com,10,amazoncom inc ordered employee start wearing mask work regardless vaccination status precautionary measure fight highly infectious covid delta variant bloomberg news reported friday,-0.3818,-0.3818,0.1410177273,-0.522817727,Negative Impact
09/08/2021,167.1805,167.74,166.43,167.09,167.09,42964000,3.3,50.56966791,1.192,0,13.66057312,0.8419472675,0.2413396506,0.09,273.567,14860.17969,16726.94922,7132.299805,6813.180176,3494.629883,54402.85156,20437.40039,173.3643994,163.5794125,173.0498784,162.625092,176.4145004,190.4478272,162.3811736,31.10995809,-2.378932502,-0.593300345,-1.785632157,3.67603629,177.5399375,10553990000,10.21081256,13.21741924,16.71999931,US Government Enlists Tech Firms' Help on Cybersecurity,The U.S. government has enlisted a trio of tech behemoths to help fight off an increasing spate of ransomware attacks.,https://www.investopedia.com/us-government-enlists-tech-firms-help-on-cybersecurity-5196484,investopedia.com,5,u government enlisted trio tech behemoth help fight increasing spate ransomware attack,-0.4588,-0.2294,0.2416993333,-0.471099333,Negative Impact
10/08/2021,167.2505,167.90,165.75,166.03,166.03,48252000,3.3,50.56966791,1.192,0,13.66057312,0.8419472675,0.2413396506,0.09,273.567,14788.08984,16792.7793,7161,6820.209961,3529.929932,54554.66016,20495.69922,173.4620093,163.6154824,172.7747457,162.6590114,175.5228004,189.8258029,161.219798,28.7178704,-2.657234818,-1.00608724,-1.651147578,3.676715306,176.5358221,10505738000,5.071432907,8.745861885,16.79000092,"Amazon to pay shoppers hurt by others' products, does not admit liability","Amazon.com Inc on Tuesday said it would pay customers who suffer injuries or property damage from defective goods others sell on its U.S. platform, in a new policy that could reduce litigation.",https://www.reuters.com/business/retail-consumer/amazon-pay-shoppers-hurt-by-others-products-does-not-admit-liability-2021-08-10/,reuters.com,10,amazoncom inc tuesday said would pay customer suffer injury property damage defective good others sell u platform new policy could reduce litigation,-0.8934,-0.8934,0.03345294118,-0.926852941,Negative Impact
11/08/2021,166.5725,166.89,163.89,164.61,164.61,58944000,3.3,50.56966791,1.192,0,13.66057312,0.8419472675,0.2413396506,0.09,273.567,14765.13965,16875.39063,7220.100098,6857.990234,3532.620117,54525.92969,20554,173.5354694,163.6374099,172.4543831,162.6783795,174.5488754,189.0486624,160.0490884,21.03816997,-2.958950266,-1.396659845,-1.562290421,3.684428624,175.6120359,10446794000,3.297350399,6.193198623,16.17000008,Taking Stock of the Impressive Earnings Picture,"With the bulk of the Q2 earnings season now behind us, we can now say with full confidence that the earnings picture has not been this good in a long time.",https://www.zacks.com/commentary/1780606/taking-stock-of-the-impressive-earnings-picture,zacks.com,8,bulk q earnings season behind u say full confidence earnings picture good long time,0.7351,0.58808,0.2898533333,0.2982266667,Positive Impact
12/08/2021,164.5,165.73,163.48,165.18,165.18,46282000,3.3,50.56966791,1.192,0,13.66057312,0.8419472675,0.2413396506,0.09,273.567,14816.25977,16871.11914,7193.200195,6882.470215,3524.73999,54843.98047,20520.59961,173.6049796,163.6615249,172.1689173,162.7032215,173.7296257,188.4118628,159.0473886,20.07187907,-3.116186281,-1.740565132,-1.375621149,3.687178476,174.4397819,10493076000,7.646743543,5.338508949,15.59000015,Wyndham Hotels & Resorts Selects AWS as Its Preferred Cloud Provider to Enhance Guest Experiences,"SEATTLE--(BUSINESS WIRE)--Today, Amazon Web Services, Inc. (AWS), an Amazon.com, Inc. company (NASDAQ: AMZN), announced a global collaboration with Wyndham Hotels & Resorts, Inc. (NYSE: WH), the worldÃÂÃÂs largest hotel franchising company, to upgrade its technology infrastructure and develop and deliver new guest services across its 21 hotel brandsÃÂÃÂincluding Days Inn, La Quinta, Microtel, Ramada, Super 8, and Wyndham. Moving to AWS enables Wyndham to enhance business performance, reinvest approximately 45% of reduced data center operating costs, and shut down additional physical datacenters, putting it on track to achieve its goal of running 90% of its infrastructure in the cloud. The announcement is part of WyndhamÃÂÃÂs multiyear digital transformation and investment in technology that automates hotel reservations, supports its franchisees by helping simplify operations, and enhances the guest experience across Wyndham properties globally. Wyndham began working with AWS in 2018 when it was spun off from Wyndham Worldwide and needed to quickly stand up its own IT infrastructure. The hotel company migrated its core reservation system, property management system, and data processing platform to AWS to more easily launch new services for franchisees and guests while also improving operational efficiency. Expanding its presence in the cloud will enable Wyndham to focus on growing its core hotel franchise businessÃÂÃÂseamlessly integrating new properties into its networkÃÂÃÂwhile leveraging AWSÃÂÃÂs proven global infrastructure to help meet demand where it arises post-pandemic during the peak summer travel season. For example, Wyndham will use AWS machine learning to help optimize over 90,000 daily rate changes across its approximately 9,000 hotels to help maximize occupancy rates that vary according to factors such as location, weather, and time of year. This will benefit Wyndham franchisees by helping them identify and offer the best rates, discounts, and stay rules appropriate for the geographic market, brand, and specific hotel. In addition, Wyndham will use AWS to develop new digital services for guests to automate check-in and leverage AWS partners to deliver customized offers during hotel stays, such as recommendations on local attractions, restaurants, and entertainment. During COVID-19, Wyndham leveraged AWS technologies to provide flexibility for franchisees and guests, helping them navigate evolving safety protocols. For example, Wyndham was able to launch a housekeeping application in just a few weeksÃÂÃÂ time to provide hotels with an updated checklist of protocols for cleaning staff. The app also gives franchisees the ability to run ÃÂÃÂlast-rentedÃÂÃÂ room reports to accommodate new guest requests to stay in rooms that have been vacant for more than 24 hours. Looking ahead, Wyndham will use AWS to remain agile and adapt to rapidly changing guest and market needs with plans to use AWS machine learning to drive demand with greater personalization and more timely and relevant guest offers. ÃÂÃÂWe are excited to expand our strategic relationship with AWS, the worldÃÂÃÂs leading and most comprehensive cloud provider, to create one-of-a-kind experiences for our guests and increase our operational efficiency on a global scale,ÃÂÃÂ said Scott Strickland, Executive Vice President and Chief Information Officer, Wyndham Hotels & Resorts. ÃÂÃÂBy moving the majority of our workloads to the cloud, Wyndham was able to rapidly respond to the changing business conditions brought on by COVID-19, and now weÃÂÃÂre positioned to scale our operations as different parts of the world begin to reopen. The agility we have gained in moving to the cloud, thanks to AWSÃÂÃÂs vast portfolio of cloud technologies, helps us expand our digital guest services and introduce new solutions and functionality for our franchisees in a matter of days rather than months.ÃÂÃÂ ÃÂÃÂThe hotel industry has faced a series of rapid changes recently, yet by running on AWS Wyndham gains the insights and agility it needs to support its franchisees, transform its customer engagement, service, and business models, and remain an industry leader,ÃÂÃÂ said Greg Pearson, Vice President, Worldwide Commercial Sales at Amazon Web Services, Inc. ÃÂÃÂLeveraging AWSÃÂÃÂs proven operating experience, global infrastructure, and unparalleled portfolio of cloud capabilities, Wyndham has the ability to scale its operations to every corner of the globe and drive innovations across its digital channels. This collaboration is helping Wyndham to become an even more resilient organization that can meet customersÃÂÃÂ ever-changing needs and build for whatÃÂÃÂs next.ÃÂÃÂ About Amazon Web Services For over 15 years, Amazon Web Services has been the worldÃÂÃÂs most comprehensive and broadly adopted cloud offering. AWS has been continually expanding its services to support virtually any cloud workload, and it now has more than 200 fully featured services for compute, storage, databases, networking, analytics, machine learning and artificial intelligence (AI), Internet of Things (IoT), mobile, security, hybrid, virtual and augmented reality (VR and AR), media, and application development, deployment, and management from 81 Availability Zones within 25 geographic regions, with announced plans for 21 more Availability Zones and seven more AWS Regions in Australia, India, Indonesia, Israel, Spain, Switzerland, and the United Arab Emirates. Millions of customersÃÂÃÂincluding the fastest-growing startups, largest enterprises, and leading government agenciesÃÂÃÂtrust AWS to power their infrastructure, become more agile, and lower costs. To learn more about AWS, visit aws.amazon.com. About Amazon Amazon is guided by four principles: customer obsession rather than competitor focus, passion for invention, commitment to operational excellence, and long-term thinking. Amazon strives to be EarthÃÂÃÂs Most Customer-Centric Company, EarthÃÂÃÂs Best Employer, and EarthÃÂÃÂs Safest Place to Work. Customer reviews, 1-Click shopping, personalized recommendations, Prime, Fulfillment by Amazon, AWS, Kindle Direct Publishing, Kindle, Career Choice, Fire tablets, Fire TV, Amazon Echo, Alexa, Just Walk Out technology, Amazon Studios, and The Climate Pledge are some of the things pioneered by Amazon. For more information, visit amazon.com/about and follow @AmazonNews. About Wyndham Hotels & Resorts Wyndham Hotels & Resorts (NYSE: WH) is the worldÃÂÃÂs largest hotel franchising company by the number of properties, with approximately 9,000 hotels across nearly 95 countries on six continents. Through its network of approximately 798,000 rooms appealing to the everyday traveler, Wyndham commands a leading presence in the economy and midscale segments of the lodging industry. The Company operates a portfolio of 21 hotel brands, including Super 8ÃÂÃÂ®, Days InnÃÂÃÂ®, RamadaÃÂÃÂ®, MicrotelÃÂÃÂ®, La QuintaÃÂÃÂ®, BaymontÃÂÃÂ®, WingateÃÂÃÂ®, AmericInnÃÂÃÂ®, Hawthorn SuitesÃÂÃÂ®, Trademark CollectionÃÂÃÂ® and WyndhamÃÂÃÂ®. Wyndham Hotels & Resorts is also a leading provider of hotel management services. The CompanyÃÂÃÂs award-winning Wyndham Rewards loyalty program offers 89 million enrolled members the opportunity to redeem points at thousands of hotels, vacation club resorts and vacation rentals globally. For more information, visit www.wyndhamhotels.com.",https://www.businesswire.com/news/home/20210811005880/en/Wyndham-Hotels-Resorts-Selects-AWS-as-Its-Preferred-Cloud-Provider-to-Enhance-Guest-Experiences,businesswire.com,5,seattlebusiness wiretoday amazon web service inc aws amazoncom inc company nasdaq amzn announced global collaboration wyndham hotel resort inc nyse wh world largest hotel franchising company upgrade technology infrastructure develop deliver new guest service across hotel brandsincluding day inn la quinta microtel ramada super wyndham moving aws enables wyndham enhance business performance reinvest approximately reduced data center operating cost shut additional physical datacenters putting track achieve goal running infrastructure cloud announcement part wyndhams multiyear digital transformation investment technology automates hotel reservation support franchisees helping simplify operation enhances guest experience across wyndham property globally wyndham began working aws spun wyndham worldwide needed quickly stand infrastructure hotel company migrated core reservation system property management system data processing platform aws easily launch new service franchisees guest also improving operational efficiency expanding presence cloud enable wyndham focus growing core hotel franchise businessseamlessly integrating new property networkwhile leveraging awss proven global infrastructure help meet demand arises postpandemic peak summer travel season example wyndham use aws machine learning help optimize daily rate change across approximately hotel help maximize occupancy rate vary according factor location weather time year benefit wyndham franchisees helping identify offer best rate discount stay rule appropriate geographic market brand specific hotel addition wyndham use aws develop new digital service guest automate checkin leverage aws partner deliver customized offer hotel stay recommendation local attraction restaurant entertainment covid wyndham leveraged aws technology provide flexibility franchisees guest helping navigate evolving safety protocol example wyndham able launch housekeeping application week time provide hotel updated checklist protocol cleaning staff app also give franchisees ability run lastrented room report accommodate new guest request stay room vacant hour looking ahead wyndham use aws remain agile adapt rapidly changing guest market need plan use aws machine learning drive demand greater personalization timely relevant guest offer excited expand strategic relationship aws world leading comprehensive cloud provider create oneofakind experience guest increase operational efficiency global scale said scott strickland executive vice president chief information officer wyndham hotel resort moving majority workload cloud wyndham able rapidly respond changing business condition brought covid positioned scale operation different part world begin reopen agility gained moving cloud thanks awss vast portfolio cloud technology help u expand digital guest service introduce new solution functionality franchisees matter day rather month hotel industry faced series rapid change recently yet running aws wyndham gain insight agility need support franchisees transform customer engagement service business model remain industry leader said greg pearson vice president worldwide commercial sale amazon web service inc leveraging awss proven operating experience global infrastructure unparalleled portfolio cloud capability wyndham ability scale operation every corner globe drive innovation across digital channel collaboration helping wyndham become even resilient organization meet customer everchanging need build whats next amazon web service year amazon web service world comprehensive broadly adopted cloud offering aws continually expanding service support virtually cloud workload fully featured service compute storage database networking analytics machine learning artificial intelligence ai internet thing iot mobile security hybrid virtual augmented reality vr ar medium application development deployment management availability zone within geographic region announced plan availability zone seven aws region australia india indonesia israel spain switzerland united arab emirate million customersincluding fastestgrowing startup largest enterprise leading government agenciestrust aws power infrastructure become agile lower cost learn aws visit awsamazoncom amazon amazon guided four principle customer obsession rather competitor focus passion invention commitment operational excellence longterm thinking amazon strives earth customercentric company earth best employer earth safest place work customer review click shopping personalized recommendation prime fulfillment amazon aws kindle direct publishing kindle career choice fire tablet fire tv amazon echo alexa walk technology amazon studio climate pledge thing pioneered amazon information visit amazoncomabout follow amazonnews wyndham hotel resort wyndham hotel resort nyse wh world largest hotel franchising company number property approximately hotel across nearly country six continent network approximately room appealing everyday traveler wyndham command leading presence economy midscale segment lodging industry company operates portfolio hotel brand including super day inn ramada microtel la quinta baymont wingate americinn hawthorn suite trademark collection wyndham wyndham hotel resort also leading provider hotel management service company awardwinning wyndham reward loyalty program offer million enrolled member opportunity redeem point thousand hotel vacation club resort vacation rental globally information visit,0.9991,0.49955,0.2486877778,0.2508622222,Positive Impact
13/08/2021,165.2835,165.30,164.15,164.70,164.70,41134000,3.3,50.56966791,1.192,0,13.66057312,0.8419472675,0.2413396506,0.09,273.567,14822.90039,16868.10938,7218.700195,6896.040039,3516.300049,55437.28906,20518.09961,173.7119397,163.6634349,171.8759598,162.723075,173.0304756,188.047745,158.0132063,13.52437187,-3.241876309,-2.040827368,-1.201048942,3.538035801,173.1250287,10451942000,5.666564664,5.536886202,15.44999981,"Facebook, Amazon seek U.S. approval to operate undersea data cable","Facebook Inc and Amazon.com Inc have asked the U.S. government for approval to operate a new undersea data cable between the Philippines and California after China Mobile agreed to exit the plan, a government agency said Friday.",https://www.reuters.com/article/us-facebook-amazon-com-cable/facebook-amazon-seek-u-s-approval-to-operate-undersea-data-cable-idUSKBN2FE1P4,reuters.com,10,facebook inc amazoncom inc asked u government approval operate new undersea data cable philippine california china mobile agreed exit plan government agency said friday,0.6369,0.6369,0.1128223077,0.5240776923,Positive Impact
16/08/2021,164.15,165.00,160.56,164.95,164.95,66394000,3.3,50.56966791,1.192,0,13.66057312,0.8419472675,0.2413396506,0.09,273.567,14793.75977,16836.74023,7154,6838.77002,3517.340088,55582.57813,20483.40039,173.8047095,163.6974873,171.6043336,162.7452284,172.4039749,187.6829293,157.1250205,16.44941228,-3.283384804,-2.289338855,-0.994045949,3.449463981,171.9680459,10518336000,19.64269145,10.98533322,16.12000084,Amazon: Worried About Antitrust? 3 Scenarios To Ease Your Mind,"Big Tech is on the hot seat as congress and the FTC seek to reign in the power and influence of these giants, namely Amazon, Apple, Facebook and Google.",https://seekingalpha.com/article/4449605-amazon-bigtech-antitrust-ease-your-mind,seekingalpha.com,6,big tech hot seat congress ftc seek reign power influence giant namely amazon apple facebook google,0.1779,0.10674,0.3208583333,-0.214118333,Negative Impact
17/08/2021,163.875,164.02,161.28,162.10,162.10,67758000,3.3,50.56966791,1.192,0,13.66057312,0.8419472675,0.2413396506,0.09,273.567,14656.17969,16707.13086,7181.100098,6819.839844,3446.976074,55792.26953,20363.59961,173.8486597,163.7052248,171.2315365,162.7387884,171.5759003,187.2182036,155.933597,14.10853028,-3.505957199,-2.532662524,-0.973294675,3.506213597,170.3704299,10450578000,7.223202565,10.84415289,17.90999985,Second Quarter Shows the Slow Build Is Underway for Stem,"Stem's efforts to bring utility grids into the 21st century is proceeding, but expect two more years of losses for STEM stock. The post Second Quarter Shows the Slow Build Is Underway for Stem appeared first on InvestorPlace.",https://investorplace.com/2021/08/second-quarter-shows-the-slow-build-is-underway-stem-stock/,investorplace.com,6,stem effort bring utility grid st century proceeding expect two year loss stem stock post second quarter show slow build underway stem appeared first investorplace,-0.3182,-0.19092,0.189893,-0.380813,Negative Impact
18/08/2021,162.0995,162.71,160.00,160.06,160.06,56086000,3.3,50.56966791,1.192,0,13.66057312,0.8419472675,0.2413396506,0.09,273.567,14525.91016,16550.33984,7169.299805,6770.109863,3485.285889,55629.48828,20302.09961,173.7857697,163.7464924,170.7934765,162.7121438,170.6159508,186.6248648,154.6070368,13.84394497,-3.802879283,-2.786705875,-1.016173407,3.492499215,168.9964802,10394492000,0.6387918238,9.168228612,21.56999969,Amazon warns merchants about antitrust bills in Congress,"Amazon.com Inc has warned some merchants selling via its marketplace that antitrust proposals in the U.S. Congress might hurt their business, a company spokesperson said.",https://www.reuters.com/technology/amazon-warns-merchants-about-antitrust-bills-congress-2021-08-18/,reuters.com,10,amazoncom inc warned merchant selling via marketplace antitrust proposal u congress might hurt business company spokesperson said,-0.6705,-0.6705,-0.02192,-0.64858,Negative Impact
19/08/2021,159.701,161.65,159.12,159.39,159.39,75658000,3.3,50.56966791,1.192,0,13.66057312,0.8419472675,0.2413396506,0.09,273.567,14541.79004,16429.14063,7058.899902,6605.890137,3465.554932,55629.48828,20215.40039,173.6923697,163.7923099,170.3461831,162.6790628,169.4902504,185.3230992,153.6574016,26.09571147,-4.045899999,-3.0385447,-1.007355299,2.626784188,167.5570434,10318834000,2.53664333,3.466212573,21.67000008,"Facebook and Amazon are rattled by Lina Khan, the new FTC chair","The antitrust regulator has Silicon Valley in her sights. Her agency filed an amended complaint against Facebook on Thursday, alleging an illegal monopoly.",https://www.cnet.com/news/facebook-and-amazon-are-rattled-by-lina-khan-the-new-ftc-chair/,cnet.com,5,antitrust regulator silicon valley sight agency filed amended complaint facebook thursday alleging illegal monopoly,-0.7003,-0.35015,0.1882758824,-0.538425882,Negative Impact
20/08/2021,160.1935,160.39,158.79,160.00,160.00,67168000,3.3,50.56966791,1.192,0,13.66057312,0.8419472675,0.2413396506,0.09,273.567,14714.66016,16516.67969,7087.899902,6626.109863,3427.333984,55329.32031,20339,173.5426697,163.8301949,169.9403523,162.6523805,168.3485252,183.4046662,153.2923843,28.13733268,-4.141532705,-3.259142301,-0.882390404,2.591535296,166.0389157,10386002000,11.2386378,4.804690984,18.55999947,Precarious Market Action,Precarious Market Action,https://www.zacks.com/registration/ultimatetrader/welcome/eoffer/30c3,zacks.com,8,precarious market action,0,0,0.2908209091,-0.290820909,Negative Impact
23/08/2021,160.595,164.05,160.50,163.29,163.29,65362000,3.3,50.56966791,1.192,0,13.66057312,0.8419472675,0.2413396506,0.09,273.567,14942.65039,16648.55078,7109,6683.100098,3477.129883,55555.78906,20477.30078,173.4617096,163.8363724,169.6796916,162.6587598,167.2636505,180.2560156,154.2712854,34.88269903,-3.906332467,-3.388580334,-0.517752132,2.554820469,164.5887315,10451364000,42.25761902,18.67763338,17.14999962,Amazon CEO Andy Jassy to join executives at White House cybersecurity meeting -source,"Amazon Inc Chief Executive Andy Jassy will join tech executives at a White House meeting with President Joe Biden on Wednesday to discuss efforts by private companies to improve cybersecurity, a source familiar with the matter told Reuters.",https://www.reuters.com/article/us-usa-cyber-infrastructure/amazon-ceo-andy-jassy-to-join-executives-at-white-house-cybersecurity-meeting-source-idUSKBN2FP03Z,reuters.com,10,amazon inc chief executive andy jassy join tech executive white house meeting president joe biden wednesday discus effort private company improve cybersecurity source familiar matter told reuters,0.7096,0.7096,0.2656457143,0.4439542857,Positive Impact
24/08/2021,164,165.77,163.73,165.29,165.29,51036000,3.3,50.56966791,1.192,0,13.66057312,0.8419472675,0.2413396506,0.09,273.567,15019.7998,16741.16016,7125.799805,6664.310059,3514.470947,55958.98047,20547.80078,173.3836197,163.8323174,169.5075076,162.6849314,166.4621254,177.656962,155.2672887,43.2095953,-3.518357088,-3.414535685,-0.103821403,2.577320644,158.7879944,10502400000,60.97360267,38.15661983,17.21999931,3 Stocks to Make the Most of Bitcoin's Bullish Trajectory,"JPMorgan (JPM), Intel (INTC) & PayPal (PYPL) at present are widely expected to benefit from the bitcoin's bullish trend and the blockchain technology that supports it.",https://www.zacks.com/stock/news/1785820/3-stocks-to-make-the-most-of-bitcoin-s-bullish-trajectory,zacks.com,8,jpmorgan jpm intel intc paypal pypl present widely expected benefit bitcoins bullish trend blockchain technology support,0.6908,0.55264,0.1415471429,0.4110928571,Positive Impact
25/08/2021,165.4935,166.05,164.31,164.96,164.96,33606000,3.3,50.56966791,1.192,0,13.66057312,0.8419472675,0.2413396506,0.09,273.567,15041.86035,16812.83984,7150.100098,6676.47998,3540.379883,55944.21094,20587.30078,173.2996698,163.8292699,169.3291348,162.7075589,165.6342751,174.3063606,156.9621895,38.8903357,-3.20061747,-3.371752042,0.1711345722,2.530071804,158.9277246,10468794000,61.94541027,55.05887732,16.79000092,2 Stocks to Help You Build Retirement Wealth,It doesn't get much better than this.,https://www.fool.com/investing/2021/08/25/2-stocks-to-help-you-build-retirement-wealth/,fool.com,7,doesnt get much better,-0.3412,-0.23884,0.1629228571,-0.401762857,Negative Impact
26/08/2021,164.95,166.60,164.80,165.80,165.80,41976000,3.3,50.56966791,1.192,0,13.66057312,0.8419472675,0.2413396506,0.09,273.567,14945.80957,16694.32031,7125,6666.029785,3501.664063,55949.10156,20504.19922,173.2004199,163.8723349,169.1907375,162.7383295,164.9244751,170.371174,159.4777762,45.63449244,-2.848113308,-3.267024295,0.4189109869,2.490964617,159.2126157,10510770000,76.95356719,66.62419338,18.84000015,"Big tech firms pledge more than $31 billion and 250,000 jobs to strengthen cybersecurity","At the White House, Google, Microsoft, IBM, Amazon, Apple, and others pledged more training and investments in new jobs to battle increasing attacks.",https://www.businessinsider.com/apple-amazon-google-microsoft-ibm-pledge-31-billion-to-cybersecurity-2021-8,businessinsider.com,7,white house google microsoft ibm amazon apple others pledged training investment new job battle increasing attack,-0.6124,-0.42868,0.2713085714,-0.699988571,Negative Impact
27/08/2021,166.6615,167.62,165.69,167.48,167.48,48048000,3.3,50.56966791,1.192,0,13.66057312,0.8419472675,0.2413396506,0.09,273.567,15129.5,16844.75,7148,6681.919922,3522.156982,56124.71875,20644.59961,173.0608099,163.9509874,169.1237088,162.7855253,164.9795753,170.5099051,159.4492456,51.07176456,-2.405340687,-3.094687574,0.6893468863,2.534570966,159.6558592,10558818000,95.4072918,78.10208975,16.38999939,"As Markets Set Records, Here's What Sent Affirm Holdings Skyrocketing After Hours Friday","Find out why the buy now, pay later specialist is on the move.",https://www.fool.com/investing/2021/08/27/as-markets-set-records-heres-what-sent-affirm-hold/,fool.com,7,find buy pay later specialist move,-0.1027,-0.07189,0.278338125,-0.350228125,Negative Impact
30/08/2021,167.8715,172.25,167.76,171.08,171.08,63844000,3.3,50.56966791,1.192,0,13.66057312,0.8419472675,0.2413396506,0.09,273.567,15265.88965,16819.63086,7148,6687.299805,3528.150879,56889.76172,20595,172.99548,164.0220324,169.2003675,162.8680425,165.2048004,171.3421207,159.0674801,62.22111322,-1.744087591,-2.824567577,1.080479986,2.721606663,160.2926702,10622662000,91.29777862,87.88621254,16.19000053,The Ratings Game: Affirm stock rockets as Amazon BNPL deal may tell a bigger story,Shares of Affirm Holdings Inc. are surging toward their best day on record Monday after a partnership arrangement with Amazon.com Inc. proved a big vote of confidence in the company's business model.,https://www.marketwatch.com/story/affirm-stock-rockets-as-amazon-bnpl-deal-may-tell-a-bigger-story-11630346558,marketwatch.com,8,share affirm holding inc surging toward best day record monday partnership arrangement amazoncom inc proved big vote confidence company business model,0.8658,0.69264,0.2897961111,0.4028438889,Positive Impact
31/08/2021,171.24,173.63,169.78,173.54,173.54,87128000,3.3,50.56966791,1.192,0,13.66057312,0.8419472675,0.2413396506,0.09,273.567,15259.24023,16806.43945,7119.700195,6680.180176,3543.939941,57552.39063,20582.90039,173.0123102,164.1121599,169.3705298,162.9742262,165.4661758,172.5352057,158.397146,70.61280876,-1.009817189,-2.4616175,1.45180031,2.782606942,161.4884032,10709790000,99.39698957,95.36735333,16.47999954,Amazon pushes deworming drug falsely touted as Covid treatment,The CDC and FDA have warned against using ivermectin as a treatment for Covid-19.,https://www.cnbc.com/2021/08/31/amazon-pushes-deworming-drug-falsely-touted-as-covid-treatment.html,cnbc.com,9,cdc fda warned using ivermectin treatment covid,-0.2732,-0.24588,0.1989353846,-0.444815385,Negative Impact
01/09/2021,174.82,176.35,173.76,173.95,173.95,72598000,3.3,50.56966791,1.192,0,13.66057312,0.8419472675,0.2413396506,0.08,274.31,15309.37988,16845.99023,7149.799805,6758.689941,3567.100098,57338.21094,20689.59961,172.9858701,164.1997073,169.5501167,163.0834379,165.7768761,173.7538901,157.799862,70.39558522,-0.390280427,-2.047350085,1.657069658,2.82321494,162.9452746,10782388000,86.3340875,92.3429519,16.11000061,"Amazon to block some autocomplete search results for ivermectin, amid misuse for COVID-19","Amazon said it plans to block some autocomplete responses to address concerns over ivermectin, an unproven treatment for COVID-19, coming up as a suggestion when users type ""iv"" in the shopping platform's search bar.",https://techxplore.com/news/2021-09-amazon-block-autocomplete-results-ivermectin.html,techxplore.com,5,amazon said plan block autocomplete response address concern ivermectin unproven treatment covid coming suggestion user type iv shopping platform search bar,-0.296,-0.148,0.2299,-0.3779,Negative Impact
02/09/2021,174.738,175.60,172.75,173.16,173.16,58474000,3.3,50.56966791,1.192,0,13.66057312,0.8419472675,0.2413396506,0.08,274.31,15331.17969,16926.7207,7163.899902,6763.080078,3597.040039,57852.53906,20795.09961,172.9451703,164.2827224,169.6915241,163.1836625,165.9947014,174.5371271,157.4522757,69.3717466,0.0362209429,-1.63063588,1.666856822,2.944250924,164.821937,10723914000,81.8130161,89.18136439,16.40999985,Exclusive-Amazon to proactively remove more content that violates rules from cloud service -sources,"Amazon.com Inc plans to take a more proactive approach to determine what types of content violate its cloud service policies, such as rules against promoting violence, and enforce its removal, according to two sources, a move likely to renew debate about how much power tech companies should have to restrict free speech.",https://www.reuters.com/technology/exclusive-amazon-proactively-remove-more-content-that-violates-rules-cloud-2021-09-02/,reuters.com,10,amazoncom inc plan take proactive approach determine type content violate cloud service policy rule promoting violence enforce removal according two source move likely renew debate much power tech company restrict free speech,-0.3182,-0.3182,0.2682005263,-0.586400526,Negative Impact
03/09/2021,172.6,174.13,171.82,173.90,173.90,51514000,3.3,50.56966791,1.192,0,13.66057312,0.8419472675,0.2413396506,0.08,274.31,15363.51953,16909.7207,7138.399902,6689.990234,3581.72998,58129.94922,20821.40039,172.9741403,164.3683199,169.8566603,163.2903175,166.3274765,175.5655228,157.0894302,70.05153477,0.4295107616,-1.218606551,1.648117313,2.79196494,166.4358666,10775428000,86.06361387,84.73690582,16.40999985,Amazon kÃÂÃÂ¼ndigt gemeinsam mit The Nature Conservancy eine Investition in naturbasierte LÃÂÃÂ¶sungen zur CO2-Eliminierung in Brasilien an,"SEATTLE--(BUSINESS WIRE)--Als Teil der BemÃÂÃÂ¼hungen, globale LÃÂÃÂ¶sungen fÃÂÃÂ¼r die Klimakrise zu fÃÂÃÂ¶rdern, gab Amazon (NASDAQ: AMZN) heute den Start des ÃÂÃÂAgroforestry and Restoration AcceleratorÃÂÃÂ (Beschleunigungsprojekt fÃÂÃÂ¼r Agroforstwirtschaft und Wiederaufforstung) in Partnerschaft mit The Nature Conservancy, einer globalen Umweltorganisation, bekannt. Der Accelerator wird Tausenden von Landwirten im brasilianischen Bundesstaat ParÃÂÃÂ¡ im Amazonasgebiet eine nachhaltigere Einkommensquelle verschaffen. Gleichzeitig werden die einheimischen RegenwÃÂÃÂ¤lder wieder aufgebaut und der Klimawandel bekÃÂÃÂ¤mpft, indem CO2 auf natÃÂÃÂ¼rliche Weise gebunden und gespeichert wird. Laut dem Intergovernmental Panel on Climate Change (Weltklimarat) spielen naturbezogene LÃÂÃÂ¶sungen eine entscheidende Rolle bei der Abwendung der schlimmsten Auswirkungen des Klimawandels. Regierungen wie auch der Privatsektor kÃÂÃÂ¶nnen durch Investitionen in naturbezogene LÃÂÃÂ¶sungen in groÃÂÃÂem MaÃÂÃÂstab sowohl CO2-Emissionen reduzieren als auch Kohlenstoff aus der AtmosphÃÂÃÂ¤re entfernen. Der Agroforestry and Restoration Accelerator ist ein solches CO2-Abbauprojekt und Teil von Amazons Verpflichtung zur ErfÃÂÃÂ¼llung von The Climate Pledge, eine Initiative, die das Unternehmen gemeinsam mit Global Optimism ins Leben gerufen hat. Die Unterzeichner des Klimaversprechens verpflichten sich, bis 2040 ÃÂÃÂ 10 Jahre vor dem ÃÂÃÂbereinkommen von Paris ÃÂÃÂ eine CO2-neutrale Produktion zu erreichen. Im Rahmen der Verpflichtung zur ErfÃÂÃÂ¼llung des Klimaversprechens setzt Amazon in erster Linie seine Innovationen fort und investiert in die Dekarbonisierung seiner GeschÃÂÃÂ¤ftsbereiche. Das Unternehmen hat 100.000 elektrische Lieferfahrzeuge erworben und ist der grÃÂÃÂ¶ÃÂÃÂte gewerbliche Abnehmer von erneuerbaren Energien in der Welt. Amazon investiert darÃÂÃÂ¼ber hinaus in naturbezogene LÃÂÃÂ¶sungen auÃÂÃÂerhalb seiner WertschÃÂÃÂ¶pfungskette durch den Right Now Climate Fund, der den Accelerator und andere Projekte zur Wiederbelebung geschÃÂÃÂ¤digter BÃÂÃÂ¶den auf eine Art und Weise unterstÃÂÃÂ¼tzt, die die Lebensgrundlage der lokalen Gemeinschaften verbessert und CO2 aus der AtmosphÃÂÃÂ¤re entfernt. DarÃÂÃÂ¼ber hinaus arbeiten Amazon und andere Partner im Rahmen der kÃÂÃÂ¼rzlich angekÃÂÃÂ¼ndigten LEAF Coalition ÃÂÃÂ einer ÃÂÃÂ¶ffentlich-privaten Initiative, die mindestens 1 Milliarde USD fÃÂÃÂ¼r den Schutz der weltweiten TropenwÃÂÃÂ¤lder mobilisieren soll ÃÂÃÂ daran, die Abholzung der TropenwÃÂÃÂ¤lder einzudÃÂÃÂ¤mmen und so den CO2-AusstoÃÂÃÂ in die AtmosphÃÂÃÂ¤re zu verringern. ÃÂÃÂDie Wiederherstellung der WÃÂÃÂ¤lder der Welt ist eine der sinnvollsten MaÃÂÃÂnahmen, die wir jetzt ergreifen kÃÂÃÂ¶nnen, um den Klimawandel zu bekÃÂÃÂ¤mpfen, und sie erfordert innovative LÃÂÃÂ¶sungen, um erfolgreich zu seinÃÂÃÂ, sagte Kara Hurst, Vice President des Bereichs Worldwide Sustainability bei Amazon. ÃÂÃÂWir sind stolz darauf, den Agroforestry and Restoration Accelerator in Zusammenarbeit mit The Nature Conservancy ins Leben zu rufen, um LÃÂÃÂ¶sungen zu fÃÂÃÂ¶rdern, die eine hohe ÃÂÃÂ¶kologische IntegritÃÂÃÂ¤t und einen starken Nutzen fÃÂÃÂ¼r die Gemeinschaft in den Vordergrund stellen. Amazon freut sich sehr darauf, unsere Leidenschaft fÃÂÃÂ¼r Innovation in Verbindung mit finanzieller UnterstÃÂÃÂ¼tzung zur Verbesserung der Lebensgrundlagen lokaler Gemeinschaften in Brasilien einzubringen und gleichzeitig dazu beizutragen, den Planeten fÃÂÃÂ¼r zukÃÂÃÂ¼nftige Generationen zu schÃÂÃÂ¼tzen.ÃÂÃÂ ÃÂÃÂDie Wissenschaft ist eindeutig der Meinung, dass natÃÂÃÂ¼rliche Systeme bei der Aufnahme von CO2 aus der AtmosphÃÂÃÂ¤re PrioritÃÂÃÂ¤t haben, und der jÃÂÃÂ¼ngste IPCC-Bericht bestÃÂÃÂ¤tigt diesÃÂÃÂ, sagte Christiana Figueres, MitbegrÃÂÃÂ¼nderin von Global Optimism und ehemalige UN-Klimachefin, die fÃÂÃÂ¼r das ÃÂÃÂbereinkommen von Paris maÃÂÃÂgeblich verantwortlich ist. ÃÂÃÂDer Schutz bestehender ÃÂÃÂkosysteme und die Wiederherstellung geschÃÂÃÂ¤digter FlÃÂÃÂ¤chen sind als Strategien zur Verringerung des CO2-AusstoÃÂÃÂes von entscheidender Bedeutung, insbesondere in den nÃÂÃÂ¤chsten ein bis zwei Jahrzehnten. Projekte, die dieses Ziel erreichen, um sowohl die Natur als auch die Lebensgrundlagen der lokalen Gemeinschaften zu erhalten, sind von unschÃÂÃÂ¤tzbarem Wert fÃÂÃÂ¼r den Wandel, der notwendig ist, um weit ÃÂÃÂ¼ber die Klimakrise hinaus zu gedeihen. Ein groÃÂÃÂes Lob an Amazon und The Nature Conservancy.ÃÂÃÂ Die Anfangsinvestition von Amazon in den Accelerator wird 3.000 Landwirte fÃÂÃÂ¶rdern und innerhalb von drei Jahren etwa 20.000 Hektar wiederherstellen ÃÂÃÂ eine Landmasse, die in etwa der GrÃÂÃÂ¶ÃÂÃÂe der Stadt Seattle entspricht ÃÂÃÂ und bis 2050 bis zu 10 Millionen Tonnen Kohlendioxid aus der AtmosphÃÂÃÂ¤re entfernen. The Nature Conservancy wird mit dem World Agroforestry Centre und mehreren lokalen zivilen Organisationen zusammenarbeiten, um den Accelerator umzusetzen. Dabei werden Kleinbauern bei der Umwandlung geschÃÂÃÂ¤digter Viehweiden in einheimischen Wald und Agroforstwirtschaft unterstÃÂÃÂ¼tzt. Die Agroforstsysteme werden den Landwirten ÃÂÃÂ¼ber den Verkauf von Kakao und anderen Nutzpflanzen eine nachhaltige Einkommensquelle bieten. Im Rahmen des Accelerators werden darÃÂÃÂ¼ber hinaus innovative Wege zur UnterstÃÂÃÂ¼tzung der Landwirte und zur FÃÂÃÂ¶rderung der MÃÂÃÂ¤rkte fÃÂÃÂ¼r nachhaltige forstwirtschaftliche Erzeugnisse getestet, auch mit Hilfe digitaler Technologien, und es werden neue Methoden und satellitengestÃÂÃÂ¼tzte Technologien zur Quantifizierung und ÃÂÃÂberwachung des CO2-Abbaus entwickelt. ÃÂÃÂParÃÂÃÂ¡ ist Heimat von 9 Prozent des weltweiten Tropenwaldes. Doch diese Region sieht sich mit einer beispiellosen Abholzung konfrontiert und hat im letzten Jahr jeden Tag 3.300 Hektar Wald verlorenÃÂÃÂ, sagte Jennifer Morris, CEO von The Nature Conservancy. ÃÂÃÂIn den letzten 13 Jahren waren kleine Farmen in ParÃÂÃÂ¡ ÃÂÃÂ einem Gebiet, in dem Brandrodung die einzige Option zu sein scheint ÃÂÃÂ fÃÂÃÂ¼r durchschnittlich 40 % der Entwaldung im Bundesstaat verantwortlich. Seit 20 Jahren arbeitet The Nature Conservancy mit Kleinbauern, Gemeindevertretern, Regierungsbeamten und indigenen VÃÂÃÂ¶lkern zusammen, um LÃÂÃÂ¶sungen zu finden und umzusetzen, die fÃÂÃÂ¼r beide Seiten von Vorteil sind, wie z. B. die Agroforstwirtschaft, die den Menschen und der Natur zu Wohlstand verhilft. Diese neue Partnerschaft mit Amazon ermÃÂÃÂ¶glicht es uns, die Ressourcen und die technische UnterstÃÂÃÂ¼tzung bereitzustellen, die nÃÂÃÂ¶tig sind, um dieses Programm voranzubringen und zu zeigen, dass regenerative Agroforstwirtschaft und CO2-MÃÂÃÂ¤rkte tragfÃÂÃÂ¤hige GeschÃÂÃÂ¤ftsmodelle fÃÂÃÂ¼r die Gemeinden im Amazonasgebiet sind.ÃÂÃÂ ÃÂÃÂWir mÃÂÃÂ¼ssen unsere KrÃÂÃÂ¤fte vereinen, um das Jahrhundertziel zu erreichen: unsere Wirtschaft weiterzuentwickeln und das Einkommen der Menschen zu sichern und gleichzeitig den Wald zu erhalten und wiederherzustellenÃÂÃÂ, sagte Helder Barbalho, Gouverneur von ParÃÂÃÂ¡. ÃÂÃÂDer Bundesstaat ParÃÂÃÂ¡ ist bereit, sich dieser Herausforderung zu stellen, und unsere Strategie ist in unserem Amazonia Agora-Plan klar festgelegt. Darin verpflichten wir uns, bis 2036 durch die Reduzierung der Abholzung und die FÃÂÃÂ¶rderung der Wiederaufforstung kohlendioxidfrei zu werden. Investitionen wie die von Amazon in nachhaltige Agroforstwirtschaft und Wiederaufforstung in ParÃÂÃÂ¡ sind sehr begrÃÂÃÂ¼ÃÂÃÂenswert. Diese Initiative wird der Gemeinschaft, den natÃÂÃÂ¼rlichen Ressourcen und der biologischen Vielfalt des Bundesstaates erheblich zugute kommen.ÃÂÃÂ Weitere Informationen ÃÂÃÂ¼ber den Einsatz von Amazon fÃÂÃÂ¼r Nachhaltigkeit finden Sie unter: https://sustainability.aboutamazon.com. ÃÂÃÂber Amazon Amazon wird von vier Prinzipien geleitet: Kundenorientierung statt Wettbewerbsfokus, Leidenschaft fÃÂÃÂ¼r Neuerungen, Einsatz fÃÂÃÂ¼r operative HÃÂÃÂ¶chstleistungen sowie langfristiges Denken. Amazon strebt danach, das kundenorientierteste Unternehmen der Welt, der beste Arbeitgeber der Welt und der sicherste Arbeitsplatz der Welt zu sein. Kundenrezensionen, 1-Klick-EinkÃÂÃÂ¤ufe, personalisierte Empfehlungen, Prime, Versand durch Amazon, AWS, Kindle Direct Publishing, Kindle, Career Choice, Fire-Tablets, Fire TV, Amazon Echo, Alexa, Just Walk Out-Technologie, Amazon Studios und The Climate Pledge sind einige der Pionierleistungen von Amazon. FÃÂÃÂ¼r weitere Informationen besuchen Sie amazon.com/about und folgen Sie @AmazonNews. ÃÂÃÂber The Nature Conservancy The Nature Conservancy ist eine globale Naturschutzorganisation, die sich fÃÂÃÂ¼r den Erhalt von Land und GewÃÂÃÂ¤ssern einsetzt, wovon alles Leben abhÃÂÃÂ¤ngt. Unter wissenschaftlicher Leitung schaffen wir innovative, bodenstÃÂÃÂ¤ndige LÃÂÃÂ¶sungen fÃÂÃÂ¼r die schwierigsten Herausforderungen unserer Welt, damit Natur und Menschen gemeinsam gedeihen kÃÂÃÂ¶nnen. Wir bekÃÂÃÂ¤mpfen den Klimawandel, schÃÂÃÂ¼tzen Land, GewÃÂÃÂ¤sser und Ozeane in einem noch nie dagewesenen AusmaÃÂÃÂ, sorgen fÃÂÃÂ¼r eine nachhaltige Versorgung mit Nahrungsmitteln und Wasser und tragen dazu bei, StÃÂÃÂ¤dte nachhaltiger zu gestalten. Wir arbeiten in 72 LÃÂÃÂ¤ndern und Gebieten: In 38 LÃÂÃÂ¤ndern sind wir direkt und in 34 ÃÂÃÂ¼ber unsere Partner tÃÂÃÂ¤tig. Dabei verfolgen wir einen kooperativen Ansatz, der lokale Gemeinschaften, Regierungen, den Privatsektor und andere Partner mit einbezieht. Um mehr zu erfahren, besuchen Sie www.nature.org oder folgen Sie @nature_press auf Twitter. Die Ausgangssprache, in der der Originaltext verÃÂÃÂ¶ffentlicht wird, ist die offizielle und autorisierte Version. ÃÂÃÂbersetzungen werden zur besseren VerstÃÂÃÂ¤ndigung mitgeliefert. Nur die Sprachversion, die im Original verÃÂÃÂ¶ffentlicht wurde, ist rechtsgÃÂÃÂ¼ltig. Gleichen Sie deshalb ÃÂÃÂbersetzungen mit der originalen Sprachversion der VerÃÂÃÂ¶ffentlichung ab.",https://www.businesswire.com/news/home/20210903005372/de/,businesswire.com,5,seattlebusiness wireals teil der bemhungen globale lsungen fr die klimakrise zu frdern gab amazon nasdaq amzn heute den start de agroforestry restoration accelerator beschleunigungsprojekt fr agroforstwirtschaft und wiederaufforstung partnerschaft mit nature conservancy einer globalen umweltorganisation bekannt der accelerator wird tausenden von landwirten im brasilianischen bundesstaat par im amazonasgebiet eine nachhaltigere einkommensquelle verschaffen gleichzeitig werden die einheimischen regenwlder wieder aufgebaut und der klimawandel bekmpft indem co auf natrliche weise gebunden und gespeichert wird laut dem intergovernmental panel climate change weltklimarat spielen naturbezogene lsungen eine entscheidende rolle bei der abwendung der schlimmsten auswirkungen de klimawandels regierungen wie auch der privatsektor knnen durch investitionen naturbezogene lsungen groem mastab sowohl coemissionen reduzieren al auch kohlenstoff au der atmosphre entfernen der agroforestry restoration accelerator ist ein solches coabbauprojekt und teil von amazon verpflichtung zur erfllung von climate pledge eine initiative die da unternehmen gemeinsam mit global optimism in leben gerufen hat die unterzeichner de klimaversprechens verpflichten sich bi jahre vor dem bereinkommen von paris eine coneutrale produktion zu erreichen im rahmen der verpflichtung zur erfllung de klimaversprechens setzt amazon erster linie seine innovationen fort und investiert die dekarbonisierung seiner geschftsbereiche da unternehmen hat elektrische lieferfahrzeuge erworben und ist der grte gewerbliche abnehmer von erneuerbaren energien der welt amazon investiert darber hinaus naturbezogene lsungen auerhalb seiner wertschpfungskette durch den right climate fund der den accelerator und andere projekte zur wiederbelebung geschdigter bden auf eine art und weise untersttzt die die lebensgrundlage der lokalen gemeinschaften verbessert und co au der atmosphre entfernt darber hinaus arbeiten amazon und andere partner im rahmen der krzlich angekndigten leaf coalition einer ffentlichprivaten initiative die mindestens milliarde usd fr den schutz der weltweiten tropenwlder mobilisieren soll daran die abholzung der tropenwlder einzudmmen und den coaussto die atmosphre zu verringern die wiederherstellung der wlder der welt ist eine der sinnvollsten manahmen die wir jetzt ergreifen knnen um den klimawandel zu bekmpfen und sie erfordert innovative lsungen um erfolgreich zu sein sagte kara hurst vice president de bereichs worldwide sustainability bei amazon wir sind stolz darauf den agroforestry restoration accelerator zusammenarbeit mit nature conservancy in leben zu rufen um lsungen zu frdern die eine hohe kologische integritt und einen starken nutzen fr die gemeinschaft den vordergrund stellen amazon freut sich sehr darauf unsere leidenschaft fr innovation verbindung mit finanzieller untersttzung zur verbesserung der lebensgrundlagen lokaler gemeinschaften brasilien einzubringen und gleichzeitig dazu beizutragen den planeten fr zuknftige generationen zu schtzen die wissenschaft ist eindeutig der meinung das natrliche systeme bei der aufnahme von co au der atmosphre prioritt haben und der jngste ipccbericht besttigt dy sagte christiana figueres mitbegrnderin von global optimism und ehemalige unklimachefin die fr da bereinkommen von paris mageblich verantwortlich ist der schutz bestehender kosysteme und die wiederherstellung geschdigter flchen sind al strategien zur verringerung de coausstoes von entscheidender bedeutung insbesondere den nchsten ein bi zwei jahrzehnten projekte die diesis ziel erreichen um sowohl die natur al auch die lebensgrundlagen der lokalen gemeinschaften zu erhalten sind von unschtzbarem wert fr den wandel der notwendig ist um weit ber die klimakrise hinaus zu gedeihen ein groes lob amazon und nature conservancy die anfangsinvestition von amazon den accelerator wird landwirte frdern und innerhalb von drei jahren etwa hektar wiederherstellen eine landmasse die etwa der gre der stadt seattle entspricht und bi bi zu millionen tonnen kohlendioxid au der atmosphre entfernen nature conservancy wird mit dem world agroforestry centre und mehreren lokalen zivilen organisationen zusammenarbeiten um den accelerator umzusetzen dabei werden kleinbauern bei der umwandlung geschdigter viehweiden einheimischen wald und agroforstwirtschaft untersttzt die agroforstsysteme werden den landwirten ber den verkauf von kakao und anderen nutzpflanzen eine nachhaltige einkommensquelle bieten im rahmen de accelerator werden darber hinaus innovative wege zur untersttzung der landwirte und zur frderung der mrkte fr nachhaltige forstwirtschaftliche erzeugnisse getestet auch mit hilfe digitaler technologien und e werden neue methoden und satellitengesttzte technologien zur quantifizierung und berwachung de coabbaus entwickelt par ist heimat von prozent de weltweiten tropenwaldes doch diese region sieht sich mit einer beispiellosen abholzung konfrontiert und hat im letzten jahr jeden tag hektar wald verloren sagte jennifer morris ceo von nature conservancy den letzten jahren waren kleine farmen par einem gebiet dem brandrodung die einzige option zu sein scheint fr durchschnittlich der entwaldung im bundesstaat verantwortlich seit jahren arbeitet nature conservancy mit kleinbauern gemeindevertretern regierungsbeamten und indigenen vlkern zusammen um lsungen zu finden und umzusetzen die fr beide seiten von vorteil sind wie z b die agroforstwirtschaft die den menschen und der natur zu wohlstand verhilft diese neue partnerschaft mit amazon ermglicht e un die ressourcen und die technische untersttzung bereitzustellen die ntig sind um diesis programm voranzubringen und zu zeigen das regenerative agroforstwirtschaft und comrkte tragfhige geschftsmodelle fr die gemeinden im amazonasgebiet sind wir mssen unsere krfte vereinen um da jahrhundertziel zu erreichen unsere wirtschaft weiterzuentwickeln und da einkommen der menschen zu sichern und gleichzeitig den wald zu erhalten und wiederherzustellen sagte helder barbalho gouverneur von par der bundesstaat par ist bereit sich dieser herausforderung zu stellen und unsere strategie ist unserem amazonia agoraplan klar festgelegt darin verpflichten wir un bi durch die reduzierung der abholzung und die frderung der wiederaufforstung kohlendioxidfrei zu werden investitionen wie die von amazon nachhaltige agroforstwirtschaft und wiederaufforstung par sind sehr begrenswert diese initiative wird der gemeinschaft den natrlichen ressourcen und der biologischen vielfalt de bundesstaates erheblich zugute kommen weitere informationen ber den einsatz von amazon fr nachhaltigkeit finden sie unter ber amazon amazon wird von vier prinzipien geleitet kundenorientierung statt wettbewerbsfokus leidenschaft fr neuerungen einsatz fr operative hchstleistungen sowie langfristiges denken amazon strebt danach da kundenorientierteste unternehmen der welt der beste arbeitgeber der welt und der sicherste arbeitsplatz der welt zu sein kundenrezensionen klickeinkufe personalisierte empfehlungen prime versand durch amazon aws kindle direct publishing kindle career choice firetablets fire tv amazon echo alexa walk outtechnologie amazon studio und climate pledge sind einige der pionierleistungen von amazon fr weitere informationen besuchen sie amazoncomabout und folgen sie amazonnews ber nature conservancy nature conservancy ist eine globale naturschutzorganisation die sich fr den erhalt von land und gewssern einsetzt wovon alles leben abhngt unter wissenschaftlicher leitung schaffen wir innovative bodenstndige lsungen fr die schwierigsten herausforderungen unserer welt damit natur und menschen gemeinsam gedeihen knnen wir bekmpfen den klimawandel schtzen land gewsser und ozeane einem noch nie dagewesenen ausma sorgen fr eine nachhaltige versorgung mit nahrungsmitteln und wasser und tragen dazu bei stdte nachhaltiger zu gestalt wir arbeiten lndern und gebieten lndern sind wir direkt und ber unsere partner ttig dabei verfolgen wir einen kooperativen ansatz der lokale gemeinschaften regierungen den privatsektor und andere partner mit einbezieht um mehr zu erfahren besuchen sie oder folgen sie naturepress auf twitter die ausgangssprache der der originaltext verffentlicht wird ist die offizielle und autorisierte version bersetzungen werden zur besseren verstndigung mitgeliefert nur die sprachversion die im original verffentlicht wurde ist rechtsgltig gleichen sie deshalb bersetzungen mit der originalen sprachversion der verffentlichung ab,-0.9991,-0.49955,0.21436,-0.71391,Negative Impact
07/09/2021,173.9,176.40,173.85,175.46,175.46,54758000,3.3,50.56966791,1.192,0,13.66057312,0.8419472675,0.2413396506,0.08,274.31,15374.33008,16801.17969,7149.399902,6726.069824,3676.590088,58279.48047,20806.59961,173.0819702,164.4692773,170.0765753,163.4114536,166.7460258,176.8483103,156.6437414,81.77126932,0.8573528071,-0.80341468,1.660767487,2.71282196,167.8238462,10830186000,94.66407972,87.5135699,18.13999939,"Square, Amazon, and PayPal All Believe This Technology Is the Next Big Thing in the Fintech World","Buy now, pay later (BNPL) isn't just a ÃÂÃÂCovid thingÃÂÃÂ ÃÂÃÂ it's the next evolution of consumer payments. Or, the credit card killer, if you will.",https://investorplace.com/hypergrowthinvesting/2021/09/square-amazon-and-paypal-all-believe-this-technology-is-the-next-big-thing-in-the-fintech-world/,investorplace.com,6,buy pay later bnpl isnt covid thing next evolution consumer payment credit card killer,-0.4767,-0.28602,0.1713371429,-0.457357143,Negative Impact
08/09/2021,175.5825,177.28,174.78,176.28,176.27,61068000,3.3,50.56966791,1.192,0,13.66057312,0.8419472675,0.2413396506,0.08,274.31,15286.63965,16731.03906,7095.5,6668.890137,3675.189941,58250.26172,20741.80078,173.16358,164.5713973,170.3196505,163.539449,167.2580757,178.2107689,156.3053826,90.92583435,1.247441645,-0.393243415,1.64068506,2.698036194,169.19675,10891254000,94.55754585,91.76174648,17.95999908,U.S. FTC meeting will scrutinize Big Tech's small deals,"The U.S. Federal Trade Commission will hold its next open meeting on Sept. 15 to hear staff findings on deals that Big Tech firms like Facebook and Apple make which are sometimes too small to spark antitrust scrutiny, the agency said on Wednesday.",https://www.reuters.com/world/us/us-ftc-meeting-will-scrutinize-big-techs-small-deals-2021-09-08/,reuters.com,10,u federal trade commission hold next open meeting sept hear staff finding deal big tech firm like facebook apple make sometimes small spark antitrust scrutiny agency said wednesday,0.5267,0.5267,0.1845146667,0.3421853333,Positive Impact
09/09/2021,176.301,177.50,174.02,174.21,174.21,54384000,3.3,50.56966791,1.192,0,13.66057312,0.8419472675,0.2413396506,0.08,274.31,15248.25,16663.11914,7024.200195,6684.720215,3693.129883,58305.07031,20705.30078,173.1995999,164.6675873,170.4721345,163.6456037,167.7382004,179.037682,156.4387188,84.94990378,1.373961947,-0.039802342,1.41376429,2.766179766,170.652004,10836870000,82.40919466,90.54360675,18.79999924,"Amazon TVs are coming in October, with prices starting at $370",Two series will be available in various sizes: the Amazon Fire TV Omni and the more affordable Amazon Fire TV 4 Series.,https://www.cnbc.com/2021/09/09/amazon-fire-tv-omni-and-4-series-tvs-price-release-date.html,cnbc.com,9,two series available various size amazon fire tv omni affordable amazon fire tv series,-0.34,-0.306,0.2417264286,-0.547726429,Negative Impact
10/09/2021,175.0915,175.42,173.15,173.46,173.46,47946000,3.3,50.56966791,1.192,0,13.66057312,0.8419472675,0.2413396506,0.08,274.31,15115.49023,16563.48047,7029.200195,6663.77002,3703.110107,58305.07031,20633.09961,173.2285901,164.7602773,170.5892079,163.7432345,168.1523254,179.6614277,156.6432232,81.53264419,1.397561844,0.2476704949,1.149891349,2.814358303,172.0215025,10788924000,76.22216677,84.39630243,20.95000076,AWS en Bundesliga debuteren met twee nieuwe Bundesliga-wedstrijdfeiten voor het Europese voetbalseizoen 2021-22,"SEATTLE--(BUSINESS WIRE)--Vandaag hebben Amazon Web Services (AWS), een bedrijf van Amazon.com, Inc. (NASDAQ: AMZN), en de Duitse Bundesliga, de hoogste nationale voetbalcompetitie van Duitsland, twee nieuwe Bundesliga Match Facts aangekondigd, mogelijk gemaakt door AWS die tijdens het seizoen 2021-2022 als graphics in premiÃÂÃÂ¨re gaat tijdens uitzendingen en in de officiÃÂÃÂ«le Bundesliga-app. De eerste geavanceerde stat, Shot Efficiency, vergelijkt het werkelijke aantal doelpunten dat een speler of team heeft gescoord met het aantal doelpunten dat de speler of het team had moeten maken op basis van de kwaliteit van hun kansen. Het tweede, Passing Profile, geeft dieper inzicht in de passkwaliteit van een speler of een heel team. Beide statistieken zullen debuteren tijdens speeldag 4 op 11 september 2021, met de confrontatie tussen de Duitse kampioen FC Bayern MÃÂÃÂ¼nchen en het team dat op de tweede plaats eindigde van het vorige seizoen, RB Leipzig. Ga voor meer informatie, videoÃÂÃÂs en blogs over elke statistiek naar aws.amazon.com/sports/bundesliga. Deze bekendmaking is officieel geldend in de originele brontaal. Vertalingen zijn slechts als leeshulp bedoeld en moeten worden vergeleken met de tekst in de brontaal, die als enige rechtsgeldig is.",https://www.businesswire.com/news/home/20210910005431/nl/,businesswire.com,5,seattlebusiness wirevandaag hebben amazon web service aws een bedrijf van amazoncom inc nasdaq amzn en de duitse bundesliga de hoogste nationale voetbalcompetitie van duitsland twee nieuwe bundesliga match fact aangekondigd mogelijk gemaakt door aws die tijdens het seizoen al graphic premire gaat tijdens uitzendingen en de officile bundesligaapp de eerste geavanceerde stat shot efficiency vergelijkt het werkelijke aantal doelpunten dat een speler team heeft gescoord met het aantal doelpunten dat de speler het team moeten maken op basis van de kwaliteit van hun kansen het tweede passing profile geeft dieper inzicht de passkwaliteit van een speler een heel team beide statistieken zullen debuteren tijdens speeldag op september met de confrontatie tussen de duitse kampioen fc bayern mnchen en het team dat op de tweede plaats eindigde van het vorige seizoen rb leipzig ga voor meer informatie video en blog elke statistiek naar awsamazoncomsportsbundesliga deze bekendmaking officieel geldend de originele brontaal vertalingen zijn slechts al leeshulp bedoeld en moeten worden vergeleken met de tekst de brontaal die al enige rechtsgeldig,-0.6808,-0.3404,0.2568823529,-0.597282353,Negative Impact
13/09/2021,174.14,174.90,171.90,172.86,172.86,51380000,3.3,50.56966791,1.192,0,13.66057312,0.8419472675,0.2413396506,0.08,274.31,15105.58008,16635.39063,7068.399902,6676.930176,3715.370117,58177.76172,20666.40039,173.2527902,164.8450549,170.6781999,163.8339337,168.5603256,180.1322723,156.9883789,75.64898665,1.352341762,0.4686047484,0.8837370138,2.739394052,177.4994965,10737544000,66.29756566,74.97630903,19.37000084,D.C. attorney general broadens Amazon lawsuit,"Washington, D.C., has broadened its antitrust lawsuit against Amazon to challenge the online retailer's agreements with wholesalers as well as third-party sellers, city Attorney General Karl Racine's office said on Monday.",https://www.reuters.com/article/us-tech-antitrust-amazon-dc/d-c-attorney-general-broadens-amazon-lawsuit-idUSKBN2G91OO,reuters.com,10,washington dc broadened antitrust lawsuit amazon challenge online retailer agreement wholesaler well thirdparty seller city attorney general karl racine office said monday,0.6597,0.6597,0.247792,0.411908,Positive Impact
14/09/2021,173.7775,174.34,171.89,172.50,172.50,38738000,3.3,50.56966791,1.192,0,13.66057312,0.8419472675,0.2413396506,0.08,274.31,15037.75977,16497.23047,7034.100098,6652.970215,3662.600098,58247.08984,20553.30078,173.1918103,164.9112874,170.7496431,163.9201633,168.937851,180.5064535,157.3692484,71.19763165,1.272902912,0.6294643811,0.6434385309,2.737536839,177.3875064,10698806000,62.10206223,68.20726489,19.45999908,Amazon Attracts Fresh Antitrust Allegations To Existing Lawsuit: WSJ,"The District of Columbia's attorney general blamed has Amazon.com Inc (NASDAQ: AMZN) for manipulating wholesaler contracts to drive up product prices on other websites, protecting itself from the competition, the Wall Street Journal reports. The allegations added to a pending district antitrust lawsuit.",https://www.benzinga.com/government/21/09/22926502/amazon-attracts-fresh-antitrust-allegations-to-existing-lawsuit-wsj,benzinga.com,5,district columbia attorney general blamed amazoncom inc nasdaq amzn manipulating wholesaler contract drive product price website protecting competition wall street journal report allegation added pending district antitrust lawsuit,-0.7579,-0.37895,0.2867788889,-0.665728889,Negative Impact
15/09/2021,172.126,174.27,170.10,173.79,173.79,59150000,3.3,50.56966791,1.192,0,13.66057312,0.8419472675,0.2413396506,0.08,274.31,15161.53027,16626.88086,7016.5,6583.620117,3656.219971,58723.19922,20693.80078,172.9918604,164.9813999,170.8688533,164.0183657,169.5224258,180.8140176,158.2308341,74.57221663,1.299024977,0.7633765002,0.5356484764,2.910964966,177.1674261,10757956000,70.78630355,66.39531048,18.18000031,California legislation to aid Amazon warehouse workers won't replace ongoing unionization efforts,Stuart Applebaum has heard the argument before.,https://www.geekwire.com/2021/california-legislation-aid-amazon-warehouse-workers-wont-replace-ongoing-unionization-efforts/,geekwire.com,5,stuart applebaum heard argument,-0.3612,-0.1806,0.3951608333,-0.575760833,Negative Impact
16/09/2021,172.998,174.63,172.31,174.41,174.41,51672000,3.3,50.56966791,1.192,0,13.66057312,0.8419472675,0.2413396506,0.08,274.31,15181.91992,16576.76953,7027.5,6622.589844,3607.090088,59141.16016,20602.09961,172.7835205,165.06145,171.0078004,164.1217849,170.2399757,180.8002501,159.6797014,74.25919526,1.354345203,0.8815702408,0.4727749623,2.948143005,176.7434102,10809628000,73.8613713,68.91657903,18.69000053,Amazon (AMZN) Gains As Market Dips: What You Should Know,"Amazon (AMZN) closed at $3,488.24 in the latest trading session, marking a +0.36% move from the prior day.",https://www.zacks.com/stock/news/1797526/amazon-amzn-gains-as-market-dips-what-you-should-know,zacks.com,8,amazon amzn closed latest trading session marking move prior day,0.1779,0.14232,0.3086916667,-0.166371667,Negative Impact
17/09/2021,174.4205,174.87,172.61,173.13,173.13,92332000,3.3,50.56966791,1.192,0,13.66057312,0.8419472675,0.2413396506,0.08,274.31,15043.96973,16460.34961,6963.600098,6570.189941,3613.969971,59015.89063,20490.40039,172.5146307,165.12206,171.0908673,164.2113792,170.9269012,180.2269598,161.6268427,66.26239073,1.279666593,0.9611895112,0.318477082,2.972106934,176.3448352,10717296000,55.09070512,66.57945999,20.80999947,"Follow The Smart Money, Looking Into Amazon's Biggest Options Trades For Today",Someone with a lot of money to spend (and possibly insider knowledge) has taken an unusually bearish stance on (Amazon.com: AMZN). And retail traders should know.,https://www.benzinga.com/markets/options/21/09/22988157/follow-the-smart-money-looking-into-amazons-biggest-options-trades-for-today,benzinga.com,5,someone lot money spend possibly insider knowledge taken unusually bearish stance amazoncom amzn retail trader know,0,0,0.306365,-0.306365,Negative Impact
20/09/2021,169.8,170.95,165.25,167.79,167.79,93382000,3.3,50.56966791,1.192,0,13.66057312,0.8419472675,0.2413396506,0.08,274.31,14713.90039,16168.16992,6903.899902,6455.810059,3613.969971,58490.92969,20154.5,172.1510208,165.16011,170.9612842,164.2469525,171.3163513,179.2397943,163.3929084,41.38081194,0.7806309531,0.9250777996,-0.144446846,3.194036211,175.9701748,10623914000,20.70370601,49.88526081,25.70999908,"Why Apple, Facebook, Amazon, and Other Tech Stocks Dropped Today",Fear has returned to the global financial markets.,https://www.fool.com/investing/2021/09/20/why-apple-facebook-amazon-and-other-tech-stocks-dr/,fool.com,7,fear returned global financial market,-0.4939,-0.34573,0.1878907143,-0.533620714,Negative Impact
21/09/2021,168.75,168.99,166.62,167.18,167.18,55618000,3.3,50.56966791,1.192,0,13.66057312,0.8419472675,0.2413396506,0.08,274.31,14746.40039,16184.5,6981,6552.72998,3613.969971,59005.26953,20244.30078,171.7761008,165.199335,170.8130575,164.276152,171.5107513,178.768191,164.2533116,31.56135388,0.3324907674,0.8065603932,-0.474069626,3.088035583,175.1126011,10568296000,15.76455933,30.51965682,24.36000061,"The Climate Pledge kondigt 86 nieuwe ondertekenaars aan, waaronder Procter & Gamble, HP en Salesforce geven blijk van hun engagement om tegen 2040 of eerder netto-nulkoolstof te bereiken","SEATTLE--(BUSINESS WIRE)--Vandaag hebben Amazon en Global Optimism aangekondigd dat meer dan 200 bedrijven nu The Climate Pledge hebben ondertekend. De 86 nieuwe ondertekenaars die zich bij The Climate Pledge aansluiten, zijn onder meer Procter & Gamble, HP, Salesforce, ASOS en Nespresso. Ondertekenaars van de belofte genereren in totaal meer dan $ 1,8 biljoen aan wereldwijde jaarlijkse inkomsten en hebben meer dan 7 miljoen werknemers in 26 sectoren in 21 landen. Door tegen 2040, 10 jaar voor de Overeenkomst van Parijs, netto-nul koolstof te bereiken, wordt verwacht dat de huidige ondertekenaars van de Climate Pledge gezamenlijk 1,98 miljard metrische ton (BMT) koolstofemissies verminderen ten opzichte van een 2020-basislijn. Dit komt overeen met 5,4% van de huidige wereldwijde jaarlijkse uitstoot, wat de collectieve impact aantoont die The Climate Pledge naar verwachting zal hebben bij het aanpakken van klimaatverandering en het aanzetten tot meer actie om de klimaatcrisis aan te pakken. Deze bekendmaking is officieel geldend in de originele brontaal. Vertalingen zijn slechts als leeshulp bedoeld en moeten worden vergeleken met de tekst in de brontaal, die als enige rechtsgeldig is.",https://www.businesswire.com/news/home/20210921006062/nl/,businesswire.com,5,seattlebusiness wirevandaag hebben amazon en global optimism aangekondigd dat meer dan bedrijven nu climate pledge hebben ondertekend de nieuwe ondertekenaars die zich bij climate pledge aansluiten zijn onder meer procter gamble hp salesforce asos en nespresso ondertekenaars van de belofte genereren totaal meer dan biljoen aan wereldwijde jaarlijkse inkomsten en hebben meer dan miljoen werknemers sectoren landen door tegen jaar voor de overeenkomst van parijs nettonul koolstof te bereiken wordt verwacht dat de huidige ondertekenaars van de climate pledge gezamenlijk miljard metrische ton bmt koolstofemissies verminderen ten opzichte van een basislijn dit komt overeen met van de huidige wereldwijde jaarlijkse uitstoot wat de collectieve impact aantoont die climate pledge naar verwachting zal hebben bij het aanpakken van klimaatverandering en het aanzetten tot meer actie om de klimaatcrisis aan te pakken deze bekendmaking officieel geldend de originele brontaal vertalingen zijn slechts al leeshulp bedoeld en moeten worden vergeleken met de tekst de brontaal die al enige rechtsgeldig,-0.8176,-0.4088,0.2933695238,-0.702169524,Negative Impact
22/09/2021,167.55,169.45,167.05,169.00,169.00,48228000,3.3,50.56966791,1.192,0,13.66057312,0.8419472675,0.2413396506,0.08,274.31,14896.84961,16352.17969,7083.399902,6637,3628.48999,58927.32813,20401.5,171.4787909,165.2537025,170.7420554,164.3231804,171.6964264,178.4566223,164.9362304,36.7369879,0.1228596048,0.6698202355,-0.546960631,3.058534895,174.3236333,10616524000,30.63108066,22.36644867,20.87000084,"The Climate Pledge gibt 86 neue Unterzeichner bekannt, darunter Procter & Gamble, HP und Salesforce, die damit ihr Engagement signalisieren, bis 2040 oder frÃÂÃÂ¼her Netto-Null-Kohlenstoff zu erreichen","SEATTLE--(BUSINESS WIRE)--Heute gaben Amazon und Global Optimism bekannt, dass mittlerweile mehr als 200 Unternehmen The Climate Pledge unterzeichnet haben. Zu den 86 neuen Unterzeichnern, die The Climate Pledge beitreten, gehÃÂÃÂ¶ren Procter & Gamble, HP, Salesforce, ASOS und Nespresso. Die Unterzeichner der VerpflichtungserklÃÂÃÂ¤rung erwirtschaften insgesamt einen weltweiten Jahresumsatz von ÃÂÃÂ¼ber 1,8 Billionen USD und haben mehr als 7 Millionen Mitarbeiter in 26 Branchen in 21 LÃÂÃÂ¤ndern. Durch das Erreichen von Netto-KohlenstoffausstoÃÂÃÂ von Null bis 2040, also 10 Jahre vor dem Pariser Abkommen, wird erwartet, dass die derzeitigen Unterzeichner des Climate Pledge kollektiv 1,98 Milliarden Tonnen der CO2-Emissionen gegenÃÂÃÂ¼ber einem Ausgangswert von 2020 verringern werden. Dies entspricht 5,4 % der derzeitigen weltweiten jÃÂÃÂ¤hrlichen Emissionen ÃÂÃÂ ein Beleg fÃÂÃÂ¼r die kollektiven Auswirkungen, die The Climate Pledge bei der BekÃÂÃÂ¤mpfung des Klimawandels haben und zu mehr MaÃÂÃÂnahmen zur BewÃÂÃÂ¤ltigung der Klimakrise anregen wird. Die Unterzeichner von The Climate Pledge stimmen zu: Treibhausgasemissionen regelmÃÂÃÂ¤ÃÂÃÂig zu messen und darÃÂÃÂ¼ber zu berichten. Dekarbonisierungsstrategien im Einklang mit dem ÃÂÃÂbereinkommen von Paris durch echte geschÃÂÃÂ¤ftliche VerÃÂÃÂ¤nderungen und Innovationen umzusetzen, einschlieÃÂÃÂlich Effizienzsteigerungen, erneuerbarer Energien, Materialreduzierungen und anderer Strategien zur Beseitigung von CO2-Emissionen. alle verbleibenden Emissionen durch zusÃÂÃÂ¤tzliche, quantifizierbare, reale, dauerhafte und sozial nÃÂÃÂ¼tzliche AusgleichsmaÃÂÃÂnahmen zu neutralisieren, um bis 2040 einen jÃÂÃÂ¤hrlichen Netto-KohlenstoffausstoÃÂÃÂ von Null zu erreichen. ÃÂÃÂIch glaube, dass Unternehmen wie Amazon heute mehr denn je die Pflicht haben, den Kampf um unseren Planeten anzufÃÂÃÂ¼hrenÃÂÃÂ, sagte Andy Jassy, CEO von Amazon. ÃÂÃÂAber diese Herausforderung kann nicht von einem Unternehmen gelÃÂÃÂ¶st werden; es erfordert, dass wir alle zusammen handeln, und das ist einer der GrÃÂÃÂ¼nde, warum wir so aufgeregt sind, mitteilen zu kÃÂÃÂ¶nnen, dass mehr als 200 Unternehmen mit uns zusammen The Climate Pledge unterzeichnet haben ÃÂÃÂ eine Verpflichtung, die Ziele des Pariser Abkommens 10 Jahre frÃÂÃÂ¼her zu erreichen.ÃÂÃÂ Viele der neuen Unterzeichner von Pledge machen bereits bedeutende Fortschritte bei der Reduzierung ihrer CO2-Emissionen. Seit 2010 hat Procter & Gamble seine absoluten Emissionen im weltweiten Betrieb um 52 % reduziert. Das Unternehmen hat auch den Bezug von Strom aus erneuerbaren Quellen um 97 % erhÃÂÃÂ¶ht und sich mit Verbrauchern zusammengetan, um mit Produkten wie Tide und Ariel Nachhaltigkeit mÃÂÃÂ¼helos zu Hause zu machen, die dazu beigetragen haben, die CO2-Emissionen durch KaltwasserwÃÂÃÂ¤sche um 15 Millionen Tonnen zu reduzieren. Procter & Gamble hat kÃÂÃÂ¼rzlich das Ziel angekÃÂÃÂ¼ndigt, bis 2040 Netto-Null-Emissionen in allen Bereichen seines Betriebs, seines Transports und seiner Lieferkette, vom Rohstoff bis zum EinzelhÃÂÃÂ¤ndler, zu erreichen. Nespresso, bekannt fÃÂÃÂ¼r seine Kaffeekompetenz von der Bohne ÃÂÃÂ¼ber die Kapsel bis zur Tasse, kÃÂÃÂ¼ndigt einen wichtigen Meilenstein fÃÂÃÂ¼r seine Klimareise an: Jede Tasse Nespresso-Kaffee, sowohl zu Hause als auch im Beruf, wird bis 2022 klimaneutral sein. ASOS gab bekannt, dass es im Rahmen seiner Carbon 2020-Strategie seine Emissionen seit 2015 jedes Jahr reduziert und die EmissionsintensitÃÂÃÂ¤t in dieser Zeit um 30 % gesenkt hat ÃÂÃÂ was einer Vermeidung von 110.000 Tonnen CO2-Emissionen entspricht. Anfang des Jahres hat HP eine Reihe mutiger Klimaverpflichtungen verÃÂÃÂ¶ffentlicht, darunter das Ziel, bis 2040 Netto-Null-Emissionen von Kohlenstoff und anderen Treibhausgasen in der gesamten WertschÃÂÃÂ¶pfungskette des Unternehmens sowie eine absolute Reduzierung um 50 % bis 2030 im Vergleich zu 2019 zu erreichen. DarÃÂÃÂ¼ber hinaus hat Salesforce kÃÂÃÂ¼rzlich neue Klimaverpflichtungen eingefÃÂÃÂ¼hrt, die in LieferkettenvertrÃÂÃÂ¤ge integriert werden, um Lieferanten bei der Reduzierung ihrer CO2-Emissionen zu unterstÃÂÃÂ¼tzen. ÃÂÃÂEine wirksame BekÃÂÃÂ¤mpfung des Klimawandels erfordert branchenÃÂÃÂ¼bergreifende Zusammenarbeit und glaubwÃÂÃÂ¼rdige wissenschaftsbasierte MaÃÂÃÂnahmenÃÂÃÂ, sagte David S. Taylor, Vorstandsvorsitzender, PrÃÂÃÂ¤sident und CEO von The Procter & Gamble Company. ÃÂÃÂP&G hat in den letzten zehn Jahren erhebliche Fortschritte gemacht und wir wissen, dass wir mehr tun mÃÂÃÂ¼ssen. Die vor uns liegende Aufgabe ist dringend, schwierig und viel grÃÂÃÂ¶ÃÂÃÂer, als jedes einzelne Unternehmen alleine lÃÂÃÂ¶sen kann. P&G ist stolz darauf, The Climate Pledge beizutreten, wÃÂÃÂ¤hrend wir zusammenarbeiten, um unser gemeinsames Zuhause fÃÂÃÂ¼r kommende Generationen zu erhalten.ÃÂÃÂ ÃÂÃÂDie Dringlichkeit der Klimakrise erfordert, dass wir mutige MaÃÂÃÂnahmen zum Schutz unseres Planeten ergreifen, und The Climate Pledge ist ein weiterer Schritt in die richtige RichtungÃÂÃÂ, sagte Enrique Lores, PrÃÂÃÂ¤sident und CEO von HP Inc. ÃÂÃÂHP hat sich zu einigen der umfassendsten und aggressivsten KlimaschutzmaÃÂÃÂnahmen im Technologiesektor verpflichtet, und wir verfolgen diese Agenda in unserem Produkt- und Serviceportfolio, unserer betrieblichen PrÃÂÃÂ¤senz und einer breiteren WertschÃÂÃÂ¶pfungskette, um unsere Wirkung zu maximieren. Wir haben die groÃÂÃÂe Chance, das zukÃÂÃÂ¼nftige Wachstum unseres Unternehmens voranzutreiben und gleichzeitig eine nachhaltigere Zukunft zu schaffen.ÃÂÃÂ Unternehmen haben einen Beitrag zum Klimawandel geleistet, aber tiefe Einschnitte bei den Treibhausgasemissionen kÃÂÃÂ¶nnten die steigenden Temperaturen stabilisieren. Aus diesem Grund sind dringend ehrgeizige MaÃÂÃÂnahmen von Unternehmen auf der ganzen Welt erforderlich. Die Unterzeichner des Climate Pledge sind in einer einzigartigen Position, um sich der Herausforderung zu stellen, den Klimawandel anzugehen und zur Schaffung einer kohlenstoffarmen Wirtschaft der Zukunft beizutragen. ÃÂÃÂDer Klimawandel ist die entscheidende Herausforderung unserer ZeitÃÂÃÂ, sagte Nick Beighton, CEO von ASOS. ÃÂÃÂUnternehmen mÃÂÃÂ¼ssen mutig und entschlossen handeln, um LÃÂÃÂ¶sungen fÃÂÃÂ¼r die sich ausbreitende Krise zu finden, sowohl einzeln als auch gemeinsam. Aus diesem Grund ist ASOS stolz darauf, Amazon, Global Optimism und den anderen Unterzeichnern von The Climate Pledge beizutreten und sich daher der Kampagne ÃÂÃÂRace to ZeroÃÂÃÂ der UNFCCC anzuschlieÃÂÃÂen. Dies stÃÂÃÂ¤rkt unser Engagement fÃÂÃÂ¼r Nachhaltigkeit und bedeutet, dass wir einer Gemeinschaft beitreten, die Wissen, Ideen und bewÃÂÃÂ¤hrte Verfahren teilt, um diese wichtige Mission zu erfÃÂÃÂ¼llen.ÃÂÃÂ ÃÂÃÂJetzt ist die Zeit fÃÂÃÂ¼r dringendes Handeln. Wir treten in das entscheidende Jahrzehnt ein ÃÂÃÂ es ist nicht nur notwendig, MaÃÂÃÂnahmen zum Schutz der Erde fÃÂÃÂ¼r zukÃÂÃÂ¼nftige Generationen zu ergreifen, sondern auch fÃÂÃÂ¼r die Zukunft der MenschheitÃÂÃÂ, sagte Guillaume Le Cunff, CEO von NestlÃÂÃÂ© Nespresso. ÃÂÃÂIch glaube, dass der Privatsektor ein starker Katalysator fÃÂÃÂ¼r VerÃÂÃÂ¤nderungen sein kann, wenn alle Akteure gemeinsam handeln. Aus diesem Grund sind wir stolzer Unterzeichner von The Climate Pledge, einer Netto-Null-Verpflichtung im Einklang mit unserer Verpflichtung zur CO2-NeutralitÃÂÃÂ¤t. Dies wird durch eine signifikante Dekarbonisierung unserer direkten Emissionen und der Emissionen der globalen Lieferkette sowie durch den Einsatz hochwertiger In-Setting- und Kompensationsinitiativen zur Neutralisierung aller verbleibenden Emissionen erreicht.ÃÂÃÂ ÃÂÃÂWir befinden uns in einer Klimakrise. Salesforce ist der Ansicht, dass das GeschÃÂÃÂ¤ft die beste Plattform fÃÂÃÂ¼r VerÃÂÃÂ¤nderungen ist, und wir betrachten die Umwelt als einen wichtigen Stakeholder. Aus diesem Grund ist Salesforce stolz darauf, sich The Climate Pledge anzuschlieÃÂÃÂen, um die KlimamaÃÂÃÂnahmen fÃÂÃÂ¼r Unternehmen zu beschleunigen und zu skalieren, um bedeutende VerÃÂÃÂ¤nderungen voranzutreiben. Jedes Unternehmen spielt eine wichtige Rolle im Kampf um die Rettung unseres PlanetenÃÂÃÂ, sagte Suzanne BiDianca, Chief Impact Officer von Salesforce. ÃÂÃÂWir sind bestrebt, die volle LeistungsfÃÂÃÂ¤higkeit von Salesforce zu nutzen, um eine nachhaltige Zukunft zu schaffen, indem wir die grÃÂÃÂ¶ÃÂÃÂten Unternehmen der Welt auf Netto-Null beschleunigen und bis zu 100 Gigatonnen Kohlenstoff durch die Erhaltung, Wiederherstellung und den Anbau von 1 Billion BÃÂÃÂ¤umen speichern; und die ÃÂÃÂkopreneur-Revolution anzukurbeln.ÃÂÃÂ Die heutige AnkÃÂÃÂ¼ndigung reagiert auf die Ergebnisse des jÃÂÃÂ¼ngsten Berichts des Zwischenstaatlichen Ausschusses fÃÂÃÂ¼r KlimaÃÂÃÂ¤nderungen (IPCC) der Vereinten Nationen, der die Notwendigkeit einer erhÃÂÃÂ¶hten Dringlichkeit bei der BewÃÂÃÂ¤ltigung der Klimakrise unterstreicht. Ohne sofortige, rasche und groÃÂÃÂ angelegte Reduzierungen der Treibhausgasemissionen wird eine Begrenzung der ErwÃÂÃÂ¤rmung auf fast 1,5 Grad Celsius oder sogar 2 Grad Celsius auÃÂÃÂer Reichweite sein. ÃÂÃÂDer jÃÂÃÂ¼ngste vom IPCC verÃÂÃÂ¶ffentlichte Bericht ist die bisher schÃÂÃÂ¤rfste Warnung, dass die Systeme, die das menschliche Leben unterstÃÂÃÂ¼tzen, einen Wendepunkt erreichen und dass sich das Zeitfenster fÃÂÃÂ¼r entschlossenes Handeln verengtÃÂÃÂ, sagte Christiana Figueres, die ehemalige Klimachefin der UN und jetzt GrÃÂÃÂ¼ndungspartnerin von Global Optimism. ÃÂÃÂDiesem Weckruf der Wissenschaft muss man mit Mut und ÃÂÃÂberzeugung begegnen. Vor diesem Hintergrund ist es ermutigend, dass sich jetzt 86 weitere Unternehmen ÃÂÃÂ einige der grÃÂÃÂ¶ÃÂÃÂten bekannten Namen der Welt ÃÂÃÂ The Climate Pledge anschlieÃÂÃÂen. Sie verpflichten sich, ihre MaÃÂÃÂnahmen zur rechtzeitigen BekÃÂÃÂ¤mpfung des Klimawandels zu beschleunigen und ihren Beitrag zum Aufbau einer kohlenstoffarmen Wirtschaft zu leisten. Ich freue mich auf die FrÃÂÃÂ¼chte der FÃÂÃÂ¼hrung, die wir von diesem Kollektiv von 200 Unterzeichnern sehen werden, die jetzt Teil von The Climate Pledge sind.ÃÂÃÂ Amazon und Global Optimism begrÃÂÃÂ¼ÃÂÃÂen die neuen Unterzeichner, die sich The Climate Pledge verpflichtet haben: Accenture Fileni Omni Logistics 2. Advansor A/S Flooglebinder Palo Alto Networks 3. AGRONOMICS Geotab Inc. pema elektrotechnik gmbh Aico GSK PortXchange AmpUp Glovo Primafrio Arrow Sky Media GoCodeGreen Procter & Gamble ASOS GODI Relais Colis AutoBrush Greenko Energy Holdings Rider Levett Bucknall UK Ltd Aviva GRM Consulting Ltd Sabey Data Centers Balloon One HP SAITECH Limited Boma Jewelry Holt Renefrew Salesforce Brown Thomas Arnotts Intertape Polymer Group Scania BT Group PLC Keltbray Selfridges Canva KnowBe4 Sulmara CarbonCure Landsec The Dragon Group CBRE Lighthouse The Lamington Group Clean Energy Fuels Linney Treedom Concentric Advisors Logicompany3 trilefa Costain Logitech Tunley Engineering Crown Holdings Inc. Mahou San Miguel Turntide Technologies Cundall Medoola UPL De Bijenkorf Midstream Lighting UrbanX Renewables Group Deloitte Mighty Buildings Vanquish Carbon Advisors Diligent Mohawk Group VMware Dimagi mydollarbills WIMB Lifestyle Edmund Bell NDB Inc. WPP Enfuce Financial Services Nespresso Xero ECONYQ Technologies Ltd. Neuron Mobility Zenergi FAN Courier Ogury Informationen zu allen 201 Unterzeichnern, die sich zu The Climate Pledge verpflichtet haben, und zu den MaÃÂÃÂnahmen, die sie zur Dekarbonisierung ihrer Unternehmen ergreifen, sind auf der The Climate Pledge-Website verfÃÂÃÂ¼gbar, darunter: ASOS ASOS glaubt, dass groÃÂÃÂartige Mode keine Kompromisse eingehen sollte, sei es in Bezug auf Stil, Preis oder Wirkung. Das Unternehmen hat sich anspruchsvolle Ziele gesetzt, um die Auswirkungen seiner Produkte, seines GeschÃÂÃÂ¤fts und seiner Logistik zu reduzieren, und sucht stÃÂÃÂ¤ndig nach neuen Wegen, um die Nachhaltigkeit voranzutreiben. In diesem Jahr endete die langfristige Strategie zur Reduzierung der CO2-Emissionen von ASOS, Carbon 2020. Diese 2015 angekÃÂÃÂ¼ndigte Strategie hat sich zum Ziel gesetzt, die betrieblichen CO2-Emissionen bis 2020 jedes Jahr zu reduzieren. Das Programm war ein Erfolg, da ASOS jedes Jahr seine Emissionen reduzierte und die EmissionsintensitÃÂÃÂ¤t in dieser Zeit um 30 % senkte. Dies entspricht der Vermeidung von 110.000 Tonnen CO2-Emissionen. ASOS ist stÃÂÃÂ¤ndig bestrebt, seinen Betrieb zu dekarbonisieren, indem es beispielsweise See-, StraÃÂÃÂen- und Schienenfracht priorisiert und mit Lieferkettenpartnern zusammenarbeitet, um kohlenstoffarme Innovationen voranzutreiben. Zu diesen BemÃÂÃÂ¼hungen gehÃÂÃÂ¶ren der Einsatz von Elektrofahrzeugen fÃÂÃÂ¼r die Lieferung, die Implementierung von 100 % erneuerbarer Energie im gesamten BÃÂÃÂ¼roportfolio von ASOS und die Maximierung der Menge an recycelten Verpackungsinhalten. Da Carbon 2020 nun zu Ende geht, ist ASOS dabei, noch ehrgeizigere, langfristige Ziele zu setzen, um seinen CO2-FuÃÂÃÂabdruck zu reduzieren. HP Anfang dieses Jahres hat HP Inc. eine Reihe mutiger Klimaverpflichtungen verÃÂÃÂ¶ffentlicht. Bis 2040 wird die gesamte WertschÃÂÃÂ¶pfungskette des Unternehmens ÃÂÃÂ vom Betrieb ÃÂÃÂ¼ber die Produkte bis hin zur globalen Lieferkette ÃÂÃÂ Netto-Null-Emissionen von Kohlenstoff und anderen Treibhausgasen erreichen, einschlieÃÂÃÂlich einer absoluten Reduzierung um 50 % bis 2030 im Vergleich zu 2019. Insgesamt konzentriert sich HP auf beschleunigte Strategien, die darauf abzielen, Wachstum von CO2-Emissionen und Ressourcenverbrauch zu entkoppeln, Innovationen voranzutreiben und Design- und GeschÃÂÃÂ¤ftsmodelle zu transformieren. Dazu gehÃÂÃÂ¶ren Print und Computer as a Service, nachhaltige Materialien, Zusammenarbeit in der Lieferkette, Investitionen in erneuerbare Energien und Fortschritte bei der Energieeffizienz von Produkten. Nespresso Nespresso ist fÃÂÃÂ¼r seine Kaffeekompetenz von der Bohne ÃÂÃÂ¼ber die Kapsel bis zur Tasse bekannt und legt groÃÂÃÂen Wert darauf, verantwortungsvolle und nachhaltige Praktiken in seiner gesamten WertschÃÂÃÂ¶pfungskette zu priorisieren und gleichzeitig die strengsten QualitÃÂÃÂ¤tsstandards bei den Produkten und Dienstleistungen einzuhalten, die es seinen Kunden bietet. Jede Tasse Kaffee hat einen CO2-FuÃÂÃÂabdruck, der sich aus allen AktivitÃÂÃÂ¤ten wÃÂÃÂ¤hrend seines gesamten Lebenszyklus ergibt ÃÂÃÂ von der Farm bis zum Ende des Lebens. Seit 2009 konzentriert sich die Klima-Roadmap von Nespresso auf die Entwicklung von LÃÂÃÂ¶sungen, die die Treibhausgasemissionen bestimmter AktivitÃÂÃÂ¤ten innerhalb dieses Lebenszyklus verringern. Ihr Ziel waren die AktivitÃÂÃÂ¤ten, die fÃÂÃÂ¼r groÃÂÃÂe Auswirkungen verantwortlich sind ÃÂÃÂ sowohl innerhalb als auch auÃÂÃÂerhalb ihrer direkten Kontrolle. Von der Energieeffizienz der Maschinen ÃÂÃÂ¼ber erneuerbare Energien, nachhaltige Anbaumethoden bis hin zum Recycling haben diese BemÃÂÃÂ¼hungen zur Reduzierung des CO2-FuÃÂÃÂabdrucks einer Nespresso-Tasse Kaffee gefÃÂÃÂ¼hrt. Im September 2020 kÃÂÃÂ¼ndigte Nespresso einen wichtigen Meilenstein fÃÂÃÂ¼r seine Klimareise an: Jede Tasse Nespresso-Kaffee, sowohl zu Hause als auch im Beruf, wird bis 2022 klimaneutral sein. Diese Verpflichtung baut auf den kontinuierlichen MaÃÂÃÂnahmen des Unternehmens zur Reduzierung der Emissionen pro Tasse auf, die im Vergleich zu einer ÃÂÃÂkobilanzstudie aus dem Jahr 2009 zu einer Reduzierung um 24 % gefÃÂÃÂ¼hrt haben. In Bezug auf Strom machen erneuerbare Quellen 100 % des in den Nespresso-Fabriken verbrauchten Stroms aus. Procter & Gamble (P&G) P&G bedient 5 Milliarden Verbraucher auf der ganzen Welt mit einem der stÃÂÃÂ¤rksten Portfolios an vertrauenswÃÂÃÂ¼rdigen, qualitativ hochwertigen und fÃÂÃÂ¼hrenden Marken. Im Jahr 2007 hat P&G sein erstes Ziel festgelegt, die Treibhausgasemissionen (THG) aus seinen ProduktionsstÃÂÃÂ¤tten zu reduzieren. P&G hat diese BemÃÂÃÂ¼hungen ausgeweitet und beschleunigt, um die Treibhausgasemissionen ÃÂÃÂ¼ber den gesamten Lebenszyklus seiner Produkte und BetriebsablÃÂÃÂ¤ufe zu verringern. Seit 2010 hat das Unternehmen die absoluten Emissionen weltweit um 52 % reduziert, den Kauf von Strom aus erneuerbaren Quellen um 97 % erhÃÂÃÂ¶ht und sich mit Verbrauchern zusammengetan, um mit Produkten wie Tide und Ariel, die durch KaltwasserwÃÂÃÂ¤sche 15 Millionen Tonnen CO2 reduzieren, mÃÂÃÂ¼helos Nachhaltigkeit zu Hause zu ermÃÂÃÂ¶glichen. P&G hat vor Kurzem angekÃÂÃÂ¼ndigt, die Fortschritte zu beschleunigen, um bis 2040 Netto-Null-Emissionen in allen Bereichen seines Betriebs, Transports und seiner Lieferkette, vom Rohstoff bis zum EinzelhÃÂÃÂ¤ndler, zu erreichen. Dieses Netto-Null-Ziel bekrÃÂÃÂ¤ftigt die PrioritÃÂÃÂ¤ten von P&G, die Emissionen jetzt mit den heute verfÃÂÃÂ¼gbaren Tools zu reduzieren und gleichzeitig Innovationen in Richtung einer grÃÂÃÂ¼neren Zukunft zu schaffen. Salesforce Als weltweit fÃÂÃÂ¼hrende CRM-Plattform (Customer Relationship Management) ist Salesforce der Ansicht, dass das GeschÃÂÃÂ¤ft die grÃÂÃÂ¶ÃÂÃÂte Plattform fÃÂÃÂ¼r VerÃÂÃÂ¤nderungen ist, und betrachtet die Umwelt als einen wichtigen Stakeholder. Von seinen Lieferanten und Kunden bis hin zu seiner Technologie und seiner Marke nutzt Salesforce seine grÃÂÃÂ¶ÃÂÃÂten EinflussmÃÂÃÂ¶glichkeiten als Agenten fÃÂÃÂ¼r den Wandel bei der grÃÂÃÂ¶ÃÂÃÂten und risikoreichsten Herausforderung aller Zeiten ÃÂÃÂ dem Klimanotstand. Die Nachhaltigkeitsinitiativen von Salesforce konzentrieren sich auf den globalen Weg zu Netto-Null-Emissionen, die Mobilisierung der globalen BemÃÂÃÂ¼hungen, um zusÃÂÃÂ¤tzliche Billionen BÃÂÃÂ¤ume auf der Erde zu sehen, und den Schutz und die Wiederbelebung der Weltmeere. Mit der Sustainability Cloud hilft Salesforce Unternehmen dabei, den Weg zur Netto-Null zu beschleunigen, eine einzige Quelle der Wahrheit zu erhalten und schnell MaÃÂÃÂnahmen zu ihren CO2-Emissionen zu ergreifen. Als MitbegrÃÂÃÂ¼nder der globalen Plattform UpLink hilft Salesforce dabei, mehr als 10.000 Ecopreneurs auf der ganzen Welt bei der Entwicklung der nÃÂÃÂ¤chsten Generation innovativer LÃÂÃÂ¶sungen zur FÃÂÃÂ¶rderung der Nachhaltigkeit zu verbinden. Als Teilnehmer des UN Global Compact und der UN-Dekade zur Wiederherstellung von ÃÂÃÂkosystemen trÃÂÃÂ¤gt Salesforce dazu bei, die globale Bewegung anzufÃÂÃÂ¼hren, um Unternehmen an den Zielen der Vereinten Nationen fÃÂÃÂ¼r nachhaltige Entwicklung auszurichten und eine sicherere, gerechtere und nachhaltigere Zukunft fÃÂÃÂ¼r alle aufzubauen. ÃÂÃÂber The Climate Pledge Im Jahr 2019 riefen Amazon und Global Optimism gemeinsam das Klimaschutzversprechen The Climate Pledge ins Leben, eine Verpflichtung, die Vorgaben des Pariser Abkommens zehn Jahre frÃÂÃÂ¼her zu erreichen und bis 2040 netto klimaneutral zu sein. Mittlerweile haben 201 Organisationen The Climate Pledge unterzeichnet und damit ein wichtiges Signal gesendet, dass die Nachfrage nach Produkten und Dienstleistungen, die zur Verringerung der CO2-Emissionen beitragen, schnell wachsen wird. Weitere Informationen erhalten Sie unter www.theclimatepledge.com. ÃÂÃÂber Amazon Amazon orientiert sich an vier GrundsÃÂÃÂ¤tzen: Orientierung am Kunden statt an der Konkurrenz, Leidenschaft fÃÂÃÂ¼r Neuerungen, Einsatz fÃÂÃÂ¼r betriebliche Optimierung sowie langfristiges Denken. Amazon strebt danach, das kundenorientierteste Unternehmen der Welt, der beste Arbeitgeber der Welt und der sicherste Arbeitsplatz der Welt zu sein. Kundenrezensionen, 1-Klick-EinkÃÂÃÂ¤ufe, personalisierte Empfehlungen, Prime, Versand durch Amazon, AWS, Kindle Direct Publishing, Kindle, Career Choice, Fire-Tablets, Fire TV, Amazon Echo, Alexa, Just Walk Out-Technologie, Amazon Studios und The Climate Pledge sind einige der Pionierleistungen von Amazon. FÃÂÃÂ¼r weitere Informationen besuchen Sie amazon.com/about und folgen Sie @AmazonNews. ÃÂÃÂber Global Optimism Nach der Sicherung des bahnbrechenden Pariser Abkommens im Jahr 2015 grÃÂÃÂ¼ndeten Christiana Figueres und Tom Rivett-Carnac Global Optimism, um neue Narrative aufzubauen und Kampagnen und Partnerschaften mit der unverfrorenen Can-Do-Haltung zu unterstÃÂÃÂ¼tzen, die jetzt von uns allen verlangt wird, um die vom Pariser Abkommen geforderte Transformation herbeizufÃÂÃÂ¼hren. Wir bauen Partnerschaften und Kampagnen mit FÃÂÃÂ¼hrungskrÃÂÃÂ¤ften auf, die bereit sind, in die Entscheidungen zu investieren, die erforderlich sind, um das Ziel zu erreichen, die globalen Treibhausgasemissionen bis 2030 zu halbieren, bis 2050 schlieÃÂÃÂlich Netto-Null zu erreichen und eine naturfreundliche Wirtschaft zu schaffen. Weitere Informationen finden Sie unter GlobalOptimism.com. Die Ausgangssprache, in der der Originaltext verÃÂÃÂ¶ffentlicht wird, ist die offizielle und autorisierte Version. ÃÂÃÂbersetzungen werden zur besseren VerstÃÂÃÂ¤ndigung mitgeliefert. Nur die Sprachversion, die im Original verÃÂÃÂ¶ffentlicht wurde, ist rechtsgÃÂÃÂ¼ltig. Gleichen Sie deshalb ÃÂÃÂbersetzungen mit der originalen Sprachversion der VerÃÂÃÂ¶ffentlichung ab.",https://www.businesswire.com/news/home/20210922005602/de/,businesswire.com,5,seattlebusiness wireheute gaben amazon und global optimism bekannt das mittlerweile mehr al unternehmen climate pledge unterzeichnet haben zu den neuen unterzeichnern die climate pledge beitreten gehren procter gamble hp salesforce asos und nespresso die unterzeichner der verpflichtungserklrung erwirtschaften insgesamt einen weltweiten jahresumsatz von ber billionen usd und haben mehr al millionen mitarbeiter branchen lndern durch da erreichen von nettokohlenstoffaussto von null bi also jahre vor dem pariser abkommen wird erwartet das die derzeitigen unterzeichner de climate pledge kollektiv milliarden tonnen der coemissionen gegenber einem ausgangswert von verringern werden dy entspricht der derzeitigen weltweiten jhrlichen emissionen ein beleg fr die kollektiven auswirkungen die climate pledge bei der bekmpfung de klimawandels haben und zu mehr manahmen zur bewltigung der klimakrise anregen wird die unterzeichner von climate pledge stimmen zu treibhausgasemissionen regelmig zu messen und darber zu berichten dekarbonisierungsstrategien im einklang mit dem bereinkommen von paris durch echte geschftliche vernderungen und innovationen umzusetzen einschlielich effizienzsteigerungen erneuerbarer energien materialreduzierungen und anderer strategien zur beseitigung von coemissionen alle verbleibenden emissionen durch zustzliche quantifizierbare reale dauerhafte und sozial ntzliche ausgleichsmanahmen zu neutralisieren um bi einen jhrlichen nettokohlenstoffaussto von null zu erreichen ich glaube das unternehmen wie amazon heute mehr denn je die pflicht haben den kampf um unseren planeten anzufhren sagte andy jassy ceo von amazon aber diese herausforderung kann nicht von einem unternehmen gelst werden e erfordert das wir alle zusammen handeln und da ist einer der grnde warum wir aufgeregt sind mitteilen zu knnen das mehr al unternehmen mit un zusammen climate pledge unterzeichnet haben eine verpflichtung die ziele de pariser abkommens jahre frher zu erreichen viele der neuen unterzeichner von pledge machen bereits bedeutende fortschritte bei der reduzierung ihrer coemissionen seit hat procter gamble seine absoluten emissionen im weltweiten betrieb um reduziert da unternehmen hat auch den bezug von strom au erneuerbaren quellen um erhht und sich mit verbrauchern zusammengetan um mit produkten wie tide und ariel nachhaltigkeit mhelos zu hause zu machen die dazu beigetragen haben die coemissionen durch kaltwasserwsche um millionen tonnen zu reduzieren procter gamble hat krzlich da ziel angekndigt bi nettonullemissionen allen bereichen seine betriebs seine transport und seiner lieferkette vom rohstoff bi zum einzelhndler zu erreichen nespresso bekannt fr seine kaffeekompetenz von der bohne ber die kapsel bi zur tasse kndigt einen wichtigen meilenstein fr seine klimareise jede tasse nespressokaffee sowohl zu hause al auch im beruf wird bi klimaneutral sein asos gab bekannt das e im rahmen seiner carbon strategie seine emissionen seit jedes jahr reduziert und die emissionsintensitt dieser zeit um gesenkt hat einer vermeidung von tonnen coemissionen entspricht anfang de jahres hat hp eine reihe mutiger klimaverpflichtungen verffentlicht darunter da ziel bi nettonullemissionen von kohlenstoff und anderen treibhausgasen der gesamten wertschpfungskette de unternehmens sowie eine absolute reduzierung um bi im vergleich zu zu erreichen darber hinaus hat salesforce krzlich neue klimaverpflichtungen eingefhrt die lieferkettenvertrge integriert werden um lieferanten bei der reduzierung ihrer coemissionen zu untersttzen eine wirksame bekmpfung de klimawandels erfordert branchenbergreifende zusammenarbeit und glaubwrdige wissenschaftsbasierte manahmen sagte david taylor vorstandsvorsitzender prsident und ceo von procter gamble company pg hat den letzten zehn jahren erhebliche fortschritte gemacht und wir wissen das wir mehr tun mssen die vor un liegende aufgabe ist dringend schwierig und viel grer al jedes einzelne unternehmen alleine lsen kann pg ist stolz darauf climate pledge beizutreten whrend wir zusammenarbeiten um unser gemeinsames zuhause fr kommende generationen zu erhalten die dringlichkeit der klimakrise erfordert das wir mutige manahmen zum schutz unseres planeten ergreifen und climate pledge ist ein weiterer schritt die richtige richtung sagte enrique lore prsident und ceo von hp inc hp hat sich zu einigen der umfassendsten und aggressivsten klimaschutzmanahmen im technologiesektor verpflichtet und wir verfolgen diese agenda unserem produkt und serviceportfolio unserer betrieblichen prsenz und einer breiteren wertschpfungskette um unsere wirkung zu maximieren wir haben die groe chance da zuknftige wachstum unseres unternehmens voranzutreiben und gleichzeitig eine nachhaltigere zukunft zu schaffen unternehmen haben einen beitrag zum klimawandel geleistet aber tiefe einschnitte bei den treibhausgasemissionen knnten die steigenden temperaturen stabilisieren au diesem grund sind dringend ehrgeizige manahmen von unternehmen auf der ganzen welt erforderlich die unterzeichner de climate pledge sind einer einzigartigen position um sich der herausforderung zu stellen den klimawandel anzugehen und zur schaffung einer kohlenstoffarmen wirtschaft der zukunft beizutragen der klimawandel ist die entscheidende herausforderung unserer zeit sagte nick beighton ceo von asos unternehmen mssen mutig und entschlossen handeln um lsungen fr die sich ausbreitende krise zu finden sowohl einzeln al auch gemeinsam au diesem grund ist asos stolz darauf amazon global optimism und den anderen unterzeichnern von climate pledge beizutreten und sich daher der kampagne race zero der unfccc anzuschlieen dy strkt unser engagement fr nachhaltigkeit und bedeutet das wir einer gemeinschaft beitreten die wissen ideen und bewhrte verfahren teilt um diese wichtige mission zu erfllen jetzt ist die zeit fr dringendes handeln wir treten da entscheidende jahrzehnt ein e ist nicht nur notwendig manahmen zum schutz der erde fr zuknftige generationen zu ergreifen sondern auch fr die zukunft der menschheit sagte guillaume le cunff ceo von nestl nespresso ich glaube das der privatsektor ein starker katalysator fr vernderungen sein kann wenn alle akteure gemeinsam handeln au diesem grund sind wir stolzer unterzeichner von climate pledge einer nettonullverpflichtung im einklang mit unserer verpflichtung zur coneutralitt dy wird durch eine signifikante dekarbonisierung unserer direkten emissionen und der emissionen der globalen lieferkette sowie durch den einsatz hochwertiger insetting und kompensationsinitiativen zur neutralisierung aller verbleibenden emissionen erreicht wir befinden un einer klimakrise salesforce ist der ansicht das da geschft die beste plattform fr vernderungen ist und wir betrachten die umwelt al einen wichtigen stakeholder au diesem grund ist salesforce stolz darauf sich climate pledge anzuschlieen um die klimamanahmen fr unternehmen zu beschleunigen und zu skalieren um bedeutende vernderungen voranzutreiben jedes unternehmen spielt eine wichtige rolle im kampf um die rettung unseres planeten sagte suzanne bidianca chief impact officer von salesforce wir sind bestrebt die volle leistungsfhigkeit von salesforce zu nutzen um eine nachhaltige zukunft zu schaffen indem wir die grten unternehmen der welt auf nettonull beschleunigen und bi zu gigatonnen kohlenstoff durch die erhaltung wiederherstellung und den anbau von billion bumen speichern und die kopreneurrevolution anzukurbeln die heutige ankndigung reagiert auf die ergebnisse de jngsten berichts de zwischenstaatlichen ausschusses fr klimanderungen ipcc der vereinten nationen der die notwendigkeit einer erhhten dringlichkeit bei der bewltigung der klimakrise unterstreicht ohne sofortige rasche und gro angelegte reduzierungen der treibhausgasemissionen wird eine begrenzung der erwrmung auf fast grad celsius oder sogar grad celsius auer reichweite sein der jngste vom ipcc verffentlichte bericht ist die bisher schrfste warnung das die systeme die da menschliche leben untersttzen einen wendepunkt erreichen und das sich da zeitfenster fr entschlossenes handeln verengt sagte christiana figueres die ehemalige klimachefin der un und jetzt grndungspartnerin von global optimism diesem weckruf der wissenschaft mus man mit mut und berzeugung begegnen vor diesem hintergrund ist e ermutigend das sich jetzt weitere unternehmen einige der grten bekannten namen der welt climate pledge anschlieen sie verpflichten sich ihre manahmen zur rechtzeitigen bekmpfung de klimawandels zu beschleunigen und ihren beitrag zum aufbau einer kohlenstoffarmen wirtschaft zu leisten ich freue mich auf die frchte der fhrung die wir von diesem kollektiv von unterzeichnern sehen werden die jetzt teil von climate pledge sind amazon und global optimism begren die neuen unterzeichner die sich climate pledge verpflichtet haben accenture fileni omni logistics advansor flooglebinder palo alto network agronomics geotab inc pema elektrotechnik gmbh aico gsk portxchange ampup glovo primafrio arrow sky medium gocodegreen procter gamble asos godi relais colis autobrush greenko energy holding rider levett bucknall uk ltd aviva grm consulting ltd sabey data center balloon one hp saitech limited boma jewelry holt renefrew salesforce brown thomas arnotts intertape polymer group scania bt group plc keltbray selfridges canva knowbe sulmara carboncure landsec dragon group cbre lighthouse lamington group clean energy fuel linney treedom concentric advisor logicompany trilefa costain logitech tunley engineering crown holding inc mahou san miguel turntide technology cundall medoola upl de bijenkorf midstream lighting urbanx renewables group deloitte mighty building vanquish carbon advisor diligent mohawk group vmware dimagi mydollarbills wimb lifestyle edmund bell ndb inc wpp enfuce financial service nespresso xero econyq technology ltd neuron mobility zenergi fan courier ogury informationen zu allen unterzeichnern die sich zu climate pledge verpflichtet haben und zu den manahmen die sie zur dekarbonisierung ihrer unternehmen ergreifen sind auf der climate pledgewebsite verfgbar darunter asos asos glaubt das groartige mode keine kompromisse eingehen sollte sei e bezug auf stil preis oder wirkung da unternehmen hat sich anspruchsvolle ziele gesetzt um die auswirkungen seiner produkte seine geschfts und seiner logistik zu reduzieren und sucht stndig nach neuen wegen um die nachhaltigkeit voranzutreiben diesem jahr endete die langfristige strategie zur reduzierung der coemissionen von asos carbon diese angekndigte strategie hat sich zum ziel gesetzt die betrieblichen coemissionen bi jedes jahr zu reduzieren da programm war ein erfolg da asos jedes jahr seine emissionen reduzierte und die emissionsintensitt dieser zeit um senkte dy entspricht der vermeidung von tonnen coemissionen asos ist stndig bestrebt seinen betrieb zu dekarbonisieren indem e beispielsweise see straen und schienenfracht priorisiert und mit lieferkettenpartnern zusammenarbeitet um kohlenstoffarme innovationen voranzutreiben zu diesen bemhungen gehren der einsatz von elektrofahrzeugen fr die lieferung die implementierung von erneuerbarer energie im gesamten broportfolio von asos und die maximierung der menge recycelten verpackungsinhalten da carbon nun zu ende geht ist asos dabei noch ehrgeizigere langfristige ziele zu setzen um seinen cofuabdruck zu reduzieren hp anfang diesis jahres hat hp inc eine reihe mutiger klimaverpflichtungen verffentlicht bi wird die gesamte wertschpfungskette de unternehmens vom betrieb ber die produkte bi hin zur globalen lieferkette nettonullemissionen von kohlenstoff und anderen treibhausgasen erreichen einschlielich einer absoluten reduzierung um bi im vergleich zu insgesamt konzentriert sich hp auf beschleunigte strategien die darauf abzielen wachstum von coemissionen und ressourcenverbrauch zu entkoppeln innovationen voranzutreiben und design und geschftsmodelle zu transformieren dazu gehren print und computer service nachhaltige materialien zusammenarbeit der lieferkette investitionen erneuerbare energien und fortschritte bei der energieeffizienz von produkten nespresso nespresso ist fr seine kaffeekompetenz von der bohne ber die kapsel bi zur tasse bekannt und legt groen wert darauf verantwortungsvolle und nachhaltige praktiken seiner gesamten wertschpfungskette zu priorisieren und gleichzeitig die strengsten qualittsstandards bei den produkten und dienstleistungen einzuhalten die e seinen kunden bietet jede tasse kaffee hat einen cofuabdruck der sich au allen aktivitten whrend seine gesamten lebenszyklus ergibt von der farm bi zum ende de lebens seit konzentriert sich die klimaroadmap von nespresso auf die entwicklung von lsungen die die treibhausgasemissionen bestimmter aktivitten innerhalb diesis lebenszyklus verringern ihr ziel waren die aktivitten die fr groe auswirkungen verantwortlich sind sowohl innerhalb al auch auerhalb ihrer direkten kontrolle von der energieeffizienz der maschinen ber erneuerbare energien nachhaltige anbaumethoden bi hin zum recycling haben diese bemhungen zur reduzierung de cofuabdrucks einer nespressotasse kaffee gefhrt im september kndigte nespresso einen wichtigen meilenstein fr seine klimareise jede tasse nespressokaffee sowohl zu hause al auch im beruf wird bi klimaneutral sein diese verpflichtung baut auf den kontinuierlichen manahmen de unternehmens zur reduzierung der emissionen pro tasse auf die im vergleich zu einer kobilanzstudie au dem jahr zu einer reduzierung um gefhrt haben bezug auf strom machen erneuerbare quellen de den nespressofabriken verbrauchten stroms au procter gamble pg pg bedient milliarden verbraucher auf der ganzen welt mit einem der strksten portfolio vertrauenswrdigen qualitativ hochwertigen und fhrenden marken im jahr hat pg sein erstes ziel festgelegt die treibhausgasemissionen thg au seinen produktionssttten zu reduzieren pg hat diese bemhungen ausgeweitet und beschleunigt um die treibhausgasemissionen ber den gesamten lebenszyklus seiner produkte und betriebsablufe zu verringern seit hat da unternehmen die absoluten emissionen weltweit um reduziert den kauf von strom au erneuerbaren quellen um erhht und sich mit verbrauchern zusammengetan um mit produkten wie tide und ariel die durch kaltwasserwsche millionen tonnen co reduzieren mhelos nachhaltigkeit zu hause zu ermglichen pg hat vor kurzem angekndigt die fortschritte zu beschleunigen um bi nettonullemissionen allen bereichen seine betriebs transport und seiner lieferkette vom rohstoff bi zum einzelhndler zu erreichen diesis nettonullziel bekrftigt die prioritten von pg die emissionen jetzt mit den heute verfgbaren tool zu reduzieren und gleichzeitig innovationen richtung einer grneren zukunft zu schaffen salesforce al weltweit fhrende crmplattform customer relationship management ist salesforce der ansicht das da geschft die grte plattform fr vernderungen ist und betrachtet die umwelt al einen wichtigen stakeholder von seinen lieferanten und kunden bi hin zu seiner technologie und seiner marke nutzt salesforce seine grten einflussmglichkeiten al agenten fr den wandel bei der grten und risikoreichsten herausforderung aller zeiten dem klimanotstand die nachhaltigkeitsinitiativen von salesforce konzentrieren sich auf den globalen weg zu nettonullemissionen die mobilisierung der globalen bemhungen um zustzliche billionen bume auf der erde zu sehen und den schutz und die wiederbelebung der weltmeere mit der sustainability cloud hilft salesforce unternehmen dabei den weg zur nettonull zu beschleunigen eine einzige quelle der wahrheit zu erhalten und schnell manahmen zu ihren coemissionen zu ergreifen al mitbegrnder der globalen plattform uplink hilft salesforce dabei mehr al ecopreneurs auf der ganzen welt bei der entwicklung der nchsten generation innovativer lsungen zur frderung der nachhaltigkeit zu verbinden al teilnehmer de un global compact und der undekade zur wiederherstellung von kosystemen trgt salesforce dazu bei die globale bewegung anzufhren um unternehmen den zielen der vereinten nationen fr nachhaltige entwicklung auszurichten und eine sicherere gerechtere und nachhaltigere zukunft fr alle aufzubauen ber climate pledge im jahr riefen amazon und global optimism gemeinsam da klimaschutzversprechen climate pledge in leben eine verpflichtung die vorgaben de pariser abkommens zehn jahre frher zu erreichen und bi netto klimaneutral zu sein mittlerweile haben organisationen climate pledge unterzeichnet und damit ein wichtiges signal gesendet das die nachfrage nach produkten und dienstleistungen die zur verringerung der coemissionen beitragen schnell wachsen wird weitere informationen erhalten sie unter ber amazon amazon orientiert sich vier grundstzen orientierung kunden statt der konkurrenz leidenschaft fr neuerungen einsatz fr betriebliche optimierung sowie langfristiges denken amazon strebt danach da kundenorientierteste unternehmen der welt der beste arbeitgeber der welt und der sicherste arbeitsplatz der welt zu sein kundenrezensionen klickeinkufe personalisierte empfehlungen prime versand durch amazon aws kindle direct publishing kindle career choice firetablets fire tv amazon echo alexa walk outtechnologie amazon studio und climate pledge sind einige der pionierleistungen von amazon fr weitere informationen besuchen sie amazoncomabout und folgen sie amazonnews ber global optimism nach der sicherung de bahnbrechenden pariser abkommens im jahr grndeten christiana figueres und tom rivettcarnac global optimism um neue narrative aufzubauen und kampagnen und partnerschaften mit der unverfrorenen candohaltung zu untersttzen die jetzt von un allen verlangt wird um die vom pariser abkommen geforderte transformation herbeizufhren wir bauen partnerschaften und kampagnen mit fhrungskrften auf die bereit sind die entscheidungen zu investieren die erforderlich sind um da ziel zu erreichen die globalen treibhausgasemissionen bi zu halbieren bi schlielich nettonull zu erreichen und eine naturfreundliche wirtschaft zu schaffen weitere informationen finden sie unter globaloptimismcom die ausgangssprache der der originaltext verffentlicht wird ist die offizielle und autorisierte version bersetzungen werden zur besseren verstndigung mitgeliefert nur die sprachversion die im original verffentlicht wurde ist rechtsgltig gleichen sie deshalb bersetzungen mit der originalen sprachversion der verffentlichung ab,-0.9999,-0.49995,0.222071,-0.722021,Negative Impact
23/09/2021,169.0025,171.45,169.00,170.80,170.80,47588000,3.3,50.56966791,1.192,0,13.66057312,0.8419472675,0.2413396506,0.08,274.31,15052.24023,16567.25977,7078.399902,6701.97998,3642.219971,59885.35938,20461.90039,171.213111,165.3182026,170.7443278,164.3876264,171.9884766,177.9846328,165.9923204,44.00660193,0.100608918,0.555977972,-0.455369054,3.029784066,173.5977829,10664112000,45.30576145,30.56713381,18.62999916,AWS gaat datacenters openen in Nieuw-Zeeland,"SEATTLE--(BUSINESS WIRE)--Vandaag heeft Amazon Web Services (AWS), een bedrijf van Amazon.com, Inc. (NASDAQ: AMZN), plannen aangekondigd om in 2024 een infrastructuurregio te openen in Aotearoa, Nieuw-Zeeland. Het nieuwe AWS AziÃÂÃÂ« Pacific (Auckland) Region zal bij de lancering bestaan ??uit drie Availability Zones (AZÃÂÃÂs) en voegt zich bij de bestaande 81 Availability Zones in 25 geografische AWS-regioÃÂÃÂs. De regio wordt eigendom van en wordt geÃÂÃÂ«xploiteerd door een lokale AWS-entiteit in Nieuw-Zeeland. Wereldwijd heeft AWS plannen aangekondigd voor 24 extra Availability Zones en nog acht AWS-regioÃÂÃÂs in AustraliÃÂÃÂ«, India, IndonesiÃÂÃÂ«, IsraÃÂÃÂ«l, Spanje, Zwitserland, de Verenigde Arabische Emiraten en de nieuwe AWS-regio in Nieuw-Zeeland. De nieuwe AWS Asia Pacific (Auckland)-regio stelt nog meer ontwikkelaars, startups en ondernemingen, evenals overheids-, onderwijs- en non-profitorganisaties in staat om hun applicaties uit te voeren en eindgebruikers te bedienen vanuit datacenters in Nieuw-Zeeland, zodat klanten die willen om hun gegevens in Nieuw-Zeeland te bewaren, daartoe in staat zijn. AWS heeft ook een economische impactstudie (EIS) gepubliceerd die schat dat het 1.000 nieuwe banen zal creÃÂÃÂ«ren door een investering van NZ$7,5 miljard (US$5,3 miljard) in de nieuwe AWS Asia Pacific (Auckland) regio met een geschatte economische impact op het BBP van Nieuw-Zeeland van NZ $ 10,8 miljard (US $ 7,7 miljard) in de komende 15 jaar. Ga voor meer informatie naar aws.amazon.com/about-aws/global-infrastructure. Deze bekendmaking is officieel geldend in de originele brontaal. Vertalingen zijn slechts als leeshulp bedoeld en moeten worden vergeleken met de tekst in de brontaal, die als enige rechtsgeldig is.",https://www.businesswire.com/news/home/20210923005732/nl/,businesswire.com,5,seattlebusiness wirevandaag heeft amazon web service aws een bedrijf van amazoncom inc nasdaq amzn plannen aangekondigd om een infrastructuurregio te openen aotearoa nieuwzeeland het nieuwe aws azi pacific auckland region zal bij de lancering bestaan uit drie availability zone az en voegt zich bij de bestaande availability zone geografische awsregios de regio wordt eigendom van en wordt gexploiteerd door een lokale awsentiteit nieuwzeeland wereldwijd heeft aws plannen aangekondigd voor extra availability zone en nog acht awsregios australi india indonesi isral spanje zwitserland de verenigde arabische emiraten en de nieuwe awsregio nieuwzeeland de nieuwe aws asia pacific aucklandregio stelt nog meer ontwikkelaars startup en ondernemingen evenals overheids onderwijs en nonprofitorganisaties staat om hun applicaties uit te voeren en eindgebruikers te bedienen vanuit datacenters nieuwzeeland zodat klanten die willen om hun gegevens nieuwzeeland te bewaren daartoe staat zijn aws heeft ook een economische impactstudie eis gepubliceerd die schat dat het nieuwe banen zal creren door een investering van nz miljard u miljard de nieuwe aws asia pacific auckland regio met een geschatte economische impact op het bbp van nieuwzeeland van nz miljard u miljard de komende jaar ga voor meer informatie naar awsamazoncomaboutawsglobalinfrastructure deze bekendmaking officieel geldend de originele brontaal vertalingen zijn slechts al leeshulp bedoeld en moeten worden vergeleken met de tekst de brontaal die al enige rechtsgeldig,-0.9001,-0.45005,0.2539617647,-0.704011765,Negative Impact
24/09/2021,170.1005,171.46,169.67,171.28,171.28,42324000,3.3,50.56966791,1.192,0,13.66057312,0.8419472675,0.2413396506,0.08,274.31,15047.7002,16539.15039,7051.5,6638.459961,3613.070068,60048.46875,20402.69922,171.007431,165.3802601,170.7651777,164.4561674,172.2622765,177.5236964,167.0008565,43.2252661,0.1200008478,0.4687825472,-0.348781699,2.992748805,172.9300005,10706436000,49.19177826,41.70954012,17.75,S&P 500 ETF's Best Day Since July: 6 Winning Stocks,"On Sep 23, equities logged their best day since July. These stocks played a crucial role in boosting the S&P 500.",https://www.zacks.com/stock/news/1800458/s-p-500-etf-s-best-day-since-july-6-winning-stocks,zacks.com,8,sep equity logged best day since july stock played crucial role boosting sp,0.8402,0.67216,0.2935876923,0.3785723077,Positive Impact
27/09/2021,168.575,170.78,166.98,170.29,170.29,72690000,3.3,50.56966791,1.192,0,13.66057312,0.8419472675,0.2413396506,0.08,274.31,14969.96973,16599.78906,7063.399902,6650.910156,3582.830078,60077.87891,20463.40039,170.8396008,165.45566,170.7465431,164.5142154,172.4027008,177.2613734,167.5440282,36.24425417,0.05517054005,0.3860601457,-0.330889606,3.116892133,172.3156408,10633746000,41.14207412,45.21320461,18.76000023,Amazon's price target cut by Morgan Stanley as the bank sees hiring pressure building and wage costs surging,Morgan Stanley still sees upside for Amazon's stock price as it keeps its overweight rating on the retailing giant.,https://markets.businessinsider.com/news/stocks/amazon-stock-price-target-stock-jobs-earnings-hiring-wages-morgan-stanley-2021-9,markets.businessinsider.com,5,morgan stanley still see upside amazon stock price keep overweight rating retailing giant,-0.2023,-0.10115,0.2081376471,-0.309287647,Negative Impact
28/09/2021,167.8855,168.46,164.51,165.80,165.80,88616000,3.3,50.56966791,1.192,0,13.66057312,0.8419472675,0.2413396506,0.08,274.31,14546.67969,16328.78027,7028.100098,6506.5,3602.219971,59667.60156,20174.09961,170.6059708,165.5092776,170.5524827,164.5269895,172.1386757,177.8067982,166.4705531,26.7074382,-0.354586476,0.2379308214,-0.592517297,3.351676941,171.7504298,10545130000,9.950364429,33.42807227,23.25,"Amazon, Walmart, Target are paying for college, but money isn't everything in education","Amazon, Target, Walmart and McDonald's all now offer lower-wage workers 100% tuition payment, but some education experts worry there is too much focus on money.",https://www.cnbc.com/2021/09/28/the-boom-in-low-wage-worker-free-college-is-about-to-get-tested.html,cnbc.com,9,amazon target walmart mcdonalds offer lowerwage worker tuition payment education expert worry much focus money,-0.296,-0.2664,0.3401329167,-0.606532917,Negative Impact
29/09/2021,166.1055,167.57,164.89,165.06,165.06,51246000,3.3,50.56966791,1.192,0,13.66057312,0.8419472675,0.2413396506,0.08,274.31,14512.44043,16344.88965,7108.200195,6560.799805,3536.290039,59413.26953,20158.09961,170.3339008,165.5554526,170.3369344,164.5322532,171.7145004,178.1579327,165.2710681,28.37941011,-0.730771537,0.04419034968,-0.774961887,3.29385594,171.0258873,10493884000,5.046897996,18.71311218,22.55999947,"Amazon settled with employees who said they were fired for their activism, avoiding a trial that could have exposed its labor practices","Amazon settled with Maren Costa and Emily Cunningham, former employees who accused the company of violating labor laws by firing them last April.",https://www.businessinsider.com/amazon-reaches-settlement-with-employees-over-nlrb-complaint-2021-9,businessinsider.com,7,amazon settled maren costa emily cunningham former employee accused company violating labor law firing last april,-0.7506,-0.52542,0.1511158824,-0.676535882,Negative Impact
30/09/2021,165.8,166.39,163.70,164.25,164.25,56848000,3.3,50.56966791,1.192,0,13.66057312,0.8419472675,0.2413396506,0.08,274.31,14448.58008,16144.91992,7086.399902,6520.009766,3568.169922,59126.35938,20070.30078,170.0337408,165.5874701,170.0983094,164.5294646,171.2296005,178.384997,164.074204,28.3078379,-1.081312362,-0.180910193,-0.90040217,3.323570251,170.3737991,10437036000,4.933744831,6.643669085,23.13999939,Linnworks' new funding will enable an effortless economy,"People hate doing things themselves. Today we have cars that are self-driving, microwaves that are self-cleaning, thermostats that are self-adjusting ÃÂÃÂ even ??sentences that are self-completing.",https://www.freightwaves.com/news/linnworks-new-funding-will-enable-an-effortless-economy,freightwaves.com,5,people hate thing today car selfdriving microwave selfcleaning thermostat selfadjusting even sentence selfcompleting,-0.5267,-0.26335,0.269102,-0.532452,Negative Impact
01/10/2021,164.4505,165.46,162.80,164.16,164.16,56712000,3.3,50.56966791,1.192,0,13.66057312,0.8419472675,0.2413396506,0.08,276.589,14566.7002,16323.74023,7027.100098,6517.689941,3568.169922,58765.57813,20150.90039,169.6789706,165.6170051,169.865552,164.5258182,170.77995,178.531089,163.0288109,29.00498323,-1.350730037,-0.414874162,-0.935855876,3.299534389,169.5728824,10380324000,11.31401114,7.098217989,21.10000038,INSERTING and REPLACING Amazon Studios and Howard University Launch Howard Entertainment Program for Third Consecutive Year,"CULVER CITY, Calif.--(BUSINESS WIRE)--Insert after fifth paragraph of release: ÃÂÃÂWe are very grateful to Amazon Studios for their continued partnership in the Howard Entertainment program,ÃÂÃÂ said Howard University Provost and Chief Academic Officer, Anthony K. Wutoh, Ph.D. ÃÂÃÂIt has been a pleasure to watch Howard students engage with this program, build their network, and gain exposure to opportunities in the entertainment business.ÃÂÃÂ The updated release reads: AMAZON STUDIOS AND HOWARD UNIVERSITY LAUNCH HOWARD ENTERTAINMENT PROGRAM FOR THIRD CONSECUTIVE YEAR Intensive program developed to create opportunities in the entertainment industry for emerging executives from Howard University Amazon Studios and Howard University announced today that they will continue the Howard Entertainment program, an initiative designed to diversify the entertainment industry by creating a pipeline for Black and other underrepresented students, now in its third year. The Howard Entertainment program was announced in 2019 to help create opportunities for historically excluded students to train and study alongside entertainment executives. Applications open on October 1, 2021, and the program will begin on January 10, 2022. Howard Entertainment is an immersive, two semester program that offers Howard University students the opportunity to take academic courses related to the business of entertainment during the spring semester and participate in an internship in the entertainment industry during the summer semester. The coursework is applied toward the studentsÃÂÃÂ graduation requirements and the internship provides hands-on experience and an opportunity to make networking connections. Both semesters include immersive experiences to understand the real work of entertainment industry executives. Student disciplines include Film & TV, PR, Business (marketing), Law, Fine Arts, along with the new additions of Theatre Arts Admin, Theatre Tech and Music Business. In 2021, Howard Entertainment Program launched the Howard faculty externship program with the goal to provide hands-on experience that the professors can then take back to their classrooms. Faculty were placed with Amazon Studios teams including casting, development, PR, strategy, and unscripted to further broaden and expand their expertise in their respective disciplines. ÃÂÃÂOver the past two years, we have made great strides with our initiatives to create new diverse pipeline programs in the entertainment industry,ÃÂÃÂ said Jennifer Salke, Head of Amazon Studios. ÃÂÃÂAs we enter our third year, we are more committed than ever to helping new voices join the conversation and continuing to mentor our Howard Entertainment students. We know these programs will benefit our industry as a whole and create future leaders.ÃÂÃÂ Latasha Gillespie, Amazon Studios Global Head of Diversity, Equity and Inclusion said, ÃÂÃÂAs an industry, we have a responsibility to create opportunities and foster new voices across all disciplines. Together with Howard University, we are able to put action behind our words and help the next generation of aspiring industry leaders forge a pathway to the future. ItÃÂÃÂs both rewarding and exciting to empower the next generation of leaders as they begin their careers in entertainment."" ÃÂÃÂWe are very grateful to Amazon Studios for their continued partnership in the Howard Entertainment program,ÃÂÃÂ said Howard University Provost and Chief Academic Officer, Anthony K. Wutoh, Ph.D. ÃÂÃÂIt has been a pleasure to watch Howard students engage with this program, build their network, and gain exposure to opportunities in the entertainment business.ÃÂÃÂ Last year, the program featured guest lecturers including showrunner Anthony Sparks, actress and writer Ashleigh Hairston, actress Michael Hyatt, producer Logan Coles, actress Wendy Raquel Robinson, writer Christina Hamm and writer James Tyler. Additional highlights from cohort 2 included externship placements with Amazon partners such as Viola DavisÃÂÃÂ JuVee, Tracy OliverÃÂÃÂs Tracy Yvonne Productions (TYP), Rachel BrosnahanÃÂÃÂs Scrap Paper Pictures, and Lena WaitheÃÂÃÂs Hillman Grad Productions. Responses from the 2021 cohort were overwhelmingly positive, with students praising the valuable experience they gained across all fields of entertainment. ÃÂÃÂHoward Entertainment has laid the foundation for my career in entertainment and has allowed me to positively envision myself and my ideas within an industry I previously thought had no space for me,ÃÂÃÂ said 2021 Howard Entertainment program fellow Kai Hartman. Past participants of the Howard Entertainment cohorts have gone on to secure jobs at such companies as Gravillis, UTA and Warner Bros. To qualify, students must be enrolled as a Howard University student, as an upperclassman or graduate student. Prospective participants must complete an application and interview to be considered for the program. Students will be taught by Howard faculty who will be supported by Amazon Studios employees and other industry professionals invited by Amazon. Students who wish to apply for admission to Howard Entertainment can contact HowardEntertainment@howard.edu. For more information visit on the program, please visit https://www2.howard.edu/entertainment-fellowship",https://www.businesswire.com/news/home/20211001005455/en/INSERTING-and-REPLACING-Amazon-Studios-and-Howard-University-Launch-Howard-Entertainment-Program-for-Third-Consecutive-Year,businesswire.com,5,culver city califbusiness wireinsert fifth paragraph release grateful amazon studio continued partnership howard entertainment program said howard university provost chief academic officer anthony k wutoh phd pleasure watch howard student engage program build network gain exposure opportunity entertainment business updated release read amazon studio howard university launch howard entertainment program third consecutive year intensive program developed create opportunity entertainment industry emerging executive howard university amazon studio howard university announced today continue howard entertainment program initiative designed diversify entertainment industry creating pipeline black underrepresented student third year howard entertainment program announced help create opportunity historically excluded student train study alongside entertainment executive application open october program begin january howard entertainment immersive two semester program offer howard university student opportunity take academic course related business entertainment spring semester participate internship entertainment industry summer semester coursework applied toward student graduation requirement internship provides handson experience opportunity make networking connection semester include immersive experience understand real work entertainment industry executive student discipline include film tv pr business marketing law fine art along new addition theatre art admin theatre tech music business howard entertainment program launched howard faculty externship program goal provide handson experience professor take back classroom faculty placed amazon studio team including casting development pr strategy unscripted broaden expand expertise respective discipline past two year made great stride initiative create new diverse pipeline program entertainment industry said jennifer salke head amazon studio enter third year committed ever helping new voice join conversation continuing mentor howard entertainment student know program benefit industry whole create future leader latasha gillespie amazon studio global head diversity equity inclusion said industry responsibility create opportunity foster new voice across discipline together howard university able put action behind word help next generation aspiring industry leader forge pathway future rewarding exciting empower next generation leader begin career entertainment grateful amazon studio continued partnership howard entertainment program said howard university provost chief academic officer anthony k wutoh phd pleasure watch howard student engage program build network gain exposure opportunity entertainment business last year program featured guest lecturer including showrunner anthony spark actress writer ashleigh hairston actress michael hyatt producer logan cole actress wendy raquel robinson writer christina hamm writer james tyler additional highlight cohort included externship placement amazon partner viola davis juvee tracy oliver tracy yvonne production typ rachel brosnahans scrap paper picture lena waithes hillman grad production response cohort overwhelmingly positive student praising valuable experience gained across field entertainment howard entertainment laid foundation career entertainment allowed positively envision idea within industry previously thought space said howard entertainment program fellow kai hartman past participant howard entertainment cohort gone secure job company gravillis uta warner bros qualify student must enrolled howard university student upperclassman graduate student prospective participant must complete application interview considered program student taught howard faculty supported amazon studio employee industry professional invited amazon student wish apply admission howard entertainment contact howardentertainmenthowardedu information visit program please visit,0.9995,0.49975,0.123427,0.376323,Positive Impact
04/10/2021,163.9695,164.00,158.81,159.49,159.49,90462000,3.3,50.56966791,1.192,0,13.66057312,0.8419472675,0.2413396506,0.08,276.589,14255.48047,16198.55957,7011,6477.660156,3568.169922,59299.32031,20052.30078,169.2121106,165.6042101,169.4586283,164.4757006,170.0592751,179.152113,160.9664371,24.00295615,-1.919273706,-0.715754071,-1.203519636,3.506355286,168.6242584,10289862000,4.212843876,6.820199949,22.95999908,Amazon's stock drops toward longest losing streak in more than two years,"Shares of Amazon.com Inc. AMZN, -2.86% slid 2.9% toward a sixth straight loss in afternoon trading Monday, as part of a broad stock market selloff in which technology sector was the hardest hit. The e-commerce and cloud behemoth's stock is on track to suffer the longest losing streak since the eight-day stretch ended Aug. 5, 2019, according to Dow Jones Market Data.",https://www.marketwatch.com/story/amazons-stock-drops-toward-losing-losing-streak-in-more-than-two-years-2021-10-04,marketwatch.com,8,share amazoncom inc amzn slid toward sixth straight loss afternoon trading monday part broad stock market selloff technology sector hardest hit ecommerce cloud behemoth stock track suffer longest losing streak since eightday stretch ended aug according dow jones market data,-0.6486,-0.51888,0.1618792857,-0.680759286,Negative Impact
05/10/2021,160.225,163.04,160.12,161.05,161.05,65384000,3.3,50.56966791,1.192,0,13.66057312,0.8419472675,0.2413396506,0.08,276.589,14433.83008,16327.08984,7077.100098,6576.279785,3568.169922,59744.87891,20183.40039,168.7332907,165.6004401,169.1288783,164.441614,169.3385506,178.9004301,159.776671,24.81864147,-2.218317251,-1.016266707,-1.202050544,3.461855207,167.0543771,10355246000,13.93388491,9.820246642,21.29999924,This Growth Stock Impressed Wall Street's Brightest. Is It a Buy?,"Twilio came out on top in this year's Sohn Idea Contest, which reflects its status as an in-demand tech stock. But ignore these warning signs at your own risk.",https://www.fool.com/investing/2021/10/05/twilio-impressed-wall-street-at-ira-sohn-is-it-buy/,fool.com,7,twilio came top year sohn idea contest reflects status indemand tech stock ignore warning sign risk,-0.6369,-0.44583,0.179569,-0.625399,Negative Impact
06/10/2021,160.6765,163.22,159.93,163.10,163.10,50660000,3.3,50.56966791,1.192,0,13.66057312,0.8419472675,0.2413396506,0.08,276.589,14501.91016,16338.45996,6995.899902,6493.120117,3568.169922,59189.73047,20191.69922,168.3689105,165.61553,168.8924711,164.4282695,168.6798256,178.0428103,159.3168409,28.8360243,-2.263758699,-1.265765105,-0.997993594,3.530819484,165.7356768,10405906000,26.70316816,14.94996565,21,Amazon sued by warehouse workers over COVID-19 screening pay,Amazon.com Inc has been accused of violating Colorado state law by failing to pay warehouse workers for time spent undergoing COVID-19 screenings before clocking in at work.,https://www.reuters.com/article/employment-amazon-colorado/amazon-sued-by-warehouse-workers-over-covid-19-screening-pay-idUSKBN2GW217,reuters.com,10,amazoncom inc accused violating colorado state law failing pay warehouse worker time spent undergoing covid screening clocking work,-0.8555,-0.8555,0.04691136364,-0.902411364,Negative Impact
07/10/2021,164.577,166.29,164.15,165.12,165.12,48182000,3.3,50.56966791,1.192,0,13.66057312,0.8419472675,0.2413396506,0.08,276.589,14654.01953,16511.81055,7078,6600.189941,3568.169922,59677.82813,20416.19922,168.0410205,165.6395925,168.7445901,164.4351674,168.2255013,177.3374811,159.1135214,35.42437126,-2.112342875,-1.435080659,-0.677262216,3.596749442,158.8125,10454088000,49.87160204,30.1695517,19.54000092,"Amazon Announces New Robotics Fulfillment Center and Delivery Station in Elkhart County, Creating More Than 1,000 New, Full-Time Jobs","ELKHART, Ind.--(BUSINESS WIRE)--Amazon today announced plans to expand its investment in Indiana by opening two new buildings in Elkhart County to support operations closer to customers. The robotics fulfillment center and delivery station, both set to launch in 2023, are expected to create more than 1,000 new roles in the Hoosier State. ÃÂÃÂAmazon's decision to support Elkhart County is a huge vote of confidence in our workforce development initiatives,ÃÂÃÂ said Suzanne Weirick, President Board of C",https://www.businesswire.com/news/home/20211007005184/en/Amazon-Announces-New-Robotics-Fulfillment-Center-and-Delivery-Station-in-Elkhart-County-Creating-More-Than-1000-New-Full-Time-Jobs/,businesswire.com,5,elkhart indbusiness wireamazon today announced plan expand investment indiana opening two new building elkhart county support operation closer customer robotics fulfillment center delivery station set launch expected create new role hoosier state amazon decision support elkhart county huge vote confidence workforce development initiative said suzanne weirick president board c,0.9337,0.46685,0.30298,0.16387,Positive Impact
08/10/2021,165.85,166.07,164.41,164.43,164.43,39964000,3.3,50.56966791,1.192,0,13.66057312,0.8419472675,0.2413396506,0.08,276.589,14579.54004,16517.23047,7095.600098,6559.990234,3592.169922,60059.05859,20416.30078,167.7297205,165.6601175,168.5754297,164.435126,167.774176,176.6870211,158.8613309,42.64451675,-2.024723058,-1.553009139,-0.471713919,3.152891976,158.9620001,10414124000,44.41327137,40.32934719,18.77000046,Rule of Thumb Is to Buy Amazon on Every Dip,"AMZN stock is rarely not one to buy. Even after this massive 2-year rally, the upside potential still outweighs the downside risk.",https://investorplace.com/2021/10/amzn-stock-rule-of-thumb-buy-amazon-on-dip/,investorplace.com,6,amzn stock rarely one buy even massive year rally upside potential still outweighs downside risk,-0.4767,-0.28602,0.2695014286,-0.555521429,Negative Impact
11/10/2021,163.75,164.63,161.91,162.32,162.32,40684000,3.3,50.56966791,1.192,0,13.66057312,0.8419472675,0.2413396506,0.08,276.589,14486.2002,16430.07031,7146.899902,6570.540039,3591.709961,60135.78125,20416.30078,167.6484305,165.675375,168.3299227,164.4140302,167.2470009,176.1408573,158.3531445,39.9950686,-2.101798793,-1.66276707,-0.439031723,3.178535461,159.1085102,10373440000,27.68667761,40.65718367,20,Microsoft and Amazon reach truce allowing former AWS executive Charlie Bell to start in new role,Microsoft and Amazon have reached an agreement that clears the way for longtime Amazon Web Services executive Charlie Bell to begin his new job leading a newly formed cybersecurity engineering organization inside the Redmond tech company.,https://www.geekwire.com/2021/microsoft-amazon-reach-truce-allowing-former-aws-executive-charlie-bell-start-new-role/,geekwire.com,5,microsoft amazon reached agreement clear way longtime amazon web service executive charlie bell begin new job leading newly formed cybersecurity engineering organization inside redmond tech company,0.8225,0.41125,0.1064033333,0.3048466667,Positive Impact
12/10/2021,162.85,163.38,161.81,162.37,162.37,36392000,3.3,50.56966791,1.192,0,13.66057312,0.8419472675,0.2413396506,0.08,276.589,14465.91992,16441.75,7130.200195,6548.109863,3546.939941,60284.30859,20437.09961,167.5642804,165.694035,168.0960631,164.3936568,166.7403259,175.5281061,157.9525458,35.28668661,-2.134125507,-1.757038757,-0.377086749,3.118893215,159.2520902,10409832000,28.09376368,33.39790422,19.85000038,Amazon launches Prime service in Poland,"Amazon on Tuesday launched its Amazon Prime service offering free delivery and video streaming in Poland, sending shares in rival Polish e-commerce platform Allegro lower.",https://www.reuters.com/article/amazon-poland/amazon-launches-prime-service-in-poland-idUSKBN2H20QL,reuters.com,10,amazon tuesday launched amazon prime service offering free delivery video streaming poland sending share rival polish ecommerce platform allegro lower,0.7351,0.7351,0.20790875,0.52719125,Positive Impact
13/10/2021,163.4855,164.42,163.05,164.21,164.21,48402000,3.3,50.56966791,1.192,0,13.66057312,0.8419472675,0.2413396506,0.08,276.589,14571.63965,16513.16016,7141.799805,6597.379883,3561.76001,60737.05078,20618.5,167.4823206,165.694115,167.9438255,164.3918692,166.2615509,174.4555923,158.0675095,35.42985998,-1.987752975,-1.803181601,-0.184571375,3.090822492,159.3927985,10458234000,42.69796143,32.82613424,18.63999939,"Amazon Stock Faces Cost Headwinds Into Earnings, Analysts Say. Buy the Dip.","Higher costs and a focus on growth could pinch Amazon's profit margins. But for analysts at Baird, any weakness in the shares is a buying opportunity.",https://www.barrons.com/articles/amazon-stock-faces-cost-headwinds-into-earnings-analyst-says-buy-the-dip-51634137068,barrons.com,9,higher cost focus growth could pinch amazon profit margin analyst baird weakness share buying opportunity,0.8126,0.73134,0.220173,0.511167,Positive Impact
14/10/2021,165.1225,165.63,164.54,164.99,164.99,42190000,3.3,50.56966791,1.192,0,13.66057312,0.8419472675,0.2413396506,0.08,276.589,14823.42969,16744.28906,7207.700195,6685.209961,3558.280029,61305.94922,20819.90039,167.4274606,165.6885799,167.8281067,164.3978505,165.7906006,173.0405658,158.5406354,36.28404896,-1.788279398,-1.80020116,0.0119217619,3.063893999,159.5306926,10500424000,51.6504634,40.81406284,16.86000061,"U.S. Senator Warren urges Amazon breakup, India retailers want probe after Reuters story",U.S. Senator Elizabeth Warren called for breaking up Amazon.com Inc and Indian retailers demanded a government probe of the company after a Reuters investigation showed the e-commerce giant had copied products and rigged search results in India.,https://www.reuters.com/business/us-senator-warren-urges-amazon-breakup-india-retailers-want-probe-after-reuters-2021-10-14/,reuters.com,10,u senator elizabeth warren called breaking amazoncom inc indian retailer demanded government probe company reuters investigation showed ecommerce giant copied product rigged search result india,-0.5267,-0.5267,0.1349438095,-0.66164381,Negative Impact
15/10/2021,165.571,170.52,165.20,170.45,170.45,103598000,3.3,50.56966791,1.192,0,13.66057312,0.8419472675,0.2413396506,0.08,276.589,14897.33984,16871.74023,7234,6727.52002,3572.370117,61305.94922,20928.09961,167.4604907,165.7193725,167.9309654,164.4580809,165.6568504,172.41933,158.8943709,50.29407273,-1.176220794,-1.675405087,0.4991842928,3.151929583,159.6658289,10604022000,99.40221131,64.58354538,16.29999924,Amazon Supports Department of JusticeÃÂÃÂs Prosecution of Four Defendants Charged with Fraud,"SEATTLE--(BUSINESS WIRE)--Amazon.com, Inc.: What: The United States AttorneyÃÂÃÂs Office for the Western District of Michigan yesterday charged four individuals in a more than 30 count indictment for their role in defrauding AmazonÃÂÃÂs textbook rental program. The charges include mail fraud, wire fraud, and making false statements. AmazonÃÂÃÂs robust anti-fraud systems discovered this scheme and it supported the multi-year investigation. You can see the related press release here: https://www.justice.gov/Usao-wdmi/pr/2021_1014_Talsma Statement from Amazon: Only through close collaboration with law enforcement is the prosecution of fraud like this possible. We are grateful to the United States AttorneyÃÂÃÂs Office for the Western District of Michigan, the Federal Bureau of Investigation, and the U.S. Postal Inspector of Michigan in their thorough pursuit of this case. Fraud undermines the trust of our customers, and jeopardizes the value and selection that entrepreneurs, authors, and publishers provide to millions of customers through our stores. We will continue to pursue all available measures to protect our customers and hold bad actors accountable. Additional Background Case: 1:21-cr-00180-HYJ, United States District Court for the Western District of Michigan Amazon has an extensive history of protecting its customers from fraud and abuse: https://press.aboutamazon.com/news-releases/news-release-details/amazon-counterfeit-crimes-unit-reaches-settlement-influencers https://press.aboutamazon.com/news-releases/news-release-details/amazon-announces-lawsuit-combat-fraudulent-affiliate-marketing https://press.aboutamazon.com/news-releases/news-release-details/ftc-obtains-permanent-ban-and-2m-judgment-work-home-scammer https://press.aboutamazon.com/news-releases/news-release-details/amazon-supports-investigation-and-prosecution-four-new-york",https://www.businesswire.com/news/home/20211015005629/en/Amazon-Supports-Department-of-Justice%E2%80%99s-Prosecution-of-Four-Defendants-Charged-with-Fraud,businesswire.com,5,seattlebusiness wireamazoncom inc united state attorney office western district michigan yesterday charged four individual count indictment role defrauding amazon textbook rental program charge include mail fraud wire fraud making false statement amazon robust antifraud system discovered scheme supported multiyear investigation see related press release statement amazon close collaboration law enforcement prosecution fraud like possible grateful united state attorney office western district michigan federal bureau investigation u postal inspector michigan thorough pursuit case fraud undermines trust customer jeopardizes value selection entrepreneur author publisher provide million customer store continue pursue available measure protect customer hold bad actor accountable additional background case crhyj united state district court western district michigan amazon extensive history protecting customer fraud abuse,-0.7506,-0.3753,0.1509188235,-0.526218824,Negative Impact
18/10/2021,169.418,172.46,169.26,172.34,172.34,63482000,3.3,50.56966791,1.192,0,13.66057312,0.8419472675,0.2413396506,0.08,276.589,15021.80957,16862,7203.799805,6673.100098,3568.139893,61765.58984,20985.40039,167.562291,165.766825,168.1037513,164.5364782,165.8843758,173.2296439,158.5391076,63.19942735,-0.532833205,-1.446890711,0.9140575054,2.967536926,160.1000356,10667504000,99.10969872,83.38745781,16.30999947,Five U.S. lawmakers accuse Amazon of possibly lying to Congress following Reuters report,"Five members of the U.S. House Judiciary committee wrote to Amazon.com Inc's chief executive Sunday, and accused the company's top executives, including founder Jeff Bezos, of either misleading Congress or possibly lying to it about Amazon's business practices.",https://www.reuters.com/article/amazon-usa-letter/five-u-s-lawmakers-accuse-amazon-of-possibly-lying-to-congress-following-reuters-report-idUSKBN2H812G,reuters.com,10,five member u house judiciary committee wrote amazoncom inc chief executive sunday accused company top executive including founder jeff bezos either misleading congress possibly lying amazon business practice,-0.7003,-0.7003,0.2139347222,-0.914234722,Negative Impact
19/10/2021,171.7145,172.73,171.10,172.21,172.21,47722000,3.3,50.56966791,1.192,0,13.66057312,0.8419472675,0.2413396506,0.08,276.589,15129.08984,16988.16016,7217.5,6669.850098,3593.149902,61716.05078,21087,167.6645709,165.8312051,168.2646828,164.6128068,166.1356758,173.9937988,158.2775528,64.80182063,-0.033013028,-1.164115174,1.131102146,2.893464225,160.8415432,10619782000,96.21467527,98.2421951,15.69999981,Zuckerberg's Choice,"We have entered the phase when the body politic and public opinion are aware that Facebook ( FB , Financial) is disturbing our society. This is very important to us as investors, because the big tech companies make up a disproportionately large part of the S&P 500 Index.",https://www.gurufocus.com/news/1548558/zuckerbergs-choice,gurufocus.com,5,entered phase body politic public opinion aware facebook fb financial disturbing society important u investor big tech company make disproportionately large part sp index,-0.3612,-0.1806,0.2722818182,-0.452881818,Negative Impact
20/10/2021,172.633,173.14,170.02,170.75,170.75,42796000,3.3,50.56966791,1.192,0,13.66057312,0.8419472675,0.2413396506,0.08,276.589,15121.67969,17099.21094,7223.100098,6705.609863,3587,61259.96094,21188.19922,167.7589511,165.8803426,168.3622641,164.6739033,166.223201,174.2528931,158.1935088,63.1026351,0.2429318398,-0.882705772,1.125637611,2.924285889,161.7929795,10576986000,83.32229515,92.88222304,15.48999977,Should You Climb Aboard EV Maker Rivian's IPO?,The all-electric truck and SUV maker's offering comes with a few nagging risks.,https://www.fool.com/investing/2021/10/20/should-you-climb-aboard-ev-maker-rivians-ipo/,fool.com,7,allelectric truck suv maker offering come nagging risk,-0.5859,-0.41013,0.3357242857,-0.745854286,Negative Impact
21/10/2021,170.7125,172.01,170.15,171.75,171.75,37628000,3.3,50.56966791,1.192,0,13.66057312,0.8419472675,0.2413396506,0.08,276.589,15215.7002,17083.15039,7190.299805,6686.169922,3594.780029,60923.5,21212.40039,167.9018512,165.9545,168.4951362,164.7443173,166.270726,174.4247638,158.1166883,64.7522157,0.5359319623,-0.598978225,1.134910187,2.867322649,162.9279821,10614614000,90.28295378,89.93997473,15.01000023,Amazon warehouse workers in Staten Island make union push,"More than 2,000 Amazon warehouse workers in Staten Island announced plans Wednesday to try to form a union ÃÂÃÂ the latest labor-organizing threat at the e-commerce behemoth.",https://nypost.com/2021/10/21/amazon-warehouse-workers-in-staten-island-make-union-push/,nypost.com,5,amazon warehouse worker staten island announced plan wednesday try form union latest labororganizing threat ecommerce behemoth,-0.4019,-0.20095,0.1839947059,-0.384944706,Negative Impact
22/10/2021,171.05,171.49,166.57,166.78,166.78,62782000,3.3,50.56966791,1.192,0,13.66057312,0.8419472675,0.2413396506,0.08,276.589,15090.2002,17122.24023,7204.600098,6733.689941,3582.600098,60821.62109,21216.19922,167.9339011,165.9978475,168.4277778,164.7645479,166.0458008,173.8595779,158.2320237,64.00798145,0.3626758488,-0.40664741,0.7693232588,2.855537415,163.9494844,10551832000,51.82026697,75.14183863,15.43000031,Labour union urges European authorities to widen Amazon antitrust probe after Reuters story,A global trade union for the services sector on Friday urged European authorities to widen their antitrust investigation of Amazon.com Inc to assess if the company engaged in creating knockoff goods and rigging search results on its platform.,https://www.reuters.com/article/amazon-europe-antitrust/labour-union-urges-european-authorities-to-widen-amazon-antitrust-probe-after-reuters-story-idUSKBN2HC10W,reuters.com,10,global trade union service sector friday urged european authority widen antitrust investigation amazoncom inc assess company engaged creating knockoff good rigging search result platform,0.7964,0.7964,0.08376375,0.71263625,Positive Impact
25/10/2021,166.75,167.39,164.89,166.02,166.02,44520000,3.3,50.56966791,1.192,0,13.66057312,0.8419472675,0.2413396506,0.08,276.589,15226.70996,17169.07031,7222.799805,6712.870117,3609.860107,60967.05078,21284.80078,167.9603009,166.032265,168.3332961,164.777025,165.8322258,173.3867584,158.2776932,59.85283162,0.1622535987,-0.292867208,0.455120807,2.781073434,164.8688365,10507312000,46.07547161,62.72623079,15.23999977,France moves to shield its book industry from Amazon,"Sophie Fornairon's independent bookshop has survived the rise of Amazon thanks to a French law that prohibits price discounting on new books, but she says the e-commerce giant's ability to undercut on shipping still skews the market against stores like hers.",https://www.reuters.com/article/france-amazon-books/france-moves-to-shield-its-book-industry-from-amazon-idUSKBN2HF10Q,reuters.com,10,sophie fornairons independent bookshop survived rise amazon thanks french law prohibits price discounting new book say ecommerce giant ability undercut shipping still skews market store like,0.8934,0.8934,0.3695129412,0.5238870588,Positive Impact
26/10/2021,167.4755,170.81,167.20,168.80,168.80,53966000,3.3,50.56966791,1.192,0,13.66057312,0.8419472675,0.2413396506,0.08,276.589,15235.70996,17145.15039,7277.600098,6766.509766,3597.639893,61350.26172,21173.5,168.037381,166.09773,168.3517353,164.8170894,165.9825005,173.6528495,158.3121514,60.98927981,0.2255441097,-0.189184945,0.4147290544,2.888324193,164.8849945,10561278000,61.69561106,53.19711655,15.97999954,The Hottest Stock No One Is Talking About,Don't let this company's small size distract you from the fact that its business is firing on all cylinders.,https://www.fool.com/investing/2021/10/26/the-hottest-stock-no-one-is-talking-about/,fool.com,7,dont let company small size distract fact business firing cylinder,-0.5574,-0.39018,0.2447358824,-0.634915882,Negative Impact
27/10/2021,169.4,171.85,168.57,169.62,169.62,54044000,3.3,50.56966791,1.192,0,13.66057312,0.8419472675,0.2413396506,0.08,276.589,15235.83984,16920.38086,7253.299805,6753.52002,3562.310059,61143.32813,20955,168.1879108,166.165645,168.4016475,164.8649243,166.2109253,174.0356484,158.3862022,59.09768011,0.3380531985,-0.083737316,0.4217905145,2.89478847,164.8849945,10615322000,68.94248564,58.90452277,16.97999954,Amazon seen triumphing over Apple privacy changes in digital ad business,"Amazon.com is expected to emerge as a winner in the digital advertising arena, surviving Apple's privacy changes better than rivals Facebook and Snap.",https://www.reuters.com/article/amazon-com-results-advertising/amazon-seen-triumphing-over-apple-privacy-changes-in-digital-ad-business-idUSKBN2HH1NO,reuters.com,10,amazoncom expected emerge winner digital advertising arena surviving apple privacy change better rival facebook snap,0.836,0.836,0.2606470588,0.5753529412,Positive Impact
28/10/2021,170.105,173.95,169.30,172.33,172.33,114174000,3.3,50.56966791,1.192,0,13.66057312,0.8419472675,0.2413396506,0.08,276.589,15448.12012,17077,7249.5,6804.220215,3518.419922,59984.69922,21197.5,168.4332608,166.235815,168.555642,164.9391888,166.6147507,174.8373228,158.3921785,64.75534013,0.638053389,0.06062082495,0.5774325641,3.108252389,165.7107956,10729496000,86.63900571,72.4257008,16.53000069,Amazon scammers deliver free unordered products to around one million UK homes,"Over one million UK homes are said to have experienced a new ÃÂÃÂscam' that has resulted in them receiving free products from third-party sellers trying to game the Amazon algorithms. The so-called ""brushing"" scam, according to consumer watchdog Which?",https://www.proactiveinvestors.co.uk//companies/news/964593/amazon-scammers-deliver-free-unordered-products-to-around-one-million-uk-homes-964593.html?SNAPI,proactiveinvestors.co.uk,5,one million uk home said experienced new scam resulted receiving free product thirdparty seller trying game amazon algorithm socalled brushing scam according consumer watchdog,-0.5267,-0.26335,0.23138,-0.49473,Negative Impact
29/10/2021,165.001,168.74,163.67,168.62,168.62,129722000,3.3,50.56966791,1.192,0,13.66057312,0.8419472675,0.2413396506,0.08,276.589,15498.38965,17016.41016,7237.600098,6830.339844,3547.340088,59306.92969,21037.09961,168.617941,166.2970551,168.5582249,164.9758287,166.8376762,175.0220366,158.6533159,61.12159069,0.5701098516,0.1625186303,0.4075912213,3.532395499,173.9499969,10599774000,56.09351916,70.55833684,16.26000023,"Amazon isn't 'immune' from macroeconomic pressures, investor says. Three takes on the earnings miss","Amazon's disappointing third-quarter earnings and revenue results mean it isn't ""immune"" from supply chain pressures and other risks, one investor says.",https://www.cnbc.com/2021/10/29/unpacking-amazons-earnings-miss-with-three-market-analysts.html,cnbc.com,9,amazon disappointing thirdquarter earnings revenue result mean isnt immune supply chain pressure risk one investor say,-0.7709,-0.69381,0.01831548387,-0.712125484,Negative Impact
01/11/2021,168.09,168.79,164.60,165.91,165.91,72178000,3.3,50.56966791,1.192,0,13.66057312,0.8419472675,0.2413396506,0.08,277.948,15595.91992,17131.08008,7288.600098,6893.290039,3544.47998,60138.46094,21247,168.7361011,166.3505201,168.4541965,164.9850792,167.1585014,174.5992164,159.7177864,55.70493307,0.2937195156,0.1887588073,0.1049607083,3.720217024,173.9499969,10527596000,26.16676493,56.29976327,16.40999985,Amazon Fire TV in U.S. and Canada get TikTok,Amazon.com Inc said on Monday short-video sharing app TikTok is now available on its Amazon Fire TV devices in the United States and Canada.,https://www.reuters.com/article/tiktok-amazon-com-fire-tv/amazon-fire-tv-in-u-s-and-canada-get-tiktok-idUSKBN2HM2W5,reuters.com,10,amazoncom inc said monday shortvideo sharing app tiktok available amazon fire tv device united state canada,0.5994,0.5994,0.2848109091,0.3145890909,Positive Impact
02/11/2021,165.7505,166.56,164.18,165.64,165.64,52552000,3.3,50.56966791,1.192,0,13.66057312,0.8419472675,0.2413396506,0.08,277.948,15649.59961,17115.16992,7274.799805,6927.029785,3505.629883,60029.05859,21170,168.782981,166.3985176,168.3437377,164.9915709,167.3878761,174.2997665,160.4759858,52.41781903,0.05244780384,0.1614966066,-0.109048803,3.743501936,173.744317,10475044000,19.17052934,33.81027115,16.03000069,Amazon-backed EV startup aims for valuation above $50 bn,"Rivian Automotive, an Amazon-backed electric vehicle startup, said Monday it is targeting a valuation of more than $50 billion.",https://techxplore.com/news/2021-11-amazon-backed-ev-startup-aims-valuation.html,techxplore.com,5,rivian automotive amazonbacked electric vehicle startup said monday targeting valuation billion,0,0,0.3025766667,-0.302576667,Negative Impact
03/11/2021,165.45,169.75,164.88,169.20,169.20,67944000,3.3,50.56966791,1.192,0,13.66057312,0.8419472675,0.2413396506,0.08,277.948,15811.58008,17209.75,7248.899902,6950.649902,3498.540039,59771.92188,21265.09961,168.8612009,166.4286726,168.3773165,165.0334458,167.6928513,174.3414685,161.044234,56.52834435,0.1470075988,0.1585988051,-0.011591206,3.990215846,173.5427507,10542988000,53.81173105,33.04967511,15.10000038,Looking at Margins in the Face of Inflationary & Logistical Issues,Rising cost pressures amid supply-chain disruptions and labor/material shortages are keeping trends in margins in the spotlight.,https://www.zacks.com/commentary/1823051/looking-at-margins-in-the-face-of-inflationary-logistical-issues,zacks.com,8,rising cost pressure amid supplychain disruption labormaterial shortage keeping trend margin spotlight,-0.6908,-0.55264,0.2715672727,-0.824207273,Negative Impact
04/11/2021,168.5,174.93,168.25,173.85,173.85,107060000,3.3,50.56966791,1.192,0,13.66057312,0.8419472675,0.2413396506,0.08,277.948,15940.30957,17168.86914,7279.899902,6987.790039,3526.870117,60067.62109,21342.09961,169.039021,166.4711751,168.5919318,165.1211728,168.1292763,175.1997327,161.0588199,55.41017688,0.5903585093,0.2449507459,0.3454077634,4.072608948,163.6660004,10650048000,90.3999209,54.4607271,15.43999958,Amazon takes another swipe at union as Alabama rematch looms,"Earlier this year, Amazon.com Inc handily defeated a historic union drive at a warehouse in Bessemer, Alabama. But with the prospect of another vote looming, the online retailer is leaving nothing to chance.",https://www.reuters.com/business/retail-consumer/amazon-takes-another-swipe-union-alabama-rematch-looms-2021-11-04/,reuters.com,10,earlier year amazoncom inc handily defeated historic union drive warehouse bessemer alabama prospect another vote looming online retailer leaving nothing chance,-0.4836,-0.4836,-0.10013,-0.38347,Negative Impact
05/11/2021,173.85,178.31,173.85,175.95,175.95,99940000,3.3,50.56966791,1.192,0,13.66057312,0.8419472675,0.2413396506,0.08,277.948,15971.58984,17242.35938,7304,7040.790039,3491.570068,60067.62109,21455.80078,169.2420108,166.5278651,168.8804636,165.2289173,168.705201,176.3596279,161.0507741,55.71116759,1.098465948,0.4156537863,0.6828121614,4.162609645,163.8913104,10749988000,83.86640733,76.02601976,16.47999954,Big Tech Hits And Misses: Which FAANG Stocks May Be Losing Their Bite?,Big Tech Hits And Misses: Which FAANG Stocks May Be Losing Their Bite?,https://seekingalpha.com/article/4466293-big-tech-hits-and-misses-which-faang-stocks-may-be-losing-their-bite,seekingalpha.com,6,big tech hit miss faang stock may losing bite,-0.4939,-0.29634,0.02588142857,-0.322221429,Negative Impact
08/11/2021,176.162,178.95,174.39,174.45,174.45,61480000,3.3,50.56966791,1.192,0,13.66057312,0.8419472675,0.2413396506,0.08,277.948,15982.36035,17310.50977,7300.399902,7047.47998,3498.629883,60545.60938,21556.5,169.3813608,166.5766101,169.0988378,165.3206594,169.3119011,176.7542923,161.8695098,53.3964694,1.36434062,0.605391153,0.7589494668,4.371359689,164.468158,10688508000,70.55094983,81.60575935,17.21999931,GLQ: Heavy USA Exposure And High Leverage Pose Risks,GLQ: Heavy USA Exposure And High Leverage Pose Risks,https://seekingalpha.com/article/4466909-glq-heavy-usa-exposure-and-high-leverage-pose-risks,seekingalpha.com,6,glq heavy usa exposure high leverage pose risk,-0.2732,-0.16392,0.1961783333,-0.360098333,Negative Impact
09/11/2021,175.7625,179.69,175.07,178.81,178.81,85898000,3.3,50.56966791,1.192,0,13.66057312,0.8419472675,0.2413396506,0.08,277.948,15886.54004,17286.91016,7274,7043.27002,3507,60433.44922,21594.5,169.5360205,166.6391351,169.4797262,165.4548966,170.1341507,177.969031,162.2992703,61.22179947,1.90510367,0.8653336563,1.039770013,4.52243042,165.3370683,10774406000,94.5263611,82.98123942,17.78000069,Amazon and Weber File Joint Lawsuit Against Counterfeiters,"SEATTLE--(BUSINESS WIRE)--Today, Amazon.com, Inc. (ÃÂÃÂAmazonÃÂÃÂ) (NASDAQ: AMZN), together with a subsidiary of Weber Inc. (NYSE:WEBR) (ÃÂÃÂWeberÃÂÃÂ), jointly filed a lawsuit against 12 defendants for selling products that illegally bear the WEBERÃÂÃÂ® registered trademark in Amazon's store. The defendants attempted to offer counterfeit versions of the global grill maker's grill covers, violating Amazon's policies, infringing on Weber's registered trademarks, and breaking the law. The lawsuit was filed in th",https://www.businesswire.com/news/home/20211109006012/en/Amazon-and-Weber-File-Joint-Lawsuit-Against-Counterfeiters/,businesswire.com,5,seattlebusiness wiretoday amazoncom inc amazon nasdaq amzn together subsidiary weber inc nysewebr weber jointly filed lawsuit defendant selling product illegally bear weber registered trademark amazon store defendant attempted offer counterfeit version global grill maker grill cover violating amazon policy infringing weber registered trademark breaking law lawsuit filed th,-0.4939,-0.24695,0.2571725,-0.5041225,Negative Impact
10/11/2021,178.1935,180.27,173.15,174.10,174.10,80548000,3.3,50.56966791,1.192,0,13.66057312,0.8419472675,0.2413396506,0.08,277.948,15622.70996,17192.0293,7340.200195,7045.160156,3492.459961,60352.82031,21461.90039,169.5472803,166.7015025,169.6610112,165.5409423,170.6285751,178.1314295,163.1257207,52.96840938,1.931421146,1.078551154,0.8528699921,4.897715977,166.4851834,10693858000,62.84580695,75.97437263,18.72999954,AWS kondigt plannen aan om tweede regio in Canada te openen,"SEATTLE--(BUSINESS WIRE)--Vandaag heeft Amazon Web Services, Inc. (AWS), een bedrijf van Amazon.com, Inc. (NASDAQ: AMZN), plannen aangekondigd om eind 2023/begin een infrastructuurregio te openen in Alberta, Canada. 2024. De nieuwe AWS Canada West (Calgary) Regio zal bij de lancering uit drie Availability Zones (AZÃÂÃÂs) bestaan ??en zal aansluiten bij de bestaande AWS Canada (Central) Regio in Montreal, die ook uit drie Availability Zones bestaat. Wereldwijd heeft AWS 81 Availability Zones in 25 geografische regioÃÂÃÂs, met plannen om 27 extra Availability Zones en negen extra AWS-regioÃÂÃÂs te lanceren in AustraliÃÂÃÂ«, Canada, India, IndonesiÃÂÃÂ«, IsraÃÂÃÂ«l, Nieuw-Zeeland, Spanje, Zwitserland en de Verenigde Arabische Emiraten. De komende AWS Canada West (Calgary) regio stelt nog meer ontwikkelaars, startups en ondernemingen, evenals overheids-, onderwijs- en non-profitorganisaties in staat om hun applicaties uit te voeren en eindgebruikers te bedienen vanuit datacenters in Canada. AWS heeft ook een economische impactstudie (EIS) gepubliceerd waarin wordt geschat dat de uitgaven van het bedrijf voor de bouw en de exploitatie van de nieuwe regio AWS Canada West (Calgary) en de bestaande regio AWS Canada (centraal) in Montreal samen meer dan 5.000 nieuwe banen zullen creÃÂÃÂ«ren met een geschatte investering van meer dan $ 17 miljard (CA $ 21 miljard) in de lokale economieÃÂÃÂ«n tegen 2037. Beide infrastructuurregioÃÂÃÂs zullen in dezelfde periode naar schatting $ 31,6 miljard (CA $ 39 miljard) toevoegen aan het BBP van Canada. Ga voor meer informatie over de wereldwijde infrastructuur van AWS naar aws.amazon.com/about-aws/global-infrastructure/. Deze bekendmaking is officieel geldend in de originele brontaal. Vertalingen zijn slechts als leeshulp bedoeld en moeten worden vergeleken met de tekst in de brontaal, die als enige rechtsgeldig is.",https://www.businesswire.com/news/home/20211110006405/nl/,businesswire.com,5,seattlebusiness wirevandaag heeft amazon web service inc aws een bedrijf van amazoncom inc nasdaq amzn plannen aangekondigd om eind begin een infrastructuurregio te openen alberta canada de nieuwe aws canada west calgary regio zal bij de lancering uit drie availability zone az bestaan en zal aansluiten bij de bestaande aws canada central regio montreal die ook uit drie availability zone bestaat wereldwijd heeft aws availability zone geografische regios met plannen om extra availability zone en negen extra awsregios te lanceren australi canada india indonesi isral nieuwzeeland spanje zwitserland en de verenigde arabische emiraten de komende aws canada west calgary regio stelt nog meer ontwikkelaars startup en ondernemingen evenals overheids onderwijs en nonprofitorganisaties staat om hun applicaties uit te voeren en eindgebruikers te bedienen vanuit datacenters canada aws heeft ook een economische impactstudie eis gepubliceerd waarin wordt geschat dat de uitgaven van het bedrijf voor de bouw en de exploitatie van de nieuwe regio aws canada west calgary en de bestaande regio aws canada centraal montreal saman meer dan nieuwe banen zullen creren met een geschatte investering van meer dan miljard ca miljard de lokale economien tegen beide infrastructuurregios zullen dezelfde periode naar schatting miljard ca miljard toevoegen aan het bbp van canada ga voor meer informatie de wereldwijde infrastructuur van aws naar awsamazoncomaboutawsglobalinfrastructure deze bekendmaking officieel geldend de originele brontaal vertalingen zijn slechts al leeshulp bedoeld en moeten worden vergeleken met de tekst de brontaal die al enige rechtsgeldig,-0.7964,-0.3982,0.2602748,-0.6584748,Negative Impact
11/11/2021,175.65,177.16,173.37,173.63,173.63,45288000,3.3,50.56966791,1.192,0,13.66057312,0.8419472675,0.2413396506,0.08,277.948,15704.28027,17220.41016,7384.200195,7059.549805,3532.790039,59919.69141,21582,169.5407803,166.7602225,169.8164618,165.6213807,171.0601753,178.181443,163.9389077,59.74831018,1.891939122,1.241228748,0.6507103743,4.797930036,167.8639158,10648570000,59.97046835,72.44754547,17.65999985,AWS gibt PlÃÂÃÂ¤ne fÃÂÃÂ¼r die Einrichtung einer zweiten Region in Kanada bekannt,"SEATTLE--(BUSINESS WIRE)--Heute hat Amazon Web Services, Inc. (AWS), ein Amazon.com, Inc. Unternehmen (NASDAQ: AMZN), PlÃÂÃÂ¤ne zur ErÃÂÃÂ¶ffnung einer Infrastrukturregion in Alberta, Kanada, Ende des Jahres 2023/Anfang 2024 bekannt gegeben. Die neue Region AWS Canada West (Calgary) wird zu Beginn aus drei VerfÃÂÃÂ¼gbarkeitszonen (Availability Zones, AZs) bestehen und die bestehende Region AWS Canada (Central) in Montreal ergÃÂÃÂ¤nzen, die ebenfalls aus drei VerfÃÂÃÂ¼gbarkeitszonen besteht. Weltweit verfÃÂÃÂ¼gt AWS ÃÂÃÂ¼ber 81 VerfÃÂÃÂ¼gbarkeitszonen in 25 geografischen Regionen und plant die EinfÃÂÃÂ¼hrung von 27 weiteren VerfÃÂÃÂ¼gbarkeitszonen und neun weiteren AWS-Regionen in Australien, Kanada, Indien, Indonesien, Israel, Neuseeland, Spanien, der Schweiz und den Vereinigten Arabischen Emiraten. Die kÃÂÃÂ¼nftige AWS Canada West (Calgary) Region wird es noch mehr Entwicklern, Startups und Unternehmen sowie BehÃÂÃÂ¶rden, Bildungseinrichtungen und gemeinnÃÂÃÂ¼tzigen Organisationen ermÃÂÃÂ¶glichen, ihre Anwendungen von Rechenzentren in Kanada aus auszufÃÂÃÂ¼hren und Endbenutzer zu versorgen. AWS hat zudem eine Studie ÃÂÃÂ¼ber die wirtschaftlichen Auswirkungen (Economic Impact Study, EIS) verÃÂÃÂ¶ffentlicht, in der davon ausgegangen wird, dass durch die Ausgaben des Unternehmens fÃÂÃÂ¼r den Bau und den Betrieb der neuen AWS Canada West (Calgary) Region und der bestehenden AWS Canada (Central) Region in Montreal bis zum Jahr 2037 insgesamt mehr als 5.000 neue ArbeitsplÃÂÃÂ¤tze mit einer voraussichtlichen Investitionssumme von ÃÂÃÂ¼ber 17 Mrd. USD (21 Mrd. CA$) in den lokalen Volkswirtschaften geschaffen werden. Beide Infrastrukturregionen werden im gleichen Zeitraum schÃÂÃÂ¤tzungsweise 31,6 Milliarden USD (39 Milliarden CA$) zum BIP Kanadas beitragen. Weitere Informationen ÃÂÃÂ¼ber die globale Infrastruktur von AWS finden Sie unter aws.amazon.com/about-aws/global-infrastructure/. ÃÂÃÂUnsere Infrastruktur in Kanada hat unseren Kunden die MÃÂÃÂ¶glichkeit gegeben, die Art und Weise zu verÃÂÃÂ¤ndern, wie Unternehmen, Bildungseinrichtungen und RegierungsbehÃÂÃÂ¶rden ihre Stakeholder bedienen. Mit einer zusÃÂÃÂ¤tzlichen AWS-Region in Kanada werden Kunden noch geringere Latenzzeiten fÃÂÃÂ¼r kÃÂÃÂ¼nftige LÃÂÃÂ¶sungen wie 5G-fÃÂÃÂ¤hige Anwendungen und maschinelles Lernen an der Edge erleben, und es wird ihre MÃÂÃÂ¶glichkeiten stÃÂÃÂ¤rken, ihre regionale Infrastruktur fÃÂÃÂ¼r noch grÃÂÃÂ¶ÃÂÃÂere Fehlertoleranz, Ausfallsicherheit und VerfÃÂÃÂ¼gbarkeit zu gestaltenÃÂÃÂ, sagte Prasad Kalyanaraman, Vice President von Infrastructure Services bei AWS. ÃÂÃÂWir freuen uns darauf, eine erstklassige Infrastruktur zu schaffen, um Unternehmen dabei zu unterstÃÂÃÂ¼tzen, die Art und Weise, wie sie KundenlÃÂÃÂ¶sungen bereitstellen und das Wirtschaftswachstum fÃÂÃÂ¶rdern, neu zu erfinden.ÃÂÃÂ ÃÂÃÂDiese GroÃÂÃÂinvestition von AWS zeigt erneut, dass Alberta sich als fÃÂÃÂ¼hrender Akteur im Bereich der digitalen Technologie und Innovation etablieren wird. Dieses milliardenschwere Rechenzentrumsprojekt in unserer Provinz verdeutlicht die Arbeit, die Invest Alberta fÃÂÃÂ¼r die Schaffung von ArbeitsplÃÂÃÂ¤tzen und die Diversifizierung der Wirtschaft leistetÃÂÃÂ, sagte Albertas Premierminister Jason Kenney. ÃÂÃÂIch freue mich auf die gemeinsame Arbeit mit AWS an diesem Projekt und darauf, zu sehen, wie es den IT- und Kommunikationssektor in Alberta stÃÂÃÂ¤rken wird.ÃÂÃÂ AWS-Regionen setzen sich aus VerfÃÂÃÂ¼gbarkeitszonen zusammen, die die Infrastruktur an getrennten und eigenstÃÂÃÂ¤ndigen geografischen Standorten unterbringen. Die VerfÃÂÃÂ¼gbarkeitszonen sind weit genug voneinander entfernt, um die GeschÃÂÃÂ¤ftskontinuitÃÂÃÂ¤t der Kunden zu gewÃÂÃÂ¤hrleisten, aber nahe genug, um niedrige Latenzzeiten fÃÂÃÂ¼r Anwendungen mit hoher VerfÃÂÃÂ¼gbarkeit zu bieten, die mehrere VerfÃÂÃÂ¼gbarkeitszonen nutzen. Jede VerfÃÂÃÂ¼gbarkeitszone verfÃÂÃÂ¼gt ÃÂÃÂ¼ber eine unabhÃÂÃÂ¤ngige Stromversorgung, KÃÂÃÂ¼hlung und physische Sicherheit. Die Zonen sind ÃÂÃÂ¼ber redundante Netzwerke mit ultra-geringer Latenz miteinander verbunden. AWS-Kunden, fÃÂÃÂ¼r die hohe VerfÃÂÃÂ¼gbarkeit oberste PrioritÃÂÃÂ¤t hat, kÃÂÃÂ¶nnen ihre Anwendungen entwickeln, um sie in verschiedenen VerfÃÂÃÂ¼gbarkeitszonen zu betreiben und so eine noch grÃÂÃÂ¶ÃÂÃÂere Ausfallsicherheit zu erreichen. Die AWS Canada West (Calgary) Region versetzt Kunden mit PrÃÂÃÂ¤ferenzen fÃÂÃÂ¼r den Datenstandort in die Lage, Daten sicher in Kanada zu speichern, wÃÂÃÂ¤hrend sie eine noch geringere Latenz im ganzen Land und mehr FlexibilitÃÂÃÂ¤t fÃÂÃÂ¼r die AusfÃÂÃÂ¼hrung von ÃÂÃÂ¼ber mehrere Regionen verteilten Anwendungen bietet. Insgesamt wird AWS bis zum Jahr 2037 schÃÂÃÂ¤tzungsweise mehr als 17 Milliarden USD (21 Milliarden CA$) in Kanada in den Aufbau und Betrieb seiner beiden Infrastrukturregionen investieren. Es wird erwartet, dass diese AWS-Infrastrukturinvestitionen das kanadische Bruttoinlandsprodukt im entsprechenden Zeitraum um mehr als 31 Milliarden USD (39 Milliarden CA$) erhÃÂÃÂ¶hen werden. AWS plant, in der neu angekÃÂÃÂ¼ndigten AWS Canada West (Calgary) Region bis 2037 mehr als 3 Mrd. USD (4 Mrd. CA$) zu investieren. Dazu gehÃÂÃÂ¶ren Investitionsausgaben fÃÂÃÂ¼r den Bau von Rechenzentren, Betriebskosten wie laufende Versorgungs- und Anlagenkosten sowie der Kauf von Waren und Dienstleistungen von regionalen Unternehmen. Die EIS geht auÃÂÃÂerdem davon aus, dass die neue AWS-Region direkte und indirekte wirtschaftliche Vorteile wie neue ArbeitsplÃÂÃÂ¤tze und AbsatzmÃÂÃÂ¶glichkeiten fÃÂÃÂ¼r die Lieferkette im Bereich der Rechenzentren und die damit verbundenen Sektoren in Kanada bringen wird. Insgesamt werden durch die Investitionen in die neue AWS Canada West (Calgary) Region schÃÂÃÂ¤tzungsweise mehr als 950 neue ArbeitsplÃÂÃÂ¤tze auf Vollzeitbasis (full-time equivalent, FTE) in Kanada geschaffen. Kunden und AWS-Partner heiÃÂÃÂen die AWS Canada West (Calgary) Region willkommen Die Kunden in Kanada werden sich zu den Millionen aktiver Kunden gesellen, die AWS jeden Monat in ÃÂÃÂ¼ber 190 LÃÂÃÂ¤ndern der Welt nutzen. Kanadische Organisationen wie Air Canada, Athabasca University, Benevity, BMO Financial Group, Canada Border Services Agency, D2L, Hootsuite, Humber College, Keyera, Neo Financial, NHL, Nutrien, lululemon athletica, Provincial Health Services Authority, Porter Airlines, Sun Life, Trimac Transportation und Vancouver General Hospital vertrauen bei der AusfÃÂÃÂ¼hrung ihrer Workloads auf AWS, um Kosteneinsparungen zu erzielen, Innovationen voranzutreiben und die MarkteinfÃÂÃÂ¼hrung zu beschleunigen. Sun Life ist ein fÃÂÃÂ¼hrendes internationales Unternehmen fÃÂÃÂ¼r Finanzdienstleistungen, das Privat- und Firmenkunden LÃÂÃÂ¶sungen fÃÂÃÂ¼r die Bereiche Leben, Gesundheit und VermÃÂÃÂ¶gen anbietet. ÃÂÃÂDurch unsere digitale Transformation sind wir stÃÂÃÂ¤ndig auf der Suche nach Innovationen, um unsere Kunden bei der Erreichung lebenslanger finanzieller Sicherheit und einem gesÃÂÃÂ¼nderen Leben zu unterstÃÂÃÂ¼tzenÃÂÃÂ, sagte Laura Money, Executive Vice President und Chief Information Officer bei Sun Life. ÃÂÃÂMit der heutigen AnkÃÂÃÂ¼ndigung einer zweiten AWS-Region in Kanada bieten wir unseren Kunden, die ihre Daten in Kanada speichern mÃÂÃÂ¼ssen, eine weitere Dimension der Ausfallsicherheit.ÃÂÃÂ Die Provincial Health Services Authority (PHSA) ist das RÃÂÃÂ¼ckgrat des Gesundheitssystems von British Columbia und stellt sicher, dass 5 Millionen Einwohner Zugang zu einem Netzwerk aus spezialisierten Gesundheitsdienstleistungen und -programmen haben. Als die COVID-19-Pandemie ausgebrochen ist, hat die PHSA COVID-19-Testergebnisse bereitgestellt und Impfungen gebucht. ÃÂÃÂMithilfe von Amazon Pinpoint hat PHSA Millionen von SMS und E-Mails mit AnmeldebestÃÂÃÂ¤tigungen, Buchungsbenachrichtigungen und Erinnerungen an Impftermine an die Einwohner von British Columbia verschicktÃÂÃÂ, so Shannon Malovec, Chief Digital Innovation Officer bei PHSA. ÃÂÃÂAWS hat uns in die Lage versetzt, unsere Kommunikation in kÃÂÃÂ¼rzester Zeit zu erweitern. Wir erkennen den Wert des Einsatzes der neuesten Technologie im Dienste unserer BÃÂÃÂ¼rger, und diese neue AWS-Region in Westkanada wird uns und vielen anderen Organisationen bei der ErschlieÃÂÃÂung neuer Innovationen helfen.ÃÂÃÂ Kidoodle.TV ist ein in Calgary ansÃÂÃÂ¤ssiger Streaming-Dienst fÃÂÃÂ¼r Kinder mit mehr als 100 Millionen Downloads in 235 LÃÂÃÂ¤ndern und Regionen weltweit. ÃÂÃÂIch nutze AWS schon seit so langer Zeit in der Medien- und Unterhaltungsbranche, dass ich mir eine Welt ohne AWS nicht mehr vorstellen kann. AWS ist fÃÂÃÂ¼r uns unerlÃÂÃÂ¤sslich, um neue Funktionen und Produkte so schnell wie mÃÂÃÂ¶glich zu verÃÂÃÂ¶ffentlichenÃÂÃÂ, sagt Daniel Riddell, Chief Technology Officer bei Kidoodle.TV. ÃÂÃÂDa die AWS-Cloud bereits existierte, als wir das Unternehmen grÃÂÃÂ¼ndeten, konnten wir alles vor Ort entwickeln. Wir waren nicht auf riesige Overhead-Kosten angewiesen. Wir konnten im Wesentlichen die gleiche Service-Architektur einrichten, die auch Multimilliarden-Dollar-Unternehmen einsetzen kÃÂÃÂ¶nnen. Als COVID einschlug, stiegen unsere Zahlen sprunghaft an. Mit AWS Elemental MediaTailor und anderen AWS-Services konnten wir unsere monatlich aktiven Nutzer innerhalb eines Jahres um 3.200 % vergrÃÂÃÂ¶ÃÂÃÂern und unseren Prozess der Anzeigenschaltung rasch anpassen.ÃÂÃÂ Die Athabasca University (AU), die kanadische Online-UniversitÃÂÃÂ¤t, ist eine der weltweit am schnellsten wachsenden Online- und freien Bildungseinrichtungen mit mehr als 43.000 Studenten in 87 LÃÂÃÂ¤ndern. Die AU war die erste kanadische Hochschulinstitution, die im vergangenen Jahr ihre gesamte digitale Betriebsinfrastruktur auf AWS umgestellt hat. ÃÂÃÂIch pflege zu sagen, dass es ohne ein solides Fundament keine skalierbare Innovation gibt. Die Umstellung der AU auf AWS im Jahr 2020 war die Grundlage unserer digitalen Transformationsstrategie. Dadurch wurden die Infrastruktur und die Kosteneinsparungen geschaffen, die es uns ermÃÂÃÂ¶glichen werden, personalisiertes Lernen fÃÂÃÂ¼r unsere Studenten zu einer unendlich skalierbaren RealitÃÂÃÂ¤t zu machenÃÂÃÂ, sagte Jennifer Schaeffer, AU Vice President von Information Technology und Chief Information Officer. ÃÂÃÂWir stellen nicht nur unsere digitale Basis um, sondern rÃÂÃÂ¼cken die Cloud auch in den Vordergrund unseres Lehrplans. Mit den Programmen AU PowerEDTM und AWS Academy Cloud Foundations tragen wir zur Ausbildung der nÃÂÃÂ¤chsten Generation von Cloud-Experten bei.ÃÂÃÂ Als eines der grÃÂÃÂ¶ÃÂÃÂten unabhÃÂÃÂ¤ngigen kanadischen Midstream-Unternehmen betreibt Keyera ein integriertes InfrastrukturgeschÃÂÃÂ¤ft fÃÂÃÂ¼r Energie mit zahlreichen miteinander verbundenen Anlagen. Keyera spielt eine wichtige Rolle bei der Verarbeitung, dem Transport und der Vermarktung von umweltfreundlichem Erdgas und ErdgasflÃÂÃÂ¼ssigkeiten, die das moderne Leben in ganz Nordamerika auf verantwortungsbewusste Weise bereichern. ÃÂÃÂEin Teil unserer nachhaltigen und verantwortungsbewussten Energieversorgung beruht auf der Zusammenarbeit mit einem starken Partner fÃÂÃÂ¼r technologische Innovationen. Wir sind uns der Notwendigkeit digitaler Innovationen bewusst, damit wir unseren Kunden eine hÃÂÃÂ¶here Genauigkeit und ZuverlÃÂÃÂ¤ssigkeit bieten kÃÂÃÂ¶nnen. In Zusammenarbeit mit AWS haben wir eine neue Anwendung fÃÂÃÂ¼r maschinelles Lernen entwickelt, die proaktiv Probleme bei der Verbrauchsmessung erkennt. Dies ermÃÂÃÂ¶glicht es uns, innerhalb von Tagen statt Wochen zu reagieren. Bis heute konnten wir erhebliche Verbesserungen bei der Messung fÃÂÃÂ¼r Keyera und unsere Kunden feststellen. Aufgrund dieses Erfolges erweitern wir den Einsatz auf zwei weitere AnlagenÃÂÃÂ, so Kelly Hill, Vice President von Information Technology bei Keyera. ÃÂÃÂDie Zusammenarbeit mit AWS ermÃÂÃÂ¶glicht uns den Aufbau einer digitalen Innovationsplattform fÃÂÃÂ¼r unsere aktuellen und zukÃÂÃÂ¼nftigen Anforderungen. AWS Professional Services unterstÃÂÃÂ¼tzt uns bei der Transformation unserer digitalen GeschÃÂÃÂ¤fte durch neue Anwendungen und Services wie Amazon Rekognition fÃÂÃÂ¼r die Bestandsnachverfolgung mithilfe von Computer Vision und andere Services wie Amazon SageMaker und Amazon QuickSight fÃÂÃÂ¼r GeschÃÂÃÂ¤ftsanalysen und Dashboarding in unserer Initiative fÃÂÃÂ¼r Messdaten. Wir freuen uns darauf, weiterhin mit AWS zu kooperieren, um unseren Innovationsprozess voranzutreiben.ÃÂÃÂ Neo Financial wurde mit AWS entwickelt und ist ein Finanztechnologie-Startup, das die ElastizitÃÂÃÂ¤t der AWS Cloud nutzt, um das GeschÃÂÃÂ¤ft zu skalieren. ÃÂÃÂAls wir 2019 an den Start gingen, brauchten wir einen Cloud-Anbieter, der uns bei der Skalierung unterstÃÂÃÂ¼tzt und die regulatorischen Anforderungen erfÃÂÃÂ¼llt, die wir als Finanzdienstleistungsunternehmen erfÃÂÃÂ¼llen mÃÂÃÂ¼ssen. Unsere Kunden haben darÃÂÃÂ¼ber hinaus Compliance-Vorgaben, die verlangen, dass ihre Daten in Kanada aufbewahrt werdenÃÂÃÂ, so Kris Read, MitbegrÃÂÃÂ¼nder und CTO bei Neo Financial. ÃÂÃÂHeute nutzen wir Amazon Elastic Compute Cloud fÃÂÃÂ¼r unsere zentrale Infrastruktur und Amazon Simple Storage Service fÃÂÃÂ¼r die hochgradig bestÃÂÃÂ¤ndige Speicherung. AuÃÂÃÂerdem haben wir die Sicherheit mit Amazon GuardDuty und die Performance fÃÂÃÂ¼r unsere Kunden mit Amazon CloudFront verbessert.ÃÂÃÂ Die in Kanada ansÃÂÃÂ¤ssigen Partner sind Teil des AWS Partner Network (APN), zu dem ÃÂÃÂ¼ber 100.000 unabhÃÂÃÂ¤ngige Softwareanbieter (Independent Software Vendors, ISVs) und Systemintegratoren (SIs) auf der ganzen Welt gehÃÂÃÂ¶ren. AWS-Partner entwickeln innovative LÃÂÃÂ¶sungen und Services auf AWS, und das APN bietet Kunden UnterstÃÂÃÂ¼tzung in den Bereichen GeschÃÂÃÂ¤ftstÃÂÃÂ¤tigkeit, Technik, Marketing und MarkteinfÃÂÃÂ¼hrung. APN SIs, Beratungspartner und ISVs helfen Kunden aus Unternehmen und dem ÃÂÃÂ¶ffentlichen Sektor bei der Migration zu AWS, stellen erfolgskritische Anwendungen bereit und bieten eine breite Palette an ÃÂÃÂberwachungs-, Automatisierungs- und Verwaltungsservices fÃÂÃÂ¼r Kundenumgebungen. Zu den ÃÂÃÂAWS CanadaÃÂÃÂ-Partnern gehÃÂÃÂ¶ren Accenture, Bell Canada, Deloitte, FuseForward, FX Innovation, Levio, OpsGuru, Rackspace, Slalom, Softchoice, Qalius, Quantiphi und Xerris. AWS ISVs in Kanada, darunter Arctic Wolf, Benevity, CrowdStrike, D2L, Lightspeed POS, Salesforce, SmartSimple, Tidal Migrations, Vidyard und Workday, nutzen AWS bereits zur Bereitstellung ihrer Software fÃÂÃÂ¼r Kunden auf der ganzen Welt und beabsichtigen, ihre kanadischen Kunden beim Start von der AWS Canada West (Calgary) Region aus zu bedienen. Eine vollstÃÂÃÂ¤ndige Liste der APN-Mitglieder ist unter aws.amazon.com/partners verfÃÂÃÂ¼gbar. Xerris Inc. ist ein fortschrittlicher AWS-Partner mit Sitz in Calgary, Alberta, der sich auf die Bereitstellung von technologieorientierten LÃÂÃÂ¶sungen fÃÂÃÂ¼r Unternehmen in den Bereichen Medien und Unterhaltung, Energie, BehÃÂÃÂ¶rden und Einzelhandel spezialisiert hat. ÃÂÃÂWir haben mehrere Jahre lang mit AWS zusammengearbeitet, und im Jahr 2020 haben wir unseren GeschÃÂÃÂ¤ftsbetrieb stark ausgeweitet ÃÂÃÂ von einem achtkÃÂÃÂ¶pfigen Team auf weit ÃÂÃÂ¼ber 100 MitarbeiterÃÂÃÂ, sagte Jeremy Tooley, CEO von Xerris. ÃÂÃÂWir haben Kunden im Raum Calgary wie StellarAlgo dabei geholfen, ihre DatenlÃÂÃÂ¶sungen zu skalieren und zu optimieren, damit sie mit Hilfe von Modellen des maschinellen Lernens wertvolle Erkenntnisse ÃÂÃÂ¼ber das Fanverhalten und die Fanbindung bei Live-Sport- und Unterhaltungsveranstaltungen gewinnen kÃÂÃÂ¶nnen. Wir arbeiten auÃÂÃÂerdem mit Nutrien, Burnco, enerPlus und Aldo an einer Reihe von Transformations- und GrÃÂÃÂ¼ndungsprojekten. Die AWS-Cloud bietet eine breite Palette von Services, die unseren Kunden helfen, agil und skalierbar zu agieren. Wir freuen uns ÃÂÃÂ¼ber das anhaltende Wachstum und die Investitionen, die AWS in Kanada tÃÂÃÂ¤tigt.ÃÂÃÂ Slalom, ein globales Beratungshaus mit Schwerpunkt auf Strategie, Technologie und GeschÃÂÃÂ¤ftstransformation mit mehr als 11.000 Mitarbeitern in 41 MÃÂÃÂ¤rkten auf der ganzen Welt, verfÃÂÃÂ¼gt ÃÂÃÂ¼ber die nÃÂÃÂ¶tige Autonomie, um schnell zu handeln und fÃÂÃÂ¼r seine Kunden zu entwickeln. ÃÂÃÂSlalom und AWS haben gemeinsam mehr als 1.500 Projekte in den Bereichen Migration, Modernisierung, Datenanalyse und allgemeine Cloud-Strategien durchgefÃÂÃÂ¼hrt. Dies hat dazu gefÃÂÃÂ¼hrt, dass Slalom seit 2016 in die AWS Canada (Central) Region investiert und den Betrieb ausgebaut hatÃÂÃÂ, so Wayne Ingram, Country General Manager von Slalom Canada. ÃÂÃÂAufgrund dieser Partnerschaft ist Slalom Canada in den letzten fÃÂÃÂ¼nf Jahren auf mehr als 750 Mitarbeiter angewachsen, davon 150 in Westkanada in Vancouver und Calgary. Mit kanadischen Kunden wie LoyaltyOne, TC Energy und vielen anderen freuen wir uns besonders ÃÂÃÂ¼ber das wachsende Interesse und den Bedarf an Cloud-Strategien und freuen uns auf noch mehr Innovation in diesem Land.ÃÂÃÂ Investitionen in die Zukunft Kanadas ZusÃÂÃÂ¤tzlich zur AWS Canada (Central) Region in Montreal hat AWS fÃÂÃÂ¼nf Amazon CloudFront-Edge-Standorte in Vancouver, Toronto und Montreal erÃÂÃÂ¶ffnet. Amazon CloudFront ist ein extrem sicheres und programmierbares Content Delivery Network (CDN), das die Bereitstellung von Daten, Videos, Anwendungen und APIs fÃÂÃÂ¼r Benutzer weltweit mit geringer Latenz und hohen ÃÂÃÂbertragungsgeschwindigkeiten erheblich beschleunigt. Amazon erÃÂÃÂ¶ffnete in Toronto und Vancouver Technologiezentren fÃÂÃÂ¼r Entwickler, Ingenieure, Vertriebs-, Marketing- und GeschÃÂÃÂ¤ftsentwicklungsexperten mit dem Ziel, lokale Kunden und Partner zu unterstÃÂÃÂ¼tzen. In Winnipeg wurde zudem das AWS Thinkbox-BÃÂÃÂ¼ro erÃÂÃÂ¶ffnet, das sich auf die Entwicklung von LÃÂÃÂ¶sungen und Dienstleistungen fÃÂÃÂ¼r die Kreativbranche konzentriert. Im MÃÂÃÂ¤rz 2021 erÃÂÃÂ¶ffnete Amazon Games ein neues Entwicklerstudio in Montreal, und Amazon verfÃÂÃÂ¼gt derzeit ÃÂÃÂ¼ber 17 Auslieferungszentren, sechs Sortierzentren und 35 Lieferstationen im ganzen Land. Amazon beschÃÂÃÂ¤ftigt mehr als 39.500 Vollzeit- und Teilzeitmitarbeiter, und das Unternehmen plant die Schaffung Tausender zusÃÂÃÂ¤tzlicher ArbeitsplÃÂÃÂ¤tze im Land in seinem Betriebsnetzwerk und in Teams wie AWS, Amazon Ads, Amazon Games, Alexa und Prime Video. HÃÂÃÂ¶here Qualifikation der kanadischen Belegschaft AWS investiert weiterhin in die Qualifizierung von Entwicklern, Studenten und der nÃÂÃÂ¤chsten Generation von IT-FÃÂÃÂ¼hrungskrÃÂÃÂ¤ften in Kanada ÃÂÃÂ durch Programme wie AWS re/Start, AWS Academy und AWS Educate. Seit 2013 hat AWS mehr als 100.000 Personen geholfen, ihre Cloud-Computing-FÃÂÃÂ¤higkeiten zu verbessern. Diese AWS Bildungsprogramme bereiten Lernende aller HintergrÃÂÃÂ¼nde und Erfahrungen auf eine Karriere in der Cloud vor. Von Hochschulkursen ÃÂÃÂ¼ber Vollzeit-Schulungsangebote bis hin zu Lerninhalten zum Selbststudium bieten die AWS-Bildungsprogramme einen Zugang zu den FÃÂÃÂ¤higkeiten, die fÃÂÃÂ¼r den Einstieg in eine Cloud-Computing-Karriere erforderlich sind. Mit UnterstÃÂÃÂ¼tzung des Programms Edge Up 2.0 von Calgary Economic Development haben sich AWS und die Mount Royal University zusammengeschlossen, um Anfang 2022 das AWS re/Start-Programm nach Calgary zu ÃÂÃÂ¼bertragen. Das AWS re/Start-Jobtrainingsprogramm wird die Teilnehmer auf Einstiegspositionen im Bereich Cloud Computing vorbereiten und sie mit potenziellen Arbeitgebern in Kontakt bringen. Dies ist Teil der Verpflichtung von Amazon, bis 2025 29 Millionen Menschen auf der ganzen Welt dabei zu helfen, ihre technischen Kompetenzen durch kostenlose Cloud-Computing-Schulungen zu erweitern. Einsatz fÃÂÃÂ¼r Nachhaltigkeit Amazon hat sich verpflichtet, seine GeschÃÂÃÂ¤fte auf umweltvertrÃÂÃÂ¤gliche Weise zu tÃÂÃÂ¤tigen, und hat sich im Rahmen von The Climate Pledge dazu verpflichtet, bis zum Jahr 2040, also 10 Jahre vor dem ÃÂÃÂbereinkommen von Paris, eine CO2-neutrale GeschÃÂÃÂ¤ftstÃÂÃÂ¤tigkeit zu erreichen. Ein zentraler Aspekt dieser Verpflichtung ist es, Amazons globale Infrastruktur zu 100 % mit erneuerbarer Energie zu versorgen, und das Unternehmen ist nun auf dem Weg, diesen Meilenstein bis 2025 zu erreichen, fÃÂÃÂ¼nf Jahre vor dem ursprÃÂÃÂ¼nglichen Ziel fÃÂÃÂ¼r 2030. Amazon wurde 2020 auch der grÃÂÃÂ¶ÃÂÃÂte UnternehmenskÃÂÃÂ¤ufer erneuerbarer Energien der Welt und erreichte in all seinen GeschÃÂÃÂ¤ften einen Anteil erneuerbarer Energien von 65 %. Im April 2021 kÃÂÃÂ¼ndigte Amazon sein erstes Projekt im Bereich erneuerbare Energien in Kanada an ÃÂÃÂ ein 80-Megawatt (MW)-Solarprojekt in der Grafschaft Newell in Alberta. Nach Abschluss des Projekts werden schÃÂÃÂ¤tzungsweise 195.000 Megawattstunden (MWh) erneuerbare Energie in das Netz eingespeist. Das ist genug Energie, um mehr als 18.000 kanadische Haushalte ein Jahr lang zu versorgen. Im Juni 2021 kÃÂÃÂ¼ndigte Amazon sein zweites und grÃÂÃÂ¶ÃÂÃÂtes Projekt im Bereich erneuerbare Energien in Kanada an ÃÂÃÂ einen 375-MW-Solarpark in Vulcan, Alberta. Sobald das Projekt im nÃÂÃÂ¤chsten Jahr ans Netz geht, wird die KapazitÃÂÃÂ¤t von Amazon in Kanada auf mehr als 1 Million MWhs anwachsen. Das ist genug, um mehr als 100.000 kanadische Haushalte ein Jahr lang mit Strom zu versorgen. Diese Projekte werden dazu beitragen, die globale Amazon-Infrastruktur mit Strom zu versorgen. Weitere Informationen ÃÂÃÂ¼ber die NachhaltigkeitsbemÃÂÃÂ¼hungen von AWS finden Sie unter aws.amazon.com/about-aws/sustainability. ÃÂÃÂber Amazon Web Services Seit ÃÂÃÂ¼ber 15 Jahren bietet Amazon Web Services das umfassendste und am weitesten verbreitete Cloud-Angebot der Welt. AWS hat seine Services kontinuierlich erweitert, um nahezu jeden Cloud-Workload zu unterstÃÂÃÂ¼tzen, und verfÃÂÃÂ¼gt heute ÃÂÃÂ¼ber mehr als 200 voll funktionsfÃÂÃÂ¤hige Services in den Bereichen Rechenleistung, Datenspeicher, Datenbanken, Netzwerke, Analytik, maschinelles Lernen und kÃÂÃÂ¼nstliche Intelligenz (KI), Internet der Dinge (IoT), MobilitÃÂÃÂ¤t, Sicherheit, Hybrid, virtuelle und erweiterte RealitÃÂÃÂ¤t (VR und AR), Medien sowie Anwendungsentwicklung, -bereitstellung und -verwaltung aus 81 VerfÃÂÃÂ¼gbarkeitszonen in 25 geografischen Regionen, mit angekÃÂÃÂ¼ndigten PlÃÂÃÂ¤nen fÃÂÃÂ¼r 27 weitere VerfÃÂÃÂ¼gbarkeitszonen und neun weitere AWS-Regionen in Australien, Kanada, Indien, Indonesien, Israel, Neuseeland, Spanien, der Schweiz und den Vereinigten Arabischen Emiraten. Millionen von Kunden ÃÂÃÂ darunter die wachstumsstÃÂÃÂ¤rksten Start-ups, die grÃÂÃÂ¶ÃÂÃÂten Konzerne und fÃÂÃÂ¼hrende RegierungsbehÃÂÃÂ¶rden ÃÂÃÂ verlassen sich auf AWS, um ihre Infrastruktur anzutreiben, agiler zu werden und Kosten zu senken. Mehr Informationen zu AWS erhalten Sie unter aws.amazon.com. ÃÂÃÂber Amazon Amazon orientiert sich an vier GrundsÃÂÃÂ¤tzen: Orientierung am Kunden statt an der Konkurrenz, Leidenschaft fÃÂÃÂ¼r Neuerungen, Einsatz fÃÂÃÂ¼r betriebliche Optimierung sowie langfristiges Denken. Amazon strebt danach, das kundenorientierteste Unternehmen der Welt, der beste Arbeitgeber der Welt und der sicherste Arbeitsplatz der Welt zu sein. Kundenrezensionen, 1-Klick-EinkÃÂÃÂ¤ufe, personalisierte Empfehlungen, Prime, Versand durch Amazon, AWS, Kindle Direct Publishing, Kindle, Career Choice, Fire-Tablets, Fire TV, Amazon Echo, Alexa, Just Walk Out-Technologie, Amazon Studios und The Climate Pledge sind einige der Pionierleistungen von Amazon. FÃÂÃÂ¼r weitere Informationen besuchen Sie amazon.com/about und folgen Sie @AmazonNews. Die Ausgangssprache, in der der Originaltext verÃÂÃÂ¶ffentlicht wird, ist die offizielle und autorisierte Version. ÃÂÃÂbersetzungen werden zur besseren VerstÃÂÃÂ¤ndigung mitgeliefert. Nur die Sprachversion, die im Original verÃÂÃÂ¶ffentlicht wurde, ist rechtsgÃÂÃÂ¼ltig. Gleichen Sie deshalb ÃÂÃÂbersetzungen mit der originalen Sprachversion der VerÃÂÃÂ¶ffentlichung ab.",https://www.businesswire.com/news/home/20211111005915/de/,businesswire.com,5,seattlebusiness wireheute hat amazon web service inc aws ein amazoncom inc unternehmen nasdaq amzn plne zur erffnung einer infrastrukturregion alberta kanada ende de jahres anfang bekannt gegeben die neue region aws canada west calgary wird zu beginn au drei verfgbarkeitszonen availability zone az bestehen und die bestehende region aws canada central montreal ergnzen die ebenfalls au drei verfgbarkeitszonen besteht weltweit verfgt aws ber verfgbarkeitszonen geografischen regionen und plant die einfhrung von weiteren verfgbarkeitszonen und neun weiteren awsregionen australien kanada indien indonesien israel neuseeland spanien der schweiz und den vereinigten arabischen emiraten die knftige aws canada west calgary region wird e noch mehr entwicklern startup und unternehmen sowie behrden bildungseinrichtungen und gemeinntzigen organisationen ermglichen ihre anwendungen von rechenzentren kanada au auszufhren und endbenutzer zu versorgen aws hat zudem eine studie ber die wirtschaftlichen auswirkungen economic impact study eis verffentlicht der davon ausgegangen wird das durch die ausgaben de unternehmens fr den bau und den betrieb der neuen aws canada west calgary region und der bestehenden aws canada central region montreal bi zum jahr insgesamt mehr al neue arbeitspltze mit einer voraussichtlichen investitionssumme von ber mrd usd mrd ca den lokalen volkswirtschaften geschaffen werden beide infrastrukturregionen werden im gleichen zeitraum schtzungsweise milliarden usd milliarden ca zum bip kanadas beitragen weitere informationen ber die globale infrastruktur von aws finden sie unter awsamazoncomaboutawsglobalinfrastructure unsere infrastruktur kanada hat unseren kunden die mglichkeit gegeben die art und weise zu verndern wie unternehmen bildungseinrichtungen und regierungsbehrden ihre stakeholder bedienen mit einer zustzlichen awsregion kanada werden kunden noch geringere latenzzeiten fr knftige lsungen wie gfhige anwendungen und maschinelles lernen der edge erleben und e wird ihre mglichkeiten strken ihre regionale infrastruktur fr noch grere fehlertoleranz ausfallsicherheit und verfgbarkeit zu gestalt sagte prasad kalyanaraman vice president von infrastructure service bei aws wir freuen un darauf eine erstklassige infrastruktur zu schaffen um unternehmen dabei zu untersttzen die art und weise wie sie kundenlsungen bereitstellen und da wirtschaftswachstum frdern neu zu erfinden diese groinvestition von aws zeigt erneut das alberta sich al fhrender akteur im bereich der digitalen technologie und innovation etablieren wird diesis milliardenschwere rechenzentrumsprojekt unserer provinz verdeutlicht die arbeit die invest alberta fr die schaffung von arbeitspltzen und die diversifizierung der wirtschaft leistet sagte alberta premierminister jason kenney ich freue mich auf die gemeinsame arbeit mit aws diesem projekt und darauf zu sehen wie e den und kommunikationssektor alberta strken wird awsregionen setzen sich au verfgbarkeitszonen zusammen die die infrastruktur getrennten und eigenstndigen geografischen standorten unterbringen die verfgbarkeitszonen sind weit genug voneinander entfernt um die geschftskontinuitt der kunden zu gewhrleisten aber nahe genug um niedrige latenzzeiten fr anwendungen mit hoher verfgbarkeit zu bieten die mehrere verfgbarkeitszonen nutzen jede verfgbarkeitszone verfgt ber eine unabhngige stromversorgung khlung und physische sicherheit die zonen sind ber redundante netzwerke mit ultrageringer latenz miteinander verbunden awskunden fr die hohe verfgbarkeit oberste prioritt hat knnen ihre anwendungen entwickeln um sie verschiedenen verfgbarkeitszonen zu betreiben und eine noch grere ausfallsicherheit zu erreichen die aws canada west calgary region versetzt kunden mit prferenzen fr den datenstandort die lage daten sicher kanada zu speichern whrend sie eine noch geringere latenz im ganzen land und mehr flexibilitt fr die ausfhrung von ber mehrere regionen verteilten anwendungen bietet insgesamt wird aws bi zum jahr schtzungsweise mehr al milliarden usd milliarden ca kanada den aufbau und betrieb seiner beiden infrastrukturregionen investieren e wird erwartet das diese awsinfrastrukturinvestitionen da kanadische bruttoinlandsprodukt im entsprechenden zeitraum um mehr al milliarden usd milliarden ca erhhen werden aws plant der neu angekndigten aws canada west calgary region bi mehr al mrd usd mrd ca zu investieren dazu gehren investitionsausgaben fr den bau von rechenzentren betriebskosten wie laufende versorgungs und anlagenkosten sowie der kauf von waren und dienstleistungen von regionalen unternehmen die eis geht auerdem davon au das die neue awsregion direkte und indirekte wirtschaftliche vorteile wie neue arbeitspltze und absatzmglichkeiten fr die lieferkette im bereich der rechenzentren und die damit verbundenen sektoren kanada bringen wird insgesamt werden durch die investitionen die neue aws canada west calgary region schtzungsweise mehr al neue arbeitspltze auf vollzeitbasis fulltime equivalent fte kanada geschaffen kunden und awspartner heien die aws canada west calgary region willkommen die kunden kanada werden sich zu den millionen aktiver kunden gesellen die aws jeden monat ber lndern der welt nutzen kanadische organisationen wie air canada athabasca university benevity bmo financial group canada border service agency dl hootsuite humber college keyera neo financial nhl nutrien lululemon athletica provincial health service authority porter airline sun life trimac transportation und vancouver general hospital vertrauen bei der ausfhrung ihrer workload auf aws um kosteneinsparungen zu erzielen innovationen voranzutreiben und die markteinfhrung zu beschleunigen sun life ist ein fhrendes internationale unternehmen fr finanzdienstleistungen da privat und firmenkunden lsungen fr die bereiche leben gesundheit und vermgen anbietet durch unsere digitale transformation sind wir stndig auf der suche nach innovationen um unsere kunden bei der erreichung lebenslanger finanzieller sicherheit und einem gesnderen leben zu untersttzen sagte laura money executive vice president und chief information officer bei sun life mit der heutigen ankndigung einer zweiten awsregion kanada bieten wir unseren kunden die ihre daten kanada speichern mssen eine weitere dimension der ausfallsicherheit die provincial health service authority phsa ist da rckgrat de gesundheitssystems von british columbia und stellt sicher das millionen einwohner zugang zu einem netzwerk au spezialisierten gesundheitsdienstleistungen und programmen haben al die covidpandemie ausgebrochen ist hat die phsa covidtestergebnisse bereitgestellt und impfungen gebucht mithilfe von amazon pinpoint hat phsa millionen von sm und email mit anmeldebesttigungen buchungsbenachrichtigungen und erinnerungen impftermine die einwohner von british columbia verschickt shannon malovec chief digital innovation officer bei phsa aws hat un die lage versetzt unsere kommunikation krzester zeit zu erweitern wir erkennen den wert de einsatzes der neuesten technologie im dienste unserer brger und diese neue awsregion westkanada wird un und vielen anderen organisationen bei der erschlieung neuer innovationen helfen kidoodletv ist ein calgary ansssiger streamingdienst fr kinder mit mehr al millionen downloads lndern und regionen weltweit ich nutze aws schon seit langer zeit der medien und unterhaltungsbranche das ich mir eine welt ohne aws nicht mehr vorstellen kann aws ist fr un unerlsslich um neue funktionen und produkte schnell wie mglich zu verffentlichen sagt daniel riddell chief technology officer bei kidoodletv da die awscloud bereits existierte al wir da unternehmen grndeten konnten wir alles vor ort entwickeln wir waren nicht auf riesige overheadkosten angewiesen wir konnten im wesentlichen die gleiche servicearchitektur einrichten die auch multimilliardendollarunternehmen einsetzen knnen al covid einschlug stiegen unsere zahlen sprunghaft mit aws elemental mediatailor und anderen awsservices konnten wir unsere monatlich aktiven nutzer innerhalb eines jahres um vergrern und unseren prozess der anzeigenschaltung rasch anpassen die athabasca university au die kanadische onlineuniversitt ist eine der weltweit schnellsten wachsenden online und freien bildungseinrichtungen mit mehr al studenten lndern die au war die erste kanadische hochschulinstitution die im vergangenen jahr ihre gesamte digitale betriebsinfrastruktur auf aws umgestellt hat ich pflege zu sagen das e ohne ein solides fundament keine skalierbare innovation gibt die umstellung der au auf aws im jahr war die grundlage unserer digitalen transformationsstrategie dadurch wurden die infrastruktur und die kosteneinsparungen geschaffen die e un ermglichen werden personalisiertes lernen fr unsere studenten zu einer unendlich skalierbaren realitt zu machen sagte jennifer schaeffer au vice president von information technology und chief information officer wir stellen nicht nur unsere digitale basis um sondern rcken die cloud auch den vordergrund unseres lehrplans mit den programmen au poweredtm und aws academy cloud foundation tragen wir zur ausbildung der nchsten generation von cloudexperten bei al eines der grten unabhngigen kanadischen midstreamunternehmen betreibt keyera ein integriertes infrastrukturgeschft fr energie mit zahlreichen miteinander verbundenen anlage keyera spielt eine wichtige rolle bei der verarbeitung dem transport und der vermarktung von umweltfreundlichem erdgas und erdgasflssigkeiten die da moderne leben ganz nordamerika auf verantwortungsbewusste weise bereichern ein teil unserer nachhaltigen und verantwortungsbewussten energieversorgung beruht auf der zusammenarbeit mit einem starken partner fr technologische innovationen wir sind un der notwendigkeit digitaler innovationen bewusst damit wir unseren kunden eine hhere genauigkeit und zuverlssigkeit bieten knnen zusammenarbeit mit aws haben wir eine neue anwendung fr maschinelles lernen entwickelt die proaktiv probleme bei der verbrauchsmessung erkennt dy ermglicht e un innerhalb von tagen statt wochen zu reagieren bi heute konnten wir erhebliche verbesserungen bei der messung fr keyera und unsere kunden feststellen aufgrund diesis erfolges erweitern wir den einsatz auf zwei weitere anlage kelly hill vice president von information technology bei keyera die zusammenarbeit mit aws ermglicht un den aufbau einer digitalen innovationsplattform fr unsere aktuellen und zuknftigen anforderungen aws professional service untersttzt un bei der transformation unserer digitalen geschfte durch neue anwendungen und service wie amazon rekognition fr die bestandsnachverfolgung mithilfe von computer vision und andere service wie amazon sagemaker und amazon quicksight fr geschftsanalysen und dashboarding unserer initiative fr messdaten wir freuen un darauf weiterhin mit aws zu kooperieren um unseren innovationsprozess voranzutreiben neo financial wurde mit aws entwickelt und ist ein finanztechnologiestartup da die elastizitt der aws cloud nutzt um da geschft zu skalieren al wir den start gingen brauchten wir einen cloudanbieter der un bei der skalierung untersttzt und die regulatorischen anforderungen erfllt die wir al finanzdienstleistungsunternehmen erfllen mssen unsere kunden haben darber hinaus compliancevorgaben die verlangen das ihre daten kanada aufbewahrt werden kris read mitbegrnder und cto bei neo financial heute nutzen wir amazon elastic compute cloud fr unsere zentrale infrastruktur und amazon simple storage service fr die hochgradig bestndige speicherung auerdem haben wir die sicherheit mit amazon guardduty und die performance fr unsere kunden mit amazon cloudfront verbessert die kanada ansssigen partner sind teil de aws partner network apn zu dem ber unabhngige softwareanbieter independent software vendor isvs und systemintegratoren si auf der ganzen welt gehren awspartner entwickeln innovative lsungen und service auf aws und da apn bietet kunden untersttzung den bereichen geschftsttigkeit technik marketing und markteinfhrung apn si beratungspartner und isvs helfen kunden au unternehmen und dem ffentlichen sektor bei der migration zu aws stellen erfolgskritische anwendungen bereit und bieten eine breite palette berwachungs automatisierungs und verwaltungsservices fr kundenumgebungen zu den aws canadapartnern gehren accenture bell canada deloitte fuseforward fx innovation levio opsguru rackspace slalom softchoice qalius quantiphi und xerris aws isvs kanada darunter arctic wolf benevity crowdstrike dl lightspeed po salesforce smartsimple tidal migration vidyard und workday nutzen aws bereits zur bereitstellung ihrer software fr kunden auf der ganzen welt und beabsichtigen ihre kanadischen kunden beim start von der aws canada west calgary region au zu bedienen eine vollstndige liste der apnmitglieder ist unter awsamazoncompartners verfgbar xerris inc ist ein fortschrittlicher awspartner mit sitz calgary alberta der sich auf die bereitstellung von technologieorientierten lsungen fr unternehmen den bereichen medien und unterhaltung energie behrden und einzelhandel spezialisiert hat wir haben mehrere jahre lang mit aws zusammengearbeitet und im jahr haben wir unseren geschftsbetrieb stark ausgeweitet von einem achtkpfigen team auf weit ber mitarbeiter sagte jeremy tooley ceo von xerris wir haben kunden im raum calgary wie stellaralgo dabei geholfen ihre datenlsungen zu skalieren und zu optimieren damit sie mit hilfe von modellen de maschinellen lernens wertvolle erkenntnisse ber da fanverhalten und die fanbindung bei livesport und unterhaltungsveranstaltungen gewinnen knnen wir arbeiten auerdem mit nutrien burnco enerplus und aldo einer reihe von transformation und grndungsprojekten die awscloud bietet eine breite palette von service die unseren kunden helfen agil und skalierbar zu agieren wir freuen un ber da anhaltende wachstum und die investitionen die aws kanada ttigt slalom ein globales beratungshaus mit schwerpunkt auf strategie technologie und geschftstransformation mit mehr al mitarbeitern mrkten auf der ganzen welt verfgt ber die ntige autonomie um schnell zu handeln und fr seine kunden zu entwickeln slalom und aws haben gemeinsam mehr al projekte den bereichen migration modernisierung datenanalyse und allgemeine cloudstrategien durchgefhrt dy hat dazu gefhrt das slalom seit die aws canada central region investiert und den betrieb ausgebaut hat wayne ingram country general manager von slalom canada aufgrund dieser partnerschaft ist slalom canada den letzten fnf jahren auf mehr al mitarbeiter angewachsen davon westkanada vancouver und calgary mit kanadischen kunden wie loyaltyone tc energy und vielen anderen freuen wir un besonders ber da wachsende interesse und den bedarf cloudstrategien und freuen un auf noch mehr innovation diesem land investitionen die zukunft kanadas zustzlich zur aws canada central region montreal hat aws fnf amazon cloudfrontedgestandorte vancouver toronto und montreal erffnet amazon cloudfront ist ein extrem sicheres und programmierbares content delivery network cdn da die bereitstellung von daten video anwendungen und apis fr benutzer weltweit mit geringer latenz und hohen bertragungsgeschwindigkeiten erheblich beschleunigt amazon erffnete toronto und vancouver technologiezentren fr entwickler ingenieure vertriebs marketing und geschftsentwicklungsexperten mit dem ziel lokale kunden und partner zu untersttzen winnipeg wurde zudem da aws thinkboxbro erffnet da sich auf die entwicklung von lsungen und dienstleistungen fr die kreativbranche konzentriert im mrz erffnete amazon game ein neues entwicklerstudio montreal und amazon verfgt derzeit ber auslieferungszentren sechs sortierzentren und lieferstationen im ganzen land amazon beschftigt mehr al vollzeit und teilzeitmitarbeiter und da unternehmen plant die schaffung tausender zustzlicher arbeitspltze im land seinem betriebsnetzwerk und team wie aws amazon ad amazon game alexa und prime video hhere qualifikation der kanadischen belegschaft aws investiert weiterhin die qualifizierung von entwicklern studenten und der nchsten generation von itfhrungskrften kanada durch programme wie aws restart aws academy und aws educate seit hat aws mehr al personen geholfen ihre cloudcomputingfhigkeiten zu verbessern diese aws bildungsprogramme bereiten lernende aller hintergrnde und erfahrungen auf eine karriere der cloud vor von hochschulkursen ber vollzeitschulungsangebote bi hin zu lerninhalten zum selbststudium bieten die awsbildungsprogramme einen zugang zu den fhigkeiten die fr den einstieg eine cloudcomputingkarriere erforderlich sind mit untersttzung de programms edge von calgary economic development haben sich aws und die mount royal university zusammengeschlossen um anfang da aws restartprogramm nach calgary zu bertragen da aws restartjobtrainingsprogramm wird die teilnehmer auf einstiegspositionen im bereich cloud computing vorbereiten und sie mit potenziellen arbeitgebern kontakt bringen dy ist teil der verpflichtung von amazon bi millionen menschen auf der ganzen welt dabei zu helfen ihre technischen kompetenzen durch kostenlose cloudcomputingschulungen zu erweitern einsatz fr nachhaltigkeit amazon hat sich verpflichtet seine geschfte auf umweltvertrgliche weise zu ttigen und hat sich im rahmen von climate pledge dazu verpflichtet bi zum jahr also jahre vor dem bereinkommen von paris eine coneutrale geschftsttigkeit zu erreichen ein zentraler aspekt dieser verpflichtung ist e amazon globale infrastruktur zu mit erneuerbarer energie zu versorgen und da unternehmen ist nun auf dem weg diesen meilenstein bi zu erreichen fnf jahre vor dem ursprnglichen ziel fr amazon wurde auch der grte unternehmenskufer erneuerbarer energien der welt und erreichte seinen geschften einen anteil erneuerbarer energien von im april kndigte amazon sein erstes projekt im bereich erneuerbare energien kanada ein megawatt mwsolarprojekt der grafschaft newell alberta nach abschluss de projekts werden schtzungsweise megawattstunden mwh erneuerbare energie da netz eingespeist da ist genug energie um mehr al kanadische haushalte ein jahr lang zu versorgen im juni kndigte amazon sein zweites und grtes projekt im bereich erneuerbare energien kanada einen mwsolarpark vulcan alberta sobald da projekt im nchsten jahr an netz geht wird die kapazitt von amazon kanada auf mehr al million mwhs anwachsen da ist genug um mehr al kanadische haushalte ein jahr lang mit strom zu versorgen diese projekte werden dazu beitragen die globale amazoninfrastruktur mit strom zu versorgen weitere informationen ber die nachhaltigkeitsbemhungen von aws finden sie unter awsamazoncomaboutawssustainability ber amazon web service seit ber jahren bietet amazon web service da umfassendste und weitesten verbreitete cloudangebot der welt aws hat seine service kontinuierlich erweitert um nahezu jeden cloudworkload zu untersttzen und verfgt heute ber mehr al voll funktionsfhige service den bereichen rechenleistung datenspeicher datenbanken netzwerke analytik maschinelles lernen und knstliche intelligenz ki internet der dinge iot mobilitt sicherheit hybrid virtuelle und erweiterte realitt vr und ar medien sowie anwendungsentwicklung bereitstellung und verwaltung au verfgbarkeitszonen geografischen regionen mit angekndigten plnen fr weitere verfgbarkeitszonen und neun weitere awsregionen australien kanada indien indonesien israel neuseeland spanien der schweiz und den vereinigten arabischen emiraten millionen von kunden darunter die wachstumsstrksten startup die grten konzerne und fhrende regierungsbehrden verlassen sich auf aws um ihre infrastruktur anzutreiben agiler zu werden und kosten zu senken mehr informationen zu aws erhalten sie unter awsamazoncom ber amazon amazon orientiert sich vier grundstzen orientierung kunden statt der konkurrenz leidenschaft fr neuerungen einsatz fr betriebliche optimierung sowie langfristiges denken amazon strebt danach da kundenorientierteste unternehmen der welt der beste arbeitgeber der welt und der sicherste arbeitsplatz der welt zu sein kundenrezensionen klickeinkufe personalisierte empfehlungen prime versand durch amazon aws kindle direct publishing kindle career choice firetablets fire tv amazon echo alexa walk outtechnologie amazon studio und climate pledge sind einige der pionierleistungen von amazon fr weitere informationen besuchen sie amazoncomabout und folgen sie amazonnews die ausgangssprache der der originaltext verffentlicht wird ist die offizielle und autorisierte version bersetzungen werden zur besseren verstndigung mitgeliefert nur die sprachversion die im original verffentlicht wurde ist rechtsgltig gleichen sie deshalb bersetzungen mit der originalen sprachversion der verffentlichung ab,-0.9999,-0.49995,0.1424244444,-0.642374444,Negative Impact
12/11/2021,174.25,177.04,172.35,176.26,176.26,53788000,3.3,50.56966791,1.192,0,13.66057312,0.8419472675,0.2413396506,0.08,277.948,15860.95996,17297.66016,7347.899902,7091.399902,3539.100098,60686.69141,21768.5,169.6028104,166.8399601,170.0690518,165.7272128,171.3505005,178.831558,163.869443,63.83837684,2.049445937,1.402872186,0.6465737511,4.953572954,169.1047749,10702358000,75.82273294,66.21300275,16.29000092,Amazon Prosecuted For Delivery Van Crash,"An Amazon.com Inc (NASDAQ: AMZN) delivery van slammed Tesla Inc (NASDAQ: TSLA) Model S, crushing the car's rear and sending Ans Rana, his brother, and father, to Wellstar Kennestone Hospital, Bloomberg reports. In June, Rana prosecuted Amazon holding its algorithms, apps, and devices surrounding its logistics responsible for the mishap.",https://www.benzinga.com/news/21/11/24060293/amazon-prosecuted-for-delivery-van-crash,benzinga.com,5,amazoncom inc nasdaq amzn delivery van slammed tesla inc nasdaq tsla model crushing car rear sending an rana brother father wellstar kennestone hospital bloomberg report june rana prosecuted amazon holding algorithm apps device surrounding logistics responsible mishap,-0.2732,-0.1366,0.1742655556,-0.310865556,Negative Impact
15/11/2021,176.85,179.69,176.29,177.28,177.28,58594000,3.3,50.56966791,1.192,0,13.66057312,0.8419472675,0.2413396506,0.08,277.948,15853.84961,17285.55078,7351.899902,7128.629883,3533.300049,60718.71094,21683.09961,169.6704404,166.8906601,170.3519908,165.8422057,171.59785,179.5297854,163.6659146,62.03369221,2.231378385,1.568573426,0.6628049598,4.857072013,170.221548,10760952000,82.00398043,72.59906057,16.48999977,Amazon warehouse COVID-19 case notifications to be watched by California AG,"Amazon.com Inc. must pay $500,000 and change its practices related to notifying its workers and local health officials about COVID-19 cases at its warehouses, under a stipulated judgment called the first in the nation by California's attorney general on Monday.",https://www.marketwatch.com/story/amazon-warehouse-covid-19-case-notifications-to-be-watched-by-california-ag-11637002854,marketwatch.com,8,amazoncom inc must pay change practice related notifying worker local health official covid case warehouse stipulated judgment called first nation california attorney general monday,-0.1027,-0.08216,0.29174,-0.3739,Negative Impact
16/11/2021,176.95,178.83,176.26,177.04,177.04,44342000,3.3,50.56966791,1.192,0,13.66057312,0.8419472675,0.2413396506,0.08,277.948,15973.86035,17302.78906,7327,7152.600098,3521.790039,60322.37109,21717.19922,169.7018506,166.9308351,170.6140697,165.9535768,171.839225,180.134751,163.543699,60.68890746,2.328626557,1.720584052,0.6080425048,4.806356158,171.2266439,10716610000,80.50461076,79.44377471,16.37000084,JMIA Stock: Why ÃÂÃÂAmazon of Africa' Jumia Technologies Is Plunging Today,"It's an unfortunate day for Jumia. After reporting somewhat muted revenue numbers this morning, JMIA stock is falling in a big way.",https://investorplace.com/2021/11/jmia-stock-why-amazon-of-africa-jumia-technologies-is-plunging-today/,investorplace.com,6,unfortunate day jumia reporting somewhat muted revenue number morning jmia stock falling big way,-0.552,-0.3312,0.2184961538,-0.549696154,Negative Impact
17/11/2021,178.236,179.36,177.27,177.45,177.45,51206000,3.3,50.56966791,1.192,0,13.66057312,0.8419472675,0.2413396506,0.08,277.948,15921.57031,17192.66016,7291.200195,7156.850098,3537.370117,60008.32813,21653,169.7253506,166.9899526,170.8821453,166.0679691,172.1740746,180.8183087,163.5298404,57.90952597,2.411385966,1.858744435,0.5526415317,4.640463693,172.1312302,10767816000,83.00359084,81.83739401,17.11000061,Amazon is so big it doesn't even need a high horse to complain about Visa's fees,"Visa Inc (NYSE:V) and Amazon.com, Inc. (NASDAQ:AMZN) have traded verbal blows after the online retailer made the surprise decision to block Visa (NYSE:V) credit cards. After Amazon UK customers received emails this morning warning them of the change, the card colossus said it was ""very disappointed"" and added that said Amazon ""is threatening to restrict consumer choice"".",https://www.proactiveinvestors.co.uk//companies/news/966564/amazon-is-so-big-it-doesn-t-even-need-a-high-horse-to-complain-about-visa-s-fees-966564.html?SNAPI,proactiveinvestors.co.uk,5,visa inc nysev amazoncom inc nasdaqamzn traded verbal blow online retailer made surprise decision block visa nysev credit card amazon uk customer received email morning warning change card colossus said disappointed added said amazon threatening restrict consumer choice,-0.8074,-0.4037,0.1580342105,-0.561734211,Negative Impact
18/11/2021,178.3175,185.21,178.05,184.80,184.80,114070000,3.3,50.56966791,1.192,0,13.66057312,0.8419472675,0.2413396506,0.08,277.948,15993.70996,17117.74023,7256,7141.97998,3520.709961,59636.01172,21637.5,169.9372507,167.0812176,171.4280609,166.2543872,172.8266991,183.1450531,162.5083451,72.46090358,3.035309627,2.094057473,0.9412521541,4.575999669,172.9453578,10881886000,98.06483815,87.19101325,17.59000015,Starbucks links with Amazon Go for first cashier-less cafe,Starbucks Corp's newest cafe lacks one element most customers are used to seeing: cashiers.,https://www.reuters.com/technology/starbucks-links-with-amazon-go-first-cashier-less-cafe-2021-11-18/,reuters.com,10,starbucks corp newest cafe lack one element customer used seeing cashier,-0.3182,-0.3182,0.162957,-0.481157,Negative Impact
19/11/2021,185.6345,188.11,183.79,183.83,183.83,98734000,3.3,50.56966791,1.192,0,13.66057312,0.8419472675,0.2413396506,0.08,277.948,16057.44043,16973.96094,7223.600098,7112.290039,3560.370117,59636.01172,21555,170.1446707,167.1623226,171.9143529,166.4292541,173.6792496,184.6877162,162.6707829,76.14211887,3.411811404,2.357608259,1.054203145,4.585249765,174.4171157,10783152000,82.1187087,87.7290459,17.90999985,Exclusive-Visa CFO Prabhu says company confident of resolving Amazon dispute,"Visa expects to resolve its dispute with Amazon.com Inc in the United Kingdom and hopes to continue its co-branded credit card partnership in the United States, Chief Financial Officer Vasant Prabhu told Reuters.",https://www.reuters.com/markets/europe/exclusive-visa-cfo-prabhu-says-company-confident-resolving-amazon-dispute-2021-11-19/,reuters.com,10,visa expects resolve dispute amazoncom inc united kingdom hope continue cobranded credit card partnership united state chief financial officer vasant prabhu told reuters,0.875,0.875,0.1056392857,0.7693607143,Positive Impact
22/11/2021,183.819,185.67,178.38,178.63,178.63,96844000,3.3,50.56966791,1.192,0,13.66057312,0.8419472675,0.2413396506,0.08,277.948,15854.75977,16945.7793,7255.5,7105,3582.080078,58465.89063,21420.80078,170.2600705,167.2247301,172.1776526,166.5506395,174.3097496,184.9075879,163.7119113,66.56510211,3.253094599,2.536705527,0.7163890714,4.936643328,176.3337693,10686308000,59.19760867,79.79371851,19.17000008,Union group says U.S. should reject Amazon's plan to buy MGM,"Four big unions, including the Service Employees International Union and the Teamsters, urged the U.S. Federal Trade Commission on Monday to oppose Amazon.com's plan to buy Metro-Goldwyn-Mayer Studios, saying it would reduce competition in the streaming video market.",https://www.reuters.com/markets/deals/union-group-says-us-should-reject-amazons-plan-buy-mgm-2021-11-22/,reuters.com,10,four big union including service employee international union teamster urged u federal trade commission monday oppose amazoncoms plan buy metrogoldwynmayer studio saying would reduce competition streaming video market,0,0,0.2933069231,-0.293306923,Negative Impact
23/11/2021,179.252,181.05,176.39,179.00,179.00,73804000,3.3,50.56966791,1.192,0,13.66057312,0.8419472675,0.2413396506,0.08,277.948,15775.13965,17007.90039,7266.700195,7044.620117,3589.089111,58664.32813,21453.80078,170.3901105,167.2934901,172.445274,166.6745337,174.8196747,185.2825439,164.3568054,63.60521857,3.121466764,2.653657775,0.4678089892,4.922144209,188.1074982,10760112000,54.1457882,65.15403519,19.37999916,Two ways Amazon plans to reduce the waste it creates,"Amazon.com says it plans to cut the use of plastic packaging in Germany, shifting its model under pressure from a European economic giant that has largely embraced environmental policies.",https://www.marketwatch.com/story/two-ways-amazon-plans-to-reduce-the-waste-it-creates-11637694383,marketwatch.com,8,amazoncom say plan cut use plastic packaging germany shifting model pressure european economic giant largely embraced environmental policy,-0.5106,-0.40848,0.287813,-0.696293,Negative Impact
24/11/2021,178.1335,180.68,176.84,179.02,179.02,46560000,3.3,50.56966791,1.192,0,13.66057312,0.8419472675,0.2413396506,0.08,277.948,15845.23047,17036.81055,7286.299805,7042.22998,3592.702881,58340.98828,21548.40039,170.4947302,167.3669476,172.7031257,166.797379,175.2894745,185.6130093,164.9659397,58.23550542,2.984242549,2.71977473,0.2644678196,4.719144549,187.8730582,10806672000,42.32305427,51.88881705,18.57999992,Why This Analyst Thinks Amazon Can Surpass Walmart As The Largest US Retailer In 2022,"Amazon, Inc. (NASDAQ:AMZN) remains poised to see incremental market share in retail, according to an analyst at JPMorgan. The Amazon Analyst: Doug Anmuth has an Overweight rating and $4,400 price target for Amazon shares.",https://www.benzinga.com/analyst-ratings/analyst-color/21/11/24280864/why-this-analyst-thinks-amazon-can-surpass-walmart-as-the-largest-us-retailer-in-20,benzinga.com,5,amazon inc nasdaqamzn remains poised see incremental market share retail according analyst jpmorgan amazon analyst doug anmuth overweight rating price target amazon share,0.7184,0.3592,0.498955,-0.139755,Negative Impact
26/11/2021,180.105,181.68,175.21,175.23,175.23,59826000,3.3,50.56966791,1.192,0,13.66057312,0.8419472675,0.2413396506,0.08,277.948,15491.66016,16624.86914,7044,6739.72998,3564.090088,57107.14844,21125.90039,170.5110501,167.427555,172.8021403,166.8812658,175.434449,185.6639122,165.2049858,48.9096135,2.540186966,2.683857177,-0.143670211,4.862287249,187.643307,10746846000,18.25136559,38.24006936,28.62000084,Amazon facing global protests and strikes on Black Friday,"Amazon.com, Inc. (NASDAQ:AMZN) is facing protests and strikes in 20 countries on what is the busiest day of the year for the e-commerce giant. Protests are being staged at Amazon buildings in Britain, the US and Europe, with workers demanding more pay and changes to working conditions.",https://www.proactiveinvestors.co.uk//companies/news/967460/amazon-facing-global-protests-and-strikes-on-black-friday-967460.html?SNAPI,proactiveinvestors.co.uk,5,amazoncom inc nasdaqamzn facing protest strike country busiest day year ecommerce giant protest staged amazon building britain u europe worker demanding pay change working condition,-0.6249,-0.31245,0.138174,-0.450624,Negative Impact
29/11/2021,177.382,179.80,176.58,178.08,178.08,65312000,3.3,50.56966791,1.192,0,13.66057312,0.8419472675,0.2413396506,0.08,277.948,15782.83008,16683.98047,7110,6776.25,3562.699951,57260.57813,21149,170.6101001,167.4985201,173.0090566,166.9926811,175.907299,185.6746152,166.1399829,55.27015811,2.390723253,2.625230392,-0.234507139,4.863359724,187.1458749,10812158000,36.34409019,32.30617002,22.95999908,Jim Cramer's investment playbook for the Covid omicron variant,"""I'm not necessarily saying the economy will be able to keep on chugging without overheating now ... but it's a real possibility,"" the ""Mad Money"" host said.",https://www.cnbc.com/2021/11/29/jim-cramers-investment-playbook-for-the-covid-omicron-variant.html,cnbc.com,9,im necessarily saying economy able keep chugging without overheating real possibility mad money host said,-0.4939,-0.44451,0.1215272222,-0.566037222,Negative Impact
30/11/2021,178.175,179.29,174.60,175.35,175.35,80022000,3.3,50.56966791,1.192,0,13.66057312,0.8419472675,0.2413396506,0.08,277.948,15537.69043,16318.96973,7059.5,6721.160156,3563.889893,57064.87109,20660,170.7614401,167.5580501,173.1009956,167.0758733,176.3796989,184.9508836,167.8085143,44.72818479,2.02899794,2.505983902,-0.476985962,4.82396698,186.66834,10732136000,19.04796033,24.54780537,27.19000053,Gilead und AWS kooperieren bei der Entwicklung und Bereitstellung neuer Medikamente fÃÂÃÂ¼r Patienten,"SEATTLE--(BUSINESS WIRE)--Today, Amazon Web Services, Inc. (AWS), ein Unternehmen von Amazon.com, Inc. (NASDAQ: AMZN), gab bekannt, dass Gilead Sciences, Inc. (Nasdaq: GILD), ein biopharmazeutisches Unternehmen, das innovative Medikamente zur Vorbeugung und Behandlung lebensbedrohlicher Krankheiten entwickelt, AWS als bevorzugten Cloud-Anbieter ausgewÃÂÃÂ¤hlt hat. preferred cloud provider. Mit AWS-Innovationen und mit Hilfe von AWS-Experten und Partnern aus dem Gesundheitswesen und den Biowissenschaften bietet Gilead seinen Datenwissenschaftlern die neuesten Fortschritte in den Bereichen maschinelles Lernen und Analyse. Diese FÃÂÃÂ¤higkeiten fÃÂÃÂ¶rdern die datengesteuerte Entscheidungsfindung im gesamten Unternehmen ÃÂÃÂ von der Entdeckung von Biomarkern ÃÂÃÂ¼ber die Herstellung bis hin zur Rekrutierung fÃÂÃÂ¼r klinische Studien ÃÂÃÂ und liefern Erkenntnisse, die Gilead dabei helfen kÃÂÃÂ¶nnen, seine Medikamentenpipeline zu verfeinern. Das Unternehmen verlÃÂÃÂ¤sst sich auch auf AWS, um alle Workloads fÃÂÃÂ¼r sein Enterprise Resource Planning (ERP)-Transformationsprojekt zur Implementierung von SAP S/4HANA zu hosten. ÃÂÃÂMit AWS als unserem bevorzugten Cloud-Anbieter kÃÂÃÂ¶nnen unsere Forscher das AWS-Serviceportfolio nutzen, um die Erkenntnisse, FlexibilitÃÂÃÂ¤t und Sicherheit zu gewinnen, die fÃÂÃÂ¼r die schnelle Bereitstellung neuer Medikamente erforderlich sind, und den Einzelnen gemÃÂÃÂ¤ÃÂÃÂ seinen individuellen BedÃÂÃÂ¼rfnissen zu behandeln, nicht nur der KrankheitÃÂÃÂ, sagte Marc Berson, Senior Vice President und Chief Information Officer bei Gilead. ÃÂÃÂDie Leistung, Infrastruktur und GrÃÂÃÂ¶ÃÂÃÂe von AWS sind die Grundlagen, auf denen wir unsere ERP-Transformation abschlieÃÂÃÂen und ein effizienteres, agileres, sichereres und datengesteuertes Unternehmen in der Cloud werden.ÃÂÃÂ Gilead ÃÂÃÂ¼berarbeitet seine Bioinformatik-Computing-Infrastruktur in der weltweit fÃÂÃÂ¼hrenden Cloud. Die Nutzung der Rechen-, maschinellen Lern- und Datenbankfunktionen von AWS wird die Analyse und Integration verschiedener Genomik-, Bildgebungs- und experimentellen DatensÃÂÃÂ¤tze unterstÃÂÃÂ¼tzen, um DurchbrÃÂÃÂ¼che bei der Diagnose und Behandlung von Krankheiten durch Gilead zu unterstÃÂÃÂ¼tzen. Durch die sichere Analyse anonymisierter genomischer Patientendaten in groÃÂÃÂem MaÃÂÃÂstab auf AWS, um Muster aufzudecken, kann Gilead beispielsweise Erkenntnisse darÃÂÃÂ¼ber gewinnen, wie Menschen mit Krebs auf bestehende therapeutische Optionen reagieren, was die Entdeckung neuer Behandlungsmethoden mÃÂÃÂ¶glicherweise beschleunigt. DarÃÂÃÂ¼ber hinaus verwendet Gilead in seiner IT-Organisation AWS zum Hosten aller Workloads fÃÂÃÂ¼r sein ERP-Transformationsprojekt zur Implementierung von SAP S/4HANA. Diese Systeme unterstÃÂÃÂ¼tzen geschÃÂÃÂ¤ftskritische Prozesse in Bereichen wie Lieferkette, Finanzen, Betrieb und kommerzieller Vertrieb in allen therapeutischen Bereichen und GeschÃÂÃÂ¤ftsbereichen. Die AusfÃÂÃÂ¼hrung dieser Prozesse auf AWS bildet die Grundlage fÃÂÃÂ¼r Gileads Implementierung von SAP S/4HANA. Es hilft dem Unternehmen auch, Hardware-Aktualisierungszyklen zu verkÃÂÃÂ¼rzen, die AgilitÃÂÃÂ¤t von Tests und Bereitstellungen zu erhÃÂÃÂ¶hen und Transparenz zu gewinnen, um die GeschÃÂÃÂ¤ftsplanung zu verbessern. Dies ist Gileads erste Implementierung von ERP-Systemen im ProduktionsmaÃÂÃÂstab in der Cloud, und AWS bietet dem IT-Transformationsteam des Unternehmens eine skalierbare, sichere und leistungsstarke Infrastruktur. In Zusammenarbeit mit AWS wird Gilead seine SAP-Umgebungen mit einer breiten Palette fortschrittlicher AWS-Technologien in Bereichen wie Analyse und maschinelles Lernen integrieren, um den GeschÃÂÃÂ¤ftswert aufzudecken und Innovationen voranzutreiben. In Zukunft wird das Unternehmen mit AWS als Grundlage seiner neuen Cloud-basierten SAP-Umgebung eine Vielzahl von Amazon Elastic Compute Cloud-Instance-Typen (Amazon EC2) verwenden. Dazu gehÃÂÃÂ¶ren X1- und X1e-Instanzen, die fÃÂÃÂ¼r Hochleistungsdatenbanken, In-Memory-Datenbanken und andere speicherintensive Unternehmensanwendungen entwickelt wurden, um ERP-Workloads effizienter auszufÃÂÃÂ¼hren. DarÃÂÃÂ¼ber hinaus hat Gilead in den letzten 12 Monaten ÃÂÃÂ¼ber ein beschleunigtes Cloud-Migrationsprogramm mit AWS Professional Services mehr als 50 % seiner RechenzentrumsflÃÂÃÂ¤che zu AWS verlagert. Das Unternehmen plant auÃÂÃÂerdem, Hunderte von Anwendungen zu AWS zu migrieren, darunter kritische Anwendungen, die die Richtlinien und Vorschriften fÃÂÃÂ¼r bewÃÂÃÂ¤hrte Verfahren der Branche (GxP) in Bereichen wie Arzneimittelherstellung, -lagerung und -verteilung unterstÃÂÃÂ¼tzen. Infolgedessen beschleunigt Gilead seine PlÃÂÃÂ¤ne zur AufrÃÂÃÂ¼stung seines IT-Betriebs mit AWS und vermeidet gleichzeitig die Vorlaufkosten fÃÂÃÂ¼r die Aktualisierung der Hardware und die anhaltenden Kosten fÃÂÃÂ¼r den Betrieb einer ÃÂÃÂAlways-OnÃÂÃÂ, lokalen IT-Landschaft, die fÃÂÃÂ¼r Spitzenlasten bereitgestellt wird. Als zusÃÂÃÂ¤tzliches Element der Migration baut das Unternehmen eine automatisierte Notfallwiederherstellungslandschaft in AWS auf. Auf diese Weise kann Gilead IT seine Notfallwiederherstellungsprozesse in der Cloud optimieren und skalieren, um die Ausfallsicherheit zu erhÃÂÃÂ¶hen. Mithilfe von AWS Professional Services und AWS-Experten im Gesundheitswesen und in den Biowissenschaften suchen die Forschungs- und Entwicklungsteams von Gilead nach MÃÂÃÂ¶glichkeiten fÃÂÃÂ¼r Innovationen in der Cloud. Sie verfolgen einen agilen Produktentwicklungsansatz, der mithilfe von Microservices betriebliche Prozesse im gesamten Unternehmen optimiert und automatisiert, und bauen neue Datenarchitekturen auf, um leichter neue Erkenntnisse zu gewinnen. Durch die Zusammenarbeit zielt Gilead darauf ab, vorrangige Bereiche wie das klinische Programm- und Studiendesign, die Patientenerfahrung und die zentralisierte statistische adaptive ÃÂÃÂberwachung zu verÃÂÃÂ¤ndern, die Gilead dabei hilft, potenzielle Probleme im Zusammenhang mit dem Management klinischer Studien schnell zu erkennen und zu beheben. Gilead war auch einer der ersten Benutzer von AWS for Health, einem Angebot von kuratierten AWS-Services und AWS Partner Network (APN)-LÃÂÃÂ¶sungen, die heute von Tausenden von Kunden aus dem Gesundheitswesen und den Biowissenschaften weltweit verwendet werden. AWS for Health bietet bewÃÂÃÂ¤hrte und leicht zugÃÂÃÂ¤ngliche Funktionen, die Unternehmen dabei helfen, das Innovationstempo zu steigern, das Potenzial von Gesundheitsdaten zu erschlieÃÂÃÂen und personalisiertere AnsÃÂÃÂ¤tze fÃÂÃÂ¼r die therapeutische Entwicklung und Versorgung in 16 kritischen LÃÂÃÂ¶sungsbereichen in den Bereichen Gesundheitswesen, Genomik und Biopharma zu entwickeln. ÃÂÃÂGilead nutzt die bewÃÂÃÂ¤hrte Leistung der weltweit fÃÂÃÂ¼hrenden Cloud, um innovative, skalierbare und leistungsstarke Therapien fÃÂÃÂ¼r Krankheiten wie HIV und Krebs sowie fortschrittliche Standards fÃÂÃÂ¼r die PrÃÂÃÂ¤zisionsmedizin bereitzustellen. Durch die Rationalisierung des IT-Betriebs mit AWS und die Nutzung unserer AWS for Health-Angebote hat Gilead die MÃÂÃÂ¶glichkeit, seinen Ansatz fÃÂÃÂ¼r klinische Studien, Arzneimittelentwicklung, Herstellung und Vertrieb kontinuierlich zu verfeinernÃÂÃÂ, sagte Matt Garman, Senior Vice President of Sales and Marketing bei Amazon Web Services, Inc. ÃÂÃÂAWS bietet die Sicherheit und den Datenschutz, die Unternehmen aus dem Gesundheitswesen und den Biowissenschaften benÃÂÃÂ¶tigen, sowie das Fachwissen und die Breite und Tiefe der Dienstleistungen, auf die sie sich verlassen kÃÂÃÂ¶nnen, um transformative GesundheitslÃÂÃÂ¶sungen zu entwickeln, die Gesundheit und Wohlbefinden verbessern.ÃÂÃÂ ÃÂÃÂber Amazon Web Services Amazon Web Services ist seit ÃÂÃÂ¼ber 15 Jahren das umfassendste und am weitesten verbreitete Cloud-Angebot der Welt. AWS hat seine Services kontinuierlich erweitert, um nahezu jeden Cloud-Workload zu unterstÃÂÃÂ¼tzen, und verfÃÂÃÂ¼gt heute ÃÂÃÂ¼ber mehr als 200 voll funktionsfÃÂÃÂ¤hige Services in den Bereichen Rechenleistung, Datenspeicher, Datenbanken, Netzwerke, Analytik, maschinelles Lernen und kÃÂÃÂ¼nstliche Intelligenz (KI), Internet der Dinge (IoT), MobilitÃÂÃÂ¤t, Sicherheit, Hybrid, virtuelle und erweiterte RealitÃÂÃÂ¤t (VR und AR), Medien sowie Anwendungsentwicklung, -bereitstellung und -verwaltung aus 81 VerfÃÂÃÂ¼gbarkeitszonen in 25 geografischen Regionen, mit angekÃÂÃÂ¼ndigten PlÃÂÃÂ¤nen fÃÂÃÂ¼r 27 weitere VerfÃÂÃÂ¼gbarkeitszonen und neun weitere AWS-Regionen in Australien, Kanada, Indien, Indonesien, Israel, Neuseeland, Spanien, der Schweiz und den Vereinigten Arabischen Emiraten. Millionen von Kunden ÃÂÃÂ darunter die wachstumsstÃÂÃÂ¤rksten Start-ups, die grÃÂÃÂ¶ÃÂÃÂten Konzerne und fÃÂÃÂ¼hrende RegierungsbehÃÂÃÂ¶rden ÃÂÃÂ verlassen sich auf AWS, um ihre Infrastruktur anzutreiben, agiler zu werden und Kosten zu senken. Mehr Informationen zu AWS erhalten Sie unter aws.amazon.com. ÃÂÃÂber Amazon Amazon orientiert sich an vier GrundsÃÂÃÂ¤tzen: Orientierung am Kunden statt an der Konkurrenz, Leidenschaft fÃÂÃÂ¼r Neuerungen, Einsatz fÃÂÃÂ¼r betriebliche Optimierung sowie langfristiges Denken. Amazon strebt danach, das kundenorientierteste Unternehmen der Welt, der beste Arbeitgeber der Welt und der sicherste Arbeitsplatz der Welt zu sein. Kundenrezensionen, 1-Klick-EinkÃÂÃÂ¤ufe, personalisierte Empfehlungen, Prime, Versand durch Amazon, AWS, Kindle Direct Publishing, Kindle, Career Choice, Fire-Tablets, Fire TV, Amazon Echo, Alexa, Just Walk Out-Technologie, Amazon Studios und The Climate Pledge sind einige der Pionierleistungen von Amazon. FÃÂÃÂ¼r weitere Informationen besuchen Sie amazon.com/about und folgen Sie @AmazonNews. ÃÂÃÂber Gilead Sciences, Inc. Gilead Sciences, Inc. ist ein biopharmazeutisches Unternehmen, das seit mehr als drei Jahrzehnten DurchbrÃÂÃÂ¼che in der Medizin verfolgt und erzielt hat, mit dem Ziel, eine gesÃÂÃÂ¼ndere Welt fÃÂÃÂ¼r alle Menschen zu schaffen. Das Unternehmen engagiert sich fÃÂÃÂ¼r die Weiterentwicklung innovativer Medikamente zur Vorbeugung und Behandlung lebensbedrohlicher Krankheiten wie HIV, Virushepatitis und Krebs. Gilead ist seit mehr als 30 Jahren ein fÃÂÃÂ¼hrender Innovator im Bereich HIV und treibt Fortschritte in der Behandlung, PrÃÂÃÂ¤vention und Heilungsforschung voran. Gilead-Forscher haben elf HIV-Medikamente entwickelt, darunter die erste Einzeltablette zur Behandlung von HIV und die erste einmal tÃÂÃÂ¤glich oral einzunehmende antiretrovirale Tablette zur PrÃÂÃÂ¤expositionsprophylaxe (PrEP), um das Risiko einer HIV-Infektion zu verringern. Diese Fortschritte in der medizinischen Forschung haben dazu beigetragen, HIV fÃÂÃÂ¼r Millionen von Menschen in eine vermeidbare, chronische Erkrankung zu verwandeln. Gilead setzt sich fÃÂÃÂ¼r kontinuierliche wissenschaftliche Innovationen ein, um LÃÂÃÂ¶sungen fÃÂÃÂ¼r die sich entwickelnden BedÃÂÃÂ¼rfnisse von Menschen mit HIV auf der ganzen Welt bereitzustellen. Durch Partnerschaften und Kooperationen zielt das Unternehmen auch darauf ab, die Bildung zu verbessern, den Zugang zu erweitern und Hindernisse bei der Versorgung zu beseitigen, mit dem Ziel, die HIV-Epidemie fÃÂÃÂ¼r alle und ÃÂÃÂ¼berall zu beenden. Gilead ist in ÃÂÃÂ¼ber 35 LÃÂÃÂ¤ndern weltweit tÃÂÃÂ¤tig und hat seinen Hauptsitz in Foster City im US-Bundesstaat Kalifornien. Die Ausgangssprache, in der der Originaltext verÃÂÃÂ¶ffentlicht wird, ist die offizielle und autorisierte Version. ÃÂÃÂbersetzungen werden zur besseren VerstÃÂÃÂ¤ndigung mitgeliefert. Nur die Sprachversion, die im Original verÃÂÃÂ¶ffentlicht wurde, ist rechtsgÃÂÃÂ¼ltig. Gleichen Sie deshalb ÃÂÃÂbersetzungen mit der originalen Sprachversion der VerÃÂÃÂ¶ffentlichung ab.",https://www.businesswire.com/news/home/20211130005507/de/,businesswire.com,5,seattlebusiness wiretoday amazon web service inc aws ein unternehmen von amazoncom inc nasdaq amzn gab bekannt das gilead science inc nasdaq gild ein biopharmazeutisches unternehmen da innovative medikamente zur vorbeugung und behandlung lebensbedrohlicher krankheiten entwickelt aws al bevorzugten cloudanbieter ausgewhlt hat preferred cloud provider mit awsinnovationen und mit hilfe von awsexperten und partnern au dem gesundheitswesen und den biowissenschaften bietet gilead seinen datenwissenschaftlern die neuesten fortschritte den bereichen maschinelles lernen und analyse diese fhigkeiten frdern die datengesteuerte entscheidungsfindung im gesamten unternehmen von der entdeckung von biomarkern ber die herstellung bi hin zur rekrutierung fr klinische studien und liefern erkenntnisse die gilead dabei helfen knnen seine medikamentenpipeline zu verfeinern da unternehmen verlsst sich auch auf aws um alle workload fr sein enterprise resource planning erptransformationsprojekt zur implementierung von sap shana zu hosten mit aws al unserem bevorzugten cloudanbieter knnen unsere forscher da awsserviceportfolio nutzen um die erkenntnisse flexibilitt und sicherheit zu gewinnen die fr die schnelle bereitstellung neuer medikamente erforderlich sind und den einzelnen gem seinen individuellen bedrfnissen zu behandeln nicht nur der krankheit sagte marc berson senior vice president und chief information officer bei gilead die leistung infrastruktur und gre von aws sind die grundlagen auf denen wir unsere erptransformation abschlieen und ein effizienteres agileres sichereres und datengesteuertes unternehmen der cloud werden gilead berarbeitet seine bioinformatikcomputinginfrastruktur der weltweit fhrenden cloud die nutzung der rechen maschinellen lern und datenbankfunktionen von aws wird die analyse und integration verschiedener genomik bildgebungs und experimentellen datenstze untersttzen um durchbrche bei der diagnose und behandlung von krankheiten durch gilead zu untersttzen durch die sichere analyse anonymisierter genomischer patientendaten groem mastab auf aws um muster aufzudecken kann gilead beispielsweise erkenntnisse darber gewinnen wie menschen mit krebs auf bestehende therapeutische optionen reagieren die entdeckung neuer behandlungsmethoden mglicherweise beschleunigt darber hinaus verwendet gilead seiner itorganisation aws zum hosten aller workload fr sein erptransformationsprojekt zur implementierung von sap shana diese systeme untersttzen geschftskritische prozesse bereichen wie lieferkette finanzen betrieb und kommerzieller vertrieb allen therapeutischen bereichen und geschftsbereichen die ausfhrung dieser prozesse auf aws bildet die grundlage fr gileads implementierung von sap shana e hilft dem unternehmen auch hardwareaktualisierungszyklen zu verkrzen die agilitt von test und bereitstellungen zu erhhen und transparenz zu gewinnen um die geschftsplanung zu verbessern dy ist gileads erste implementierung von erpsystemen im produktionsmastab der cloud und aws bietet dem ittransformationsteam de unternehmens eine skalierbare sichere und leistungsstarke infrastruktur zusammenarbeit mit aws wird gilead seine sapumgebungen mit einer breiten palette fortschrittlicher awstechnologien bereichen wie analyse und maschinelles lernen integrieren um den geschftswert aufzudecken und innovationen voranzutreiben zukunft wird da unternehmen mit aws al grundlage seiner neuen cloudbasierten sapumgebung eine vielzahl von amazon elastic compute cloudinstancetypen amazon ec verwenden dazu gehren x und xeinstanzen die fr hochleistungsdatenbanken inmemorydatenbanken und andere speicherintensive unternehmensanwendungen entwickelt wurden um erpworkloads effizienter auszufhren darber hinaus hat gilead den letzten monaten ber ein beschleunigtes cloudmigrationsprogramm mit aws professional service mehr al seiner rechenzentrumsflche zu aws verlagert da unternehmen plant auerdem hunderte von anwendungen zu aws zu migrieren darunter kritische anwendungen die die richtlinien und vorschriften fr bewhrte verfahren der branche gxp bereichen wie arzneimittelherstellung lagerung und verteilung untersttzen infolgedessen beschleunigt gilead seine plne zur aufrstung seine itbetriebs mit aws und vermeidet gleichzeitig die vorlaufkosten fr die aktualisierung der hardware und die anhaltenden kosten fr den betrieb einer alwayson lokalen itlandschaft die fr spitzenlasten bereitgestellt wird al zustzliches element der migration baut da unternehmen eine automatisierte notfallwiederherstellungslandschaft aws auf auf diese weise kann gilead seine notfallwiederherstellungsprozesse der cloud optimieren und skalieren um die ausfallsicherheit zu erhhen mithilfe von aws professional service und awsexperten im gesundheitswesen und den biowissenschaften suchen die forschungs und entwicklungsteams von gilead nach mglichkeiten fr innovationen der cloud sie verfolgen einen agilen produktentwicklungsansatz der mithilfe von microservices betriebliche prozesse im gesamten unternehmen optimiert und automatisiert und bauen neue datenarchitekturen auf um leichter neue erkenntnisse zu gewinnen durch die zusammenarbeit zielt gilead darauf ab vorrangige bereiche wie da klinische programm und studiendesign die patientenerfahrung und die zentralisierte statistische adaptive berwachung zu verndern die gilead dabei hilft potenzielle probleme im zusammenhang mit dem management klinischer studien schnell zu erkennen und zu beheben gilead war auch einer der ersten benutzer von aws health einem angebot von kuratierten awsservices und aws partner network apnlsungen die heute von tausenden von kunden au dem gesundheitswesen und den biowissenschaften weltweit verwendet werden aws health bietet bewhrte und leicht zugngliche funktionen die unternehmen dabei helfen da innovationstempo zu steigern da potenzial von gesundheitsdaten zu erschlieen und personalisiertere anstze fr die therapeutische entwicklung und versorgung kritischen lsungsbereichen den bereichen gesundheitswesen genomik und biopharma zu entwickeln gilead nutzt die bewhrte leistung der weltweit fhrenden cloud um innovative skalierbare und leistungsstarke therapien fr krankheiten wie hiv und krebs sowie fortschrittliche standard fr die przisionsmedizin bereitzustellen durch die rationalisierung de itbetriebs mit aws und die nutzung unserer aws healthangebote hat gilead die mglichkeit seinen ansatz fr klinische studien arzneimittelentwicklung herstellung und vertrieb kontinuierlich zu verfeinern sagte matt garman senior vice president sale marketing bei amazon web service inc aws bietet die sicherheit und den datenschutz die unternehmen au dem gesundheitswesen und den biowissenschaften bentigen sowie da fachwissen und die breite und tiefe der dienstleistungen auf die sie sich verlassen knnen um transformative gesundheitslsungen zu entwickeln die gesundheit und wohlbefinden verbessern ber amazon web service amazon web service ist seit ber jahren da umfassendste und weitesten verbreitete cloudangebot der welt aws hat seine service kontinuierlich erweitert um nahezu jeden cloudworkload zu untersttzen und verfgt heute ber mehr al voll funktionsfhige service den bereichen rechenleistung datenspeicher datenbanken netzwerke analytik maschinelles lernen und knstliche intelligenz ki internet der dinge iot mobilitt sicherheit hybrid virtuelle und erweiterte realitt vr und ar medien sowie anwendungsentwicklung bereitstellung und verwaltung au verfgbarkeitszonen geografischen regionen mit angekndigten plnen fr weitere verfgbarkeitszonen und neun weitere awsregionen australien kanada indien indonesien israel neuseeland spanien der schweiz und den vereinigten arabischen emiraten millionen von kunden darunter die wachstumsstrksten startup die grten konzerne und fhrende regierungsbehrden verlassen sich auf aws um ihre infrastruktur anzutreiben agiler zu werden und kosten zu senken mehr informationen zu aws erhalten sie unter awsamazoncom ber amazon amazon orientiert sich vier grundstzen orientierung kunden statt der konkurrenz leidenschaft fr neuerungen einsatz fr betriebliche optimierung sowie langfristiges denken amazon strebt danach da kundenorientierteste unternehmen der welt der beste arbeitgeber der welt und der sicherste arbeitsplatz der welt zu sein kundenrezensionen klickeinkufe personalisierte empfehlungen prime versand durch amazon aws kindle direct publishing kindle career choice firetablets fire tv amazon echo alexa walk outtechnologie amazon studio und climate pledge sind einige der pionierleistungen von amazon fr weitere informationen besuchen sie amazoncomabout und folgen sie amazonnews ber gilead science inc gilead science inc ist ein biopharmazeutisches unternehmen da seit mehr al drei jahrzehnten durchbrche der medizin verfolgt und erzielt hat mit dem ziel eine gesndere welt fr alle menschen zu schaffen da unternehmen engagiert sich fr die weiterentwicklung innovativer medikamente zur vorbeugung und behandlung lebensbedrohlicher krankheiten wie hiv virushepatitis und krebs gilead ist seit mehr al jahren ein fhrender innovator im bereich hiv und treibt fortschritte der behandlung prvention und heilungsforschung voran gileadforscher haben elf hivmedikamente entwickelt darunter die erste einzeltablette zur behandlung von hiv und die erste einmal tglich oral einzunehmende antiretrovirale tablette zur prexpositionsprophylaxe prep um da risiko einer hivinfektion zu verringern diese fortschritte der medizinischen forschung haben dazu beigetragen hiv fr millionen von menschen eine vermeidbare chronische erkrankung zu verwandeln gilead setzt sich fr kontinuierliche wissenschaftliche innovationen ein um lsungen fr die sich entwickelnden bedrfnisse von menschen mit hiv auf der ganzen welt bereitzustellen durch partnerschaften und kooperationen zielt da unternehmen auch darauf ab die bildung zu verbessern den zugang zu erweitern und hindernisse bei der versorgung zu beseitigen mit dem ziel die hivepidemie fr alle und berall zu beenden gilead ist ber lndern weltweit ttig und hat seinen hauptsitz foster city im usbundesstaat kalifornien die ausgangssprache der der originaltext verffentlicht wird ist die offizielle und autorisierte version bersetzungen werden zur besseren verstndigung mitgeliefert nur die sprachversion die im original verffentlicht wurde ist rechtsgltig gleichen sie deshalb bersetzungen mit der originalen sprachversion der verffentlichung ab,-0.9997,-0.49985,0.2611708889,-0.761020889,Negative Impact
01/12/2021,177.25,177.99,172.08,172.19,172.19,74916000,3.3,50.56966791,1.192,0,13.66057312,0.8419472675,0.2413396506,0.08,278.802,15254.0498,16133.88965,7168.700195,6881.870117,3576.889893,57684.78906,20464.59961,170.8615302,167.5918201,173.0651136,167.1267204,176.7071243,183.9474755,169.4667732,46.93415559,1.469794712,2.298746064,-0.828951352,4.737966265,185.9442693,10657220000,0.6613809505,18.68447716,31.12000084,AWS unterstÃÂÃÂ¼tzt Roche bei der Nutzung von Gesundheitsdaten in groÃÂÃÂem MaÃÂÃÂstab,"SEATTLE--(BUSINESS WIRE)--Amazon Web Services (AWS), ein Unternehmen von Amazon.com, Inc. (Nasdaq: AMZN), hat heute bekannt gegeben, dass die Roche-Gruppe (SIX: RO, ROG; OTCQX: RHHBY) fÃÂÃÂ¼r die meisten Cloud-Workloads auf AWS zurÃÂÃÂ¼ckgreift, um einen grÃÂÃÂ¶ÃÂÃÂeren Nutzen aus ihren Gesundheitsdaten herauszuholen. Der Konzern nutzt die EinsatzmÃÂÃÂ¶glichkeiten von AWS in Bereichen wie Hochleistungsrechnen, Analytik, maschinelles Lernen, Datenbanken, Speicherung und Sicherheit, um die Erforschung und Entwicklung von Arzneimitteln voranzutreiben und Gesundheitsdaten im groÃÂÃÂen MaÃÂÃÂstab zu verarbeiten, damit eine hochwertige, auf individuelle Patienten zugeschnittene Versorgung gewÃÂÃÂ¤hrleistet werden kann. Roche arbeitet zudem mit AWS Professional Services an der Integration seiner Informationstechnik- bzw. IT-Systeme, sodass Daten je nach Bedarf sowohl innerhalb des Unternehmens als auch mit wichtigen externen Interessenvertretern wie akademischen Institutionen, AufsichtsbehÃÂÃÂ¶rden und medizinischen Leistungserbringern auf sichere Art und Weise ausgetauscht werden kÃÂÃÂ¶nnen und Roche dabei alle Gesetze und Vorschriften zum Schutz der PrivatsphÃÂÃÂ¤re der Patienten einhÃÂÃÂ¤lt. Die sichere Infrastruktur und das Serviceportfolio von AWS bilden die Grundlage des Programms von Roche fÃÂÃÂ¼r eine personalisierte Gesundheitsversorgung. WÃÂÃÂ¤hrend biopharmazeutische Unternehmen seit ÃÂÃÂ¼ber zwei Jahrzehnten eine Personalisierung der Medizin verfolgen, haben Fortschritte bei Daten, Analytik und digitaler Technologie das Gesundheitswesen erst vor Kurzem in die Lage versetzt, einen grundlegenden Wandel herbeizufÃÂÃÂ¼hren. Roche nutzt Analyse- und Datenbankdienste von AWS wie Amazon OpenSearch Service (den Service von AWS fÃÂÃÂ¼r die Suche, Darstellung und Analyse von Text- und unstrukturierten Daten von bis zu Petabyte-GrÃÂÃÂ¶ÃÂÃÂe) und Amazon Aurora (die mit MySQL und PostgreSQL kompatible relationale Datenbank von AWS fÃÂÃÂ¼r die Cloud), um aus seinen GeschÃÂÃÂ¤fts-, Forschungs-, Klinik-, digitalen Gesundheits- und Patientendaten aus der Praxis umsetzbare Erkenntnisse zu gewinnen. Mit AWS kann Roche Gesundheitsdaten im Zusammenhang mit Erbgut oder Gesundheitszustand von Patienten sowie Wirksamkeit und Wechselwirkung von Medikamenten in groÃÂÃÂem MaÃÂÃÂstab prÃÂÃÂ¼fen und strukturierte BestÃÂÃÂ¤nde von Patientendaten analysieren, die von Roche zum Schutz der PrivatsphÃÂÃÂ¤re der Patienten anonymisiert und aggregiert wurden. Diese MÃÂÃÂ¶glichkeit verleiht den Forschern von Roche ein vertiefteres VerstÃÂÃÂ¤ndnis der biologischen Merkmale grÃÂÃÂ¶ÃÂÃÂerer Patientenpopulationen und kann ihnen bei der Feststellung von Muster- und SonderfÃÂÃÂ¤llen helfen, die in die Entwicklung von Diagnostika und Behandlungen einflieÃÂÃÂen. ÃÂÃÂMit tiefgreifenden Fortschritten bei Daten, Analytik und digitalen Technologien verÃÂÃÂ¤ndern wird die Art und Weise, wie Medikamente erforscht, entwickelt und zur Behandlung von Patienten eingesetzt werden, grundlegend. AWS liefert uns hochleistungsfÃÂÃÂ¤hige und sichere Cloud-LÃÂÃÂ¶sungen, die uns bei der Nutzung von Daten zur Verbesserung der LebensqualitÃÂÃÂ¤t von Patienten behilflich sindÃÂÃÂ, so Dr. Alan Hippe, CFO und CIO der Roche-Gruppe. ÃÂÃÂMit AWS fÃÂÃÂ¼hren wir Gesundheitsdaten auf neue Weise zusammen, um Krankheiten besser entdecken, diagnostizieren, behandeln und ÃÂÃÂ¼berwachen zu kÃÂÃÂ¶nnen, sodass wir im Umgang mit diesen Krankheiten zugunsten der Patienten effektiver und effizienter werden kÃÂÃÂ¶nnen. Roche hÃÂÃÂ¤lt alle geltenden Datenschutzgesetze ein ÃÂÃÂ so beispielsweise das schweizerische Bundesgesetz ÃÂÃÂ¼ber den Datenschutz, die europÃÂÃÂ¤ische Datenschutz-Grundverordnung (DSGVO), das US-amerikanische HIPAA-Gesetz (Health Insurance Portability and Accountability Act), das chinesische Cybersicherheitsgesetz und die damit zusammenhÃÂÃÂ¤ngende Datenschutznorm.ÃÂÃÂ AWS steht hinter dem Einsatz von digitalen Technologien wie Smartphone-Apps bei Roche, die medizinische FachkrÃÂÃÂ¤fte dabei unterstÃÂÃÂ¼tzen, eine individuell zugeschnittene Versorgung bereitzustellen, und den Patienten die Gelegenheit bieten, eine Rolle in ihrer eigenen Gesundheitsversorgung zu ÃÂÃÂ¼bernehmen. Dienste von AWS wie etwa AWS Lambda (ein ereignisgesteuerter Serverless-Computing-Dienst), Amazon Elastic Kubernetes Service (Amazon EKS) und Amazon SageMaker (AWS-Dienst, der Entwicklern und Datenwissenschaftlern dabei hilft, Modelle mit maschinellem Lernen rasch zu erstellen, zu trainieren und einzusetzen) machen es mÃÂÃÂ¶glich, dass Roche ÃÂÃÂ¼ber Smart Devices erfasste Gesundheitsdaten aufnehmen, speichern, verarbeiten und rasch analysieren kann. So hat Roche beispielsweise die App mySugr auf AWS abgestellt, um Daten wie Blutzuckermessungen von Patienten mit Diabetes auf sichere Weise zu aggregieren und zu analysieren. Roche nutzt diese App, um Daten von intelligenten Messsystemen automatisch zu ÃÂÃÂ¼bernehmen und zu analysieren, sodass der Zeitplan und die Dosis bei der Medikamenteneinnahme von Patienten besser bestimmt werden kann. Bei sÃÂÃÂ¤mtlichen digitalen Gesundheitsanwendungen erfasst und analysiert Roche kontinuierlich und auf sichere Weise die Gesundheitsdaten von Patienten in der Cloud und ermÃÂÃÂ¶glicht Patienten und ihren Gesundheitsdienstleistern dadurch ein zeitnÃÂÃÂ¤heres und prÃÂÃÂ¤ziseres VerstÃÂÃÂ¤ndnis in Bezug auf den Verlauf von Krankheiten sowie ihr Ansprechen auf Behandlungen. Roche nutzt ÃÂÃÂ¼berdies die skalierbaren HochleistungsrechenkapazitÃÂÃÂ¤ten von AWS zusammen mit Container- und Analysediensten wie Amazon Redshift (dem Data-Warehouse-Dienst von AWS in der Cloud), um Erkenntnisse aus den genomischen Daten von mehr als 300.000 Krebspatienten aus aller Welt zu gewinnen. Diese Daten in einer GrÃÂÃÂ¶ÃÂÃÂenordnung von Dutzenden von Petabytes werden mit der Einwilligung der Patienten und unter Einhaltung der Datenschutzbestimmungen auf sichere Weise verarbeitet. Roche verwendet Amazon FSx for Lustre (einen AWS-Dienst, der kostengÃÂÃÂ¼nstigen, leistungsstarken und skalierbaren Speicher fÃÂÃÂ¼r Datenverarbeitungs-Workloads bietet), um diese genomischen Daten zu speichern und schnell fÃÂÃÂ¼r die Analyse verfÃÂÃÂ¼gbar zu machen. Mit der UnterstÃÂÃÂ¼tzung von AWS erweitert Roche seine Wissensgrundlage in Bezug auf Krebserkrankungen laufend, sodass zukÃÂÃÂ¼nftige FÃÂÃÂ¤lle immer schneller bestimmt werden kÃÂÃÂ¶nnen. Roche steigert den Nutzen von BemÃÂÃÂ¼hungen im Bereich der Tumorprofilierung durch Erkenntnisse aus aggregierten elektronischen Krankenakten von Patienten, die mithilfe von AWS verarbeitet werden. Die Anwendungen fÃÂÃÂ¼r Analytik, maschinelles Lernen, Speicher und verwaltete Datenbanken von Roche laufen alle ÃÂÃÂ¼ber AWS, wobei hochwertige Daten von mehr als drei Millionen elektronischen Krankenakten extrahiert und standardisiert werden, um anonymisierte DatensÃÂÃÂ¤tze von realen Patienten zu erstellen. Dies umfasst onkologische Daten und andere geschÃÂÃÂ¼tzte Gesundheitsinformationen in einer GrÃÂÃÂ¶ÃÂÃÂenordnung von mehreren Petabytes, die von den Forschern bei Roche genutzt werden und in die Gestaltung von klinischen Studien einflieÃÂÃÂen. ÃÂÃÂIndem AWS hinter den BemÃÂÃÂ¼hungen von Roche in Forschung, Entwicklung und Gesundheitsversorgung steht, kann der Konzern zeitnahe und maÃÂÃÂgebliche Daten einsetzen, mit deren Hilfe die Wissenschaftler bei ihrer Zusammenarbeit besser geschÃÂÃÂ¼tzt sind und wirkungsvoller agieren, die Forscher effizientere klinische Studien konzipieren, die Gesundheitsdienstleister prÃÂÃÂ¤zisere Entscheidungen treffen und die Patienten vermehrt die Kontrolle ÃÂÃÂ¼ber ihre Gesundheit ÃÂÃÂ¼bernehmen kÃÂÃÂ¶nnenÃÂÃÂ, so Kathrin Renz, Vorstand des Bereichs Business Development and Industries bei Amazon Web Services. ÃÂÃÂAWS hilft dem Gesundheitswesen und den Biowissenschaften dabei, die Schwelle zur personalisierten Medizin zu ÃÂÃÂ¼berschreiten, den Zeit- und Kostenaufwand fÃÂÃÂ¼r klinische Studien zu senken und die Behandlungsergebnisse der Patienten durch digitale GesundheitslÃÂÃÂ¶sungen zu verbessern. Mit AWS wandelt Roche komplexe Gesundheitsdaten von einem Hindernis in ein Hilfsmittel um und reduziert die Zeitdauer, bis den Patienten neue Medikamente ausgehÃÂÃÂ¤ndigt werden kÃÂÃÂ¶nnen.ÃÂÃÂ ÃÂÃÂber Amazon Web Services Seit ÃÂÃÂ¼ber 15 Jahren bietet Amazon Web Services das umfassendste und am weitesten verbreitete Cloud-Angebot der Welt. AWS hat seine Services kontinuierlich erweitert, um nahezu jeden Cloud-Workload zu unterstÃÂÃÂ¼tzen, und verfÃÂÃÂ¼gt heute ÃÂÃÂ¼ber mehr als 200 voll funktionsfÃÂÃÂ¤hige Services in den Bereichen Rechenleistung, Datenspeicher, Datenbanken, Netzwerke, Analytik, maschinelles Lernen und kÃÂÃÂ¼nstliche Intelligenz (KI), Internet der Dinge (IoT), MobilitÃÂÃÂ¤t, Sicherheit, Hybrid, virtuelle und erweiterte RealitÃÂÃÂ¤t (VR und AR), Medien sowie Anwendungsentwicklung, -bereitstellung und -verwaltung aus 81 VerfÃÂÃÂ¼gbarkeitszonen in 25 geografischen Regionen, mit angekÃÂÃÂ¼ndigten PlÃÂÃÂ¤nen fÃÂÃÂ¼r 27 weitere VerfÃÂÃÂ¼gbarkeitszonen und 9 weitere AWS-Regionen in Australien, Kanada, Indien, Indonesien, Israel, Neuseeland, Spanien, der Schweiz und den Vereinigten Arabischen Emiraten. Millionen von Kunden ÃÂÃÂ darunter die wachstumsstÃÂÃÂ¤rksten Start-ups, die grÃÂÃÂ¶ÃÂÃÂten Konzerne und fÃÂÃÂ¼hrende RegierungsbehÃÂÃÂ¶rden ÃÂÃÂ verlassen sich auf AWS, um ihre Infrastruktur anzutreiben, agiler zu werden und Kosten zu senken. Weitere Informationen zu AWS erhalten Sie unter aws.amazon.com. ÃÂÃÂber Amazon Amazon orientiert sich an vier GrundsÃÂÃÂ¤tzen: Orientierung am Kunden statt an der Konkurrenz, Leidenschaft fÃÂÃÂ¼r Neuerungen, Einsatz fÃÂÃÂ¼r betriebliche Optimierung sowie langfristiges Denken. Amazon strebt danach, das kundenorientierteste Unternehmen der Welt, der beste Arbeitgeber der Welt und der sicherste Arbeitsplatz der Welt zu sein. Kundenrezensionen, 1-Klick-EinkÃÂÃÂ¤ufe, personalisierte Empfehlungen, Prime, Versand durch Amazon, AWS, Kindle Direct Publishing, Kindle, Career Choice, Fire-Tablets, Fire TV, Amazon Echo, Alexa, ÃÂÃÂJust Walk OutÃÂÃÂ-Technologie, Amazon Studios und The Climate Pledge sind einige der Pionierleistungen von Amazon. FÃÂÃÂ¼r weitere Informationen besuchen Sie amazon.com/about und folgen Sie @AmazonNews. Die Ausgangssprache, in der der Originaltext verÃÂÃÂ¶ffentlicht wird, ist die offizielle und autorisierte Version. ÃÂÃÂbersetzungen werden zur besseren VerstÃÂÃÂ¤ndigung mitgeliefert. Nur die Sprachversion, die im Original verÃÂÃÂ¶ffentlicht wurde, ist rechtsgÃÂÃÂ¼ltig. Gleichen Sie deshalb ÃÂÃÂbersetzungen mit der originalen Sprachversion der VerÃÂÃÂ¶ffentlichung ab.",https://www.businesswire.com/news/home/20211130006208/de/,businesswire.com,5,seattlebusiness wireamazon web service aws ein unternehmen von amazoncom inc nasdaq amzn hat heute bekannt gegeben das die rochegruppe six ro rog otcqx rhhby fr die meisten cloudworkloads auf aws zurckgreift um einen greren nutzen au ihren gesundheitsdaten herauszuholen der konzern nutzt die einsatzmglichkeiten von aws bereichen wie hochleistungsrechnen analytik maschinelles lernen datenbanken speicherung und sicherheit um die erforschung und entwicklung von arzneimitteln voranzutreiben und gesundheitsdaten im groen mastab zu verarbeiten damit eine hochwertige auf individuelle patienten zugeschnittene versorgung gewhrleistet werden kann roche arbeitet zudem mit aws professional service der integration seiner informationstechnik bzw itsysteme sodass daten je nach bedarf sowohl innerhalb de unternehmens al auch mit wichtigen externen interessenvertretern wie akademischen institutionen aufsichtsbehrden und medizinischen leistungserbringern auf sichere art und weise ausgetauscht werden knnen und roche dabei alle gesetze und vorschriften zum schutz der privatsphre der patienten einhlt die sichere infrastruktur und da serviceportfolio von aws bilden die grundlage de programms von roche fr eine personalisierte gesundheitsversorgung whrend biopharmazeutische unternehmen seit ber zwei jahrzehnten eine personalisierung der medizin verfolgen haben fortschritte bei daten analytik und digitaler technologie da gesundheitswesen erst vor kurzem die lage versetzt einen grundlegenden wandel herbeizufhren roche nutzt analyse und datenbankdienste von aws wie amazon opensearch service den service von aws fr die suche darstellung und analyse von text und unstrukturierten daten von bi zu petabytegre und amazon aurora die mit mysql und postgresql kompatible relationale datenbank von aws fr die cloud um au seinen geschfts forschungs klinik digitalen gesundheits und patientendaten au der praxis umsetzbare erkenntnisse zu gewinnen mit aws kann roche gesundheitsdaten im zusammenhang mit erbgut oder gesundheitszustand von patienten sowie wirksamkeit und wechselwirkung von medikamenten groem mastab prfen und strukturierte bestnde von patientendaten analysieren die von roche zum schutz der privatsphre der patienten anonymisiert und aggregiert wurden diese mglichkeit verleiht den forschern von roche ein vertiefteres verstndnis der biologischen merkmale grerer patientenpopulationen und kann ihnen bei der feststellung von muster und sonderfllen helfen die die entwicklung von diagnostika und behandlungen einflieen mit tiefgreifenden fortschritten bei daten analytik und digitalen technologien verndern wird die art und weise wie medikamente erforscht entwickelt und zur behandlung von patienten eingesetzt werden grundlegend aws liefert un hochleistungsfhige und sichere cloudlsungen die un bei der nutzung von daten zur verbesserung der lebensqualitt von patienten behilflich sind dr alan hippe cfo und cio der rochegruppe mit aws fhren wir gesundheitsdaten auf neue weise zusammen um krankheiten besser entdecken diagnostizieren behandeln und berwachen zu knnen sodass wir im umgang mit diesen krankheiten zugunsten der patienten effektiver und effizienter werden knnen roche hlt alle geltenden datenschutzgesetze ein beispielsweise da schweizerische bundesgesetz ber den datenschutz die europische datenschutzgrundverordnung dsgvo da usamerikanische hipaagesetz health insurance portability accountability act da chinesische cybersicherheitsgesetz und die damit zusammenhngende datenschutznorm aws steht hinter dem einsatz von digitalen technologien wie smartphoneapps bei roche die medizinische fachkrfte dabei untersttzen eine individuell zugeschnittene versorgung bereitzustellen und den patienten die gelegenheit bieten eine rolle ihrer eigenen gesundheitsversorgung zu bernehmen dienste von aws wie etwa aws lambda ein ereignisgesteuerter serverlesscomputingdienst amazon elastic kubernetes service amazon eks und amazon sagemaker awsdienst der entwicklern und datenwissenschaftlern dabei hilft modelle mit maschinellem lernen rasch zu erstellen zu trainieren und einzusetzen machen e mglich das roche ber smart device erfasste gesundheitsdaten aufnehmen speichern verarbeiten und rasch analysieren kann hat roche beispielsweise die app mysugr auf aws abgestellt um daten wie blutzuckermessungen von patienten mit diabetes auf sichere weise zu aggregieren und zu analysieren roche nutzt diese app um daten von intelligenten messsystemen automatisch zu bernehmen und zu analysieren sodass der zeitplan und die dosis bei der medikamenteneinnahme von patienten besser bestimmt werden kann bei smtlichen digitalen gesundheitsanwendungen erfasst und analysiert roche kontinuierlich und auf sichere weise die gesundheitsdaten von patienten der cloud und ermglicht patienten und ihren gesundheitsdienstleistern dadurch ein zeitnheres und prziseres verstndnis bezug auf den verlauf von krankheiten sowie ihr ansprechen auf behandlungen roche nutzt berdies die skalierbaren hochleistungsrechenkapazitten von aws zusammen mit container und analysediensten wie amazon redshift dem datawarehousedienst von aws der cloud um erkenntnisse au den genomischen daten von mehr al krebspatienten au aller welt zu gewinnen diese daten einer grenordnung von dutzenden von petabyte werden mit der einwilligung der patienten und unter einhaltung der datenschutzbestimmungen auf sichere weise verarbeitet roche verwendet amazon fsx lustre einen awsdienst der kostengnstigen leistungsstarken und skalierbaren speicher fr datenverarbeitungsworkloads bietet um diese genomischen daten zu speichern und schnell fr die analyse verfgbar zu machen mit der untersttzung von aws erweitert roche seine wissensgrundlage bezug auf krebserkrankungen laufend sodass zuknftige flle immer schneller bestimmt werden knnen roche steigert den nutzen von bemhungen im bereich der tumorprofilierung durch erkenntnisse au aggregierten elektronischen krankenakten von patienten die mithilfe von aws verarbeitet werden die anwendungen fr analytik maschinelles lernen speicher und verwaltete datenbanken von roche laufen alle ber aws wobei hochwertige daten von mehr al drei millionen elektronischen krankenakten extrahiert und standardisiert werden um anonymisierte datenstze von realen patienten zu erstellen dy umfasst onkologische daten und andere geschtzte gesundheitsinformationen einer grenordnung von mehreren petabyte die von den forschern bei roche genutzt werden und die gestaltung von klinischen studien einflieen indem aws hinter den bemhungen von roche forschung entwicklung und gesundheitsversorgung steht kann der konzern zeitnahe und magebliche daten einsetzen mit deren hilfe die wissenschaftler bei ihrer zusammenarbeit besser geschtzt sind und wirkungsvoller agieren die forscher effizientere klinische studien konzipieren die gesundheitsdienstleister przisere entscheidungen treffen und die patienten vermehrt die kontrolle ber ihre gesundheit bernehmen knnen kathrin renz vorstand de bereichs business development industry bei amazon web service aws hilft dem gesundheitswesen und den biowissenschaften dabei die schwelle zur personalisierten medizin zu berschreiten den zeit und kostenaufwand fr klinische studien zu senken und die behandlungsergebnisse der patienten durch digitale gesundheitslsungen zu verbessern mit aws wandelt roche komplexe gesundheitsdaten von einem hindernis ein hilfsmittel um und reduziert die zeitdauer bi den patienten neue medikamente ausgehndigt werden knnen ber amazon web service seit ber jahren bietet amazon web service da umfassendste und weitesten verbreitete cloudangebot der welt aws hat seine service kontinuierlich erweitert um nahezu jeden cloudworkload zu untersttzen und verfgt heute ber mehr al voll funktionsfhige service den bereichen rechenleistung datenspeicher datenbanken netzwerke analytik maschinelles lernen und knstliche intelligenz ki internet der dinge iot mobilitt sicherheit hybrid virtuelle und erweiterte realitt vr und ar medien sowie anwendungsentwicklung bereitstellung und verwaltung au verfgbarkeitszonen geografischen regionen mit angekndigten plnen fr weitere verfgbarkeitszonen und weitere awsregionen australien kanada indien indonesien israel neuseeland spanien der schweiz und den vereinigten arabischen emiraten millionen von kunden darunter die wachstumsstrksten startup die grten konzerne und fhrende regierungsbehrden verlassen sich auf aws um ihre infrastruktur anzutreiben agiler zu werden und kosten zu senken weitere informationen zu aws erhalten sie unter awsamazoncom ber amazon amazon orientiert sich vier grundstzen orientierung kunden statt der konkurrenz leidenschaft fr neuerungen einsatz fr betriebliche optimierung sowie langfristiges denken amazon strebt danach da kundenorientierteste unternehmen der welt der beste arbeitgeber der welt und der sicherste arbeitsplatz der welt zu sein kundenrezensionen klickeinkufe personalisierte empfehlungen prime versand durch amazon aws kindle direct publishing kindle career choice firetablets fire tv amazon echo alexa walk outtechnologie amazon studio und climate pledge sind einige der pionierleistungen von amazon fr weitere informationen besuchen sie amazoncomabout und folgen sie amazonnews die ausgangssprache der der originaltext verffentlicht wird ist die offizielle und autorisierte version bersetzungen werden zur besseren verstndigung mitgeliefert nur die sprachversion die im original verffentlicht wurde ist rechtsgltig gleichen sie deshalb bersetzungen mit der originalen sprachversion der verffentlichung ab,-0.9994,-0.4997,0.2641355172,-0.763835517,Negative Impact
02/12/2021,173,174.64,171.19,171.87,171.87,64726000,3.3,50.56966791,1.192,0,13.66057312,0.8419472675,0.2413396506,0.08,278.802,15381.32031,16475.25,7129.200195,6795.75,3573.840088,58461.28906,20762,170.91884,167.6191026,173.0181678,167.1738973,176.8405243,183.5794457,170.1016029,47.17487108,0.9895545334,2.036907758,-1.047353224,4.713608878,184.8351279,10592494000,4.021845682,7.910395654,27.95000076,Aurora treibt die Entwicklung des Aurora-Treibers mit AWS voran,"SEATTLE--(BUSINESS WIRE)--Heute hat Amazon Web Services, Inc. (AWS), ein Unternehmen von Amazon.com, Inc. (NASDAQ: AMZN), bekannt, dass Aurora (NASDAQ: AUR), ein fÃÂÃÂ¼hrendes Unternehmen im Bereich der selbstfahrenden Fahrzeugtechnologie, AWS als bevorzugten Cloud-Anbieter fÃÂÃÂ¼r den Einsatz von maschinellem Lernen und Cloud-basierten Simulationen ausgewÃÂÃÂ¤hlt hat. Aurora nutzt die bewÃÂÃÂ¤hrte Infrastruktur und das einzigartige Funktionsportfolio von AWS, um die Entwicklung des Aurora Driver, der skalierbaren Technologie fÃÂÃÂ¼r selbstfahrende Fahrzeuge, auf sichere Weise voranzutreiben. Der Aurora Driver besteht aus Sensoren, die die Welt erfassen, Software, die einen sicheren Weg durch diese Welt plant, und einem Computer, der die Hardware und Software von Aurora betreibt und in jegliche Fahrzeugplattform integriert. Aurora setzt fÃÂÃÂ¼r das Training von maschinellem Lernen und Cloud-basierte Simulationen vollstÃÂÃÂ¤ndig auf AWS und nutzt die Cloud zur Verarbeitung von Billionen von Datenpunkten pro Tag. Das Unternehmen skaliert jetzt seine Trainings-Workloads in der Cloud, um bis zum Ende des Jahres bis zu 12 Millionen physikalisch basierte Fahrsimulationen pro Tag durchzufÃÂÃÂ¼hren, die auf den Petabytes an Daten aufbauen, die bei realen StraÃÂÃÂentests gesammelt werden. Autonomes Fahren ist eine immens komplexe technologische Herausforderung, die stark auf Cloud-Computing angewiesen ist, um bahnbrechende Entwicklungen in den Bereichen Erkennung, Embedded Computing, maschinelles Lernen, Bewegungsplanung, Entscheidungsfindung und fortschrittliche Sensortechnologien zu ermÃÂÃÂ¶glichen. Mit den FÃÂÃÂ¤higkeiten von AWS in den Bereichen Hochleistungsdatenverarbeitung, maschinelles Lernen, Datenspeicherung und Sicherheit kann Aurora seine virtuellen Tests optimieren und skalieren, um die FÃÂÃÂ¤higkeiten des Aurora Driver sicher und schnell zu erweitern. ÃÂÃÂDie fortschrittlichen maschinellen Lernverfahren von Aurora und die Simulation im groÃÂÃÂen MaÃÂÃÂstab sind die Grundlage fÃÂÃÂ¼r die sichere und schnelle Entwicklung unserer Technologie. AWS liefert die hohe Performance, die wir zur Aufrechterhalten unserer Fortschritte benÃÂÃÂ¶tigenÃÂÃÂ, sagt Chris Urmson, CEO von Aurora. ÃÂÃÂDank seiner praktisch unbegrenzten Skalierbarkeit unterstÃÂÃÂ¼tzt AWS Millionen virtueller Tests, um die FÃÂÃÂ¤higkeiten des Aurora Driver zu validieren, damit er die zahllosen GrenzfÃÂÃÂ¤lle des realen Fahrens sicher bewÃÂÃÂ¤ltigen kann.ÃÂÃÂ Die AWS-gestÃÂÃÂ¼tzte Virtual Testing Suite von Aurora ist ein einzigartiger Entwicklungsbeschleuniger fÃÂÃÂ¼r den Aurora Driver. Aurora kann Daten aus einer einzigen Testsituation, die in der realen Welt beobachtet wird, verwenden, um Hunderte von Permutationen in der Virtual Testing Suite zu beeinflussen. Diese virtuellen Tests helfen dem Aurora Driver dabei, schnell und sicher in komplexen Situationen zu navigieren, z. B. bei StraÃÂÃÂenbauarbeiten, FuÃÂÃÂgÃÂÃÂ¤ngern und ungesichertem Linksabbiegen. Bevor der Aurora Driver zum Beispiel ein ungesichertes Linksabbiegen auf einer realen StraÃÂÃÂe ausprobieren konnte, absolvierte er fast 2,3 Millionen AbbiegevorgÃÂÃÂ¤nge in der Simulation ÃÂÃÂ was schÃÂÃÂ¤tzungsweise 20.000 Stunden Fahrpraxis in der RealitÃÂÃÂ¤t entspricht. Aurora betreibt seit 2019 Simulationen in groÃÂÃÂem MaÃÂÃÂstab auf AWS und plant, das Volumen der auf AWS ausgefÃÂÃÂ¼hrten Simulationen bis Ende 2021 auf mehr als 12 Millionen pro Tag zu verdreifachen. Die Offline-Komponenten des ÃÂÃÂAurora DriverÃÂÃÂ-Software-Stacks laufen alle auf AWS, einschlieÃÂÃÂlich der Virtual Testing Suite, hochauflÃÂÃÂ¶sender StraÃÂÃÂenkarten (der Aurora-ÃÂÃÂAtlasÃÂÃÂ), maschineller Lernmodelle und Softwareentwicklungstools. Aurora verwendet beispielsweise Amazon SageMaker (einen AWS-Service, der Entwicklern und Datenwissenschaftlern beim schnellen Erstellen, Trainieren und Bereitstellen von maschinellen Lernmodellen hilft), um die maschinellen Lernmodelle zu erstellen, laufen zu lassen und kontinuierlich zu verfeinern, die die Fahrsimulationen ermÃÂÃÂ¶glichen. Mit diesem Service greift Aurora auf Instanztypen von Amazon Elastic Compute Cloud (Amazon EC2) wie P4d zu, die die beste Performance fÃÂÃÂ¼r das Training maschineller Lernverfahren in der Cloud bieten. Vor der Entwicklung von Simulationen nutzt Aurora AWS, um die Petabytes an Daten, die wÃÂÃÂ¤hrend der realen Tests aufgezeichnet werden, auf sichere Weise zu speichern und zu verarbeiten, und trainiert dann die maschinellen Lernmodelle anhand dieser Daten. Die Vorverarbeitungs-Workloads laufen auf dem Amazon Elastic Kubernetes Service (Amazon EKS) und Amazon EMR, dem AWS-Service fÃÂÃÂ¼r die Verarbeitung groÃÂÃÂer Datenmengen in der Cloud mit Open-Source-Tools. Die Aurora-Trainingslasten fÃÂÃÂ¼r das maschinelle Lernen basieren dann auf AWS-optimierten Deep-Learning-Frameworks wie TensorFlow und PyTorch. AbschlieÃÂÃÂend orchestriert und skaliert Aurora seine Simulationsworkflows automatisch ÃÂÃÂ¼ber Hunderttausende von parallelen vCPUs und Tausende von parallelen GPUs mit Amazon EKS und Amazon EC2, das beschleunigte Computing-Instance-Typen wie G4dn bereitstellt. ÃÂÃÂDie hoch skalierbaren Rechen-, maschinellen Lern- und Analyseservices von AWS helfen Aurora dabei, die Technologie fÃÂÃÂ¼r selbstfahrende Fahrzeuge voranzutreiben und eine breite Anwendung in der Praxis zu erreichenÃÂÃÂ, so Swami Sivasubramanian, Vice President of Machine Learning bei Amazon Web Services, Inc. ÃÂÃÂUnsere zuverlÃÂÃÂ¤ssige Infrastruktur und unser umfangreiches Angebot an Cloud-Services, einschlieÃÂÃÂlich branchenfÃÂÃÂ¼hrender Services fÃÂÃÂ¼r maschinelles Lernen wie Amazon SageMaker, sind die ideale Grundlage fÃÂÃÂ¼r Aurora, um aus den tÃÂÃÂ¤glich anfallenden Billionen von Datenpunkten Erkenntnisse zu gewinnen und die Technologie fortlaufend zu verbessern. Wir sind stolz darauf, die beschleunigte Innovation im Bereich der autonomen Fahrzeuge zu fÃÂÃÂ¶rdern, und freuen uns auf die verbesserte Sicherheit und Effizienz, die die Transformation des Lkw-Verkehrs, des Lieferverkehrs und der MobilitÃÂÃÂ¤t ermÃÂÃÂ¶glichen wird.ÃÂÃÂ ÃÂÃÂber Amazon Web Services Seit ÃÂÃÂ¼ber 15 Jahren bietet Amazon Web Services das umfassendste und am weitesten verbreitete Cloud-Angebot der Welt. AWS hat seine Services kontinuierlich erweitert, um nahezu jeden Cloud-Workload zu unterstÃÂÃÂ¼tzen, und verfÃÂÃÂ¼gt heute ÃÂÃÂ¼ber mehr als 200 voll funktionsfÃÂÃÂ¤hige Services in den Bereichen Rechenleistung, Datenspeicher, Datenbanken, Netzwerke, Analytik, maschinelles Lernen und kÃÂÃÂ¼nstliche Intelligenz (KI), Internet der Dinge (IoT), MobilitÃÂÃÂ¤t, Sicherheit, Hybrid, virtuelle und erweiterte RealitÃÂÃÂ¤t (VR und AR), Medien sowie Anwendungsentwicklung, -bereitstellung und -verwaltung aus 81 VerfÃÂÃÂ¼gbarkeitszonen in 25 geografischen Regionen, mit angekÃÂÃÂ¼ndigten PlÃÂÃÂ¤nen fÃÂÃÂ¼r 27 weitere VerfÃÂÃÂ¼gbarkeitszonen und 9 weitere AWS-Regionen in Australien, Kanada, Indien, Indonesien, Israel, Neuseeland, Spanien, der Schweiz und den Vereinigten Arabischen Emiraten. Millionen von Kunden ÃÂÃÂ darunter die wachstumsstÃÂÃÂ¤rksten Start-ups, die grÃÂÃÂ¶ÃÂÃÂten Konzerne und fÃÂÃÂ¼hrende RegierungsbehÃÂÃÂ¶rden ÃÂÃÂ verlassen sich auf AWS, um ihre Infrastruktur anzutreiben, agiler zu werden und Kosten zu senken. Weitere Informationen zu AWS erhalten Sie unter aws.amazon.com. ÃÂÃÂber Amazon Amazon orientiert sich an vier GrundsÃÂÃÂ¤tzen: Orientierung am Kunden statt an der Konkurrenz, Leidenschaft fÃÂÃÂ¼r Neuerungen, Einsatz fÃÂÃÂ¼r betriebliche Optimierung sowie langfristiges Denken. Amazon strebt danach, das kundenorientierteste Unternehmen der Welt, der beste Arbeitgeber der Welt und der sicherste Arbeitsplatz der Welt zu sein. Kundenrezensionen, 1-Klick-EinkÃÂÃÂ¤ufe, personalisierte Empfehlungen, Prime, Versand durch Amazon, AWS, Kindle Direct Publishing, Kindle, Career Choice, Fire-Tablets, Fire TV, Amazon Echo, Alexa, ÃÂÃÂJust Walk OutÃÂÃÂ-Technologie, Amazon Studios und The Climate Pledge sind einige der Pionierleistungen von Amazon. FÃÂÃÂ¼r weitere Informationen besuchen Sie amazon.com/about und folgen Sie @AmazonNews. ÃÂÃÂber Aurora Aurora wurde 2017 von Experten fÃÂÃÂ¼r selbstfahrende Autos gegrÃÂÃÂ¼ndet und hat es sich zur Aufgabe gemacht, die Vorteile der autonomen Fahrtechnik sicher, schnell und auf breiter Front zu nutzen. Um sowohl Menschen als auch GÃÂÃÂ¼ter zu transportieren, baut das Unternehmen den Aurora Driver, eine Plattform, die Software, Hardware und Datenservices fÃÂÃÂ¼r den autonomen Betrieb von Pkw, leichten Nutzfahrzeugen und schweren Lkw zusammenfÃÂÃÂ¼hrt. Aurora wird unter anderem von Sequoia Capital, Baillie Gifford sowie von T. Rowe Price Associates betreuten Fonds und Kunden unterstÃÂÃÂ¼tzt und arbeitet mit BranchenfÃÂÃÂ¼hrern wie Toyota, Uber, Volvo und PACCAR zusammen. Aurora testet seine Fahrzeuge in der Bay Area, in Pittsburgh und Dallas. Das Unternehmen hat Niederlassungen in diesen Regionen sowie in Bozeman (Montana), Seattle (Washington), Louisville (Colorado) und Wixom (Michigan). Weitere Informationen finden Sie unter www.aurora.tech. Die Ausgangssprache, in der der Originaltext verÃÂÃÂ¶ffentlicht wird, ist die offizielle und autorisierte Version. ÃÂÃÂbersetzungen werden zur besseren VerstÃÂÃÂ¤ndigung mitgeliefert. Nur die Sprachversion, die im Original verÃÂÃÂ¶ffentlicht wurde, ist rechtsgÃÂÃÂ¼ltig. Gleichen Sie deshalb ÃÂÃÂbersetzungen mit der originalen Sprachversion der VerÃÂÃÂ¶ffentlichung ab.",https://www.businesswire.com/news/home/20211202005779/de/,businesswire.com,5,seattlebusiness wireheute hat amazon web service inc aws ein unternehmen von amazoncom inc nasdaq amzn bekannt das aurora nasdaq aur ein fhrendes unternehmen im bereich der selbstfahrenden fahrzeugtechnologie aws al bevorzugten cloudanbieter fr den einsatz von maschinellem lernen und cloudbasierten simulationen ausgewhlt hat aurora nutzt die bewhrte infrastruktur und da einzigartige funktionsportfolio von aws um die entwicklung de aurora driver der skalierbaren technologie fr selbstfahrende fahrzeuge auf sichere weise voranzutreiben der aurora driver besteht au sensoren die die welt erfassen software die einen sicheren weg durch diese welt plant und einem computer der die hardware und software von aurora betreibt und jegliche fahrzeugplattform integriert aurora setzt fr da training von maschinellem lernen und cloudbasierte simulationen vollstndig auf aws und nutzt die cloud zur verarbeitung von billionen von datenpunkten pro tag da unternehmen skaliert jetzt seine trainingsworkloads der cloud um bi zum ende de jahres bi zu millionen physikalisch basierte fahrsimulationen pro tag durchzufhren die auf den petabyte daten aufbauen die bei realen straentests gesammelt werden autonomes fahren ist eine immens komplexe technologische herausforderung die stark auf cloudcomputing angewiesen ist um bahnbrechende entwicklungen den bereichen erkennung embedded computing maschinelles lernen bewegungsplanung entscheidungsfindung und fortschrittliche sensortechnologien zu ermglichen mit den fhigkeiten von aws den bereichen hochleistungsdatenverarbeitung maschinelles lernen datenspeicherung und sicherheit kann aurora seine virtuellen test optimieren und skalieren um die fhigkeiten de aurora driver sicher und schnell zu erweitern die fortschrittlichen maschinellen lernverfahren von aurora und die simulation im groen mastab sind die grundlage fr die sichere und schnelle entwicklung unserer technologie aws liefert die hohe performance die wir zur aufrechterhalten unserer fortschritte bentigen sagt chris urmson ceo von aurora dank seiner praktisch unbegrenzten skalierbarkeit untersttzt aws millionen virtueller test um die fhigkeiten de aurora driver zu validieren damit er die zahllosen grenzflle de realen fahrens sicher bewltigen kann die awsgesttzte virtual testing suite von aurora ist ein einzigartiger entwicklungsbeschleuniger fr den aurora driver aurora kann daten au einer einzigen testsituation die der realen welt beobachtet wird verwenden um hunderte von permutationen der virtual testing suite zu beeinflussen diese virtuellen test helfen dem aurora driver dabei schnell und sicher komplexen situationen zu navigieren z b bei straenbauarbeiten fugngern und ungesichertem linksabbiegen bevor der aurora driver zum beispiel ein ungesichertes linksabbiegen auf einer realen strae ausprobieren konnte absolvierte er fast millionen abbiegevorgnge der simulation schtzungsweise stunden fahrpraxis der realitt entspricht aurora betreibt seit simulationen groem mastab auf aws und plant da volumen der auf aws ausgefhrten simulationen bi ende auf mehr al millionen pro tag zu verdreifachen die offlinekomponenten de aurora driversoftwarestacks laufen alle auf aws einschlielich der virtual testing suite hochauflsender straenkarten der auroraatlas maschineller lernmodelle und softwareentwicklungstools aurora verwendet beispielsweise amazon sagemaker einen awsservice der entwicklern und datenwissenschaftlern beim schnellen erstellen trainieren und bereitstellen von maschinellen lernmodellen hilft um die maschinellen lernmodelle zu erstellen laufen zu lassen und kontinuierlich zu verfeinern die die fahrsimulationen ermglichen mit diesem service greift aurora auf instanztypen von amazon elastic compute cloud amazon ec wie pd zu die die beste performance fr da training maschineller lernverfahren der cloud bieten vor der entwicklung von simulationen nutzt aurora aws um die petabyte daten die whrend der realen test aufgezeichnet werden auf sichere weise zu speichern und zu verarbeiten und trainiert dann die maschinellen lernmodelle anhand dieser daten die vorverarbeitungsworkloads laufen auf dem amazon elastic kubernetes service amazon eks und amazon emr dem awsservice fr die verarbeitung groer datenmengen der cloud mit opensourcetools die auroratrainingslasten fr da maschinelle lernen basieren dann auf awsoptimierten deeplearningframeworks wie tensorflow und pytorch abschlieend orchestriert und skaliert aurora seine simulationsworkflows automatisch ber hunderttausende von parallelen vcpus und tausende von parallelen gpus mit amazon eks und amazon ec da beschleunigte computinginstancetypen wie gdn bereitstellt die hoch skalierbaren rechen maschinellen lern und analyseservices von aws helfen aurora dabei die technologie fr selbstfahrende fahrzeuge voranzutreiben und eine breite anwendung der praxis zu erreichen swami sivasubramanian vice president machine learning bei amazon web service inc unsere zuverlssige infrastruktur und unser umfangreiches angebot cloudservices einschlielich branchenfhrender service fr maschinelles lernen wie amazon sagemaker sind die ideale grundlage fr aurora um au den tglich anfallenden billionen von datenpunkten erkenntnisse zu gewinnen und die technologie fortlaufend zu verbessern wir sind stolz darauf die beschleunigte innovation im bereich der autonomen fahrzeuge zu frdern und freuen un auf die verbesserte sicherheit und effizienz die die transformation de lkwverkehrs de lieferverkehrs und der mobilitt ermglichen wird ber amazon web service seit ber jahren bietet amazon web service da umfassendste und weitesten verbreitete cloudangebot der welt aws hat seine service kontinuierlich erweitert um nahezu jeden cloudworkload zu untersttzen und verfgt heute ber mehr al voll funktionsfhige service den bereichen rechenleistung datenspeicher datenbanken netzwerke analytik maschinelles lernen und knstliche intelligenz ki internet der dinge iot mobilitt sicherheit hybrid virtuelle und erweiterte realitt vr und ar medien sowie anwendungsentwicklung bereitstellung und verwaltung au verfgbarkeitszonen geografischen regionen mit angekndigten plnen fr weitere verfgbarkeitszonen und weitere awsregionen australien kanada indien indonesien israel neuseeland spanien der schweiz und den vereinigten arabischen emiraten millionen von kunden darunter die wachstumsstrksten startup die grten konzerne und fhrende regierungsbehrden verlassen sich auf aws um ihre infrastruktur anzutreiben agiler zu werden und kosten zu senken weitere informationen zu aws erhalten sie unter awsamazoncom ber amazon amazon orientiert sich vier grundstzen orientierung kunden statt der konkurrenz leidenschaft fr neuerungen einsatz fr betriebliche optimierung sowie langfristiges denken amazon strebt danach da kundenorientierteste unternehmen der welt der beste arbeitgeber der welt und der sicherste arbeitsplatz der welt zu sein kundenrezensionen klickeinkufe personalisierte empfehlungen prime versand durch amazon aws kindle direct publishing kindle career choice firetablets fire tv amazon echo alexa walk outtechnologie amazon studio und climate pledge sind einige der pionierleistungen von amazon fr weitere informationen besuchen sie amazoncomabout und folgen sie amazonnews ber aurora aurora wurde von experten fr selbstfahrende auto gegrndet und hat e sich zur aufgabe gemacht die vorteile der autonomen fahrtechnik sicher schnell und auf breiter front zu nutzen um sowohl menschen al auch gter zu transportieren baut da unternehmen den aurora driver eine plattform die software hardware und datenservices fr den autonomen betrieb von pkw leichten nutzfahrzeugen und schweren lkw zusammenfhrt aurora wird unter anderem von sequoia capital baillie gifford sowie von rowe price associate betreuten fonds und kunden untersttzt und arbeitet mit branchenfhrern wie toyota uber volvo und paccar zusammen aurora testet seine fahrzeuge der bay area pittsburgh und dallas da unternehmen hat niederlassungen diesen regionen sowie bozeman montana seattle washington louisville colorado und wixom michigan weitere informationen finden sie unter die ausgangssprache der der originaltext verffentlicht wird ist die offizielle und autorisierte version bersetzungen werden zur besseren verstndigung mitgeliefert nur die sprachversion die im original verffentlicht wurde ist rechtsgltig gleichen sie deshalb bersetzungen mit der originalen sprachversion der verffentlichung ab,-0.9995,-0.49975,0.2499773913,-0.749727391,Negative Impact
03/12/2021,172.75,173.49,166.93,169.49,169.49,80712000,3.3,50.56966791,1.192,0,13.66057312,0.8419472675,0.2413396506,0.08,278.802,15085.46973,16347.87012,7122.299805,6765.52002,3607.429932,57696.46094,20633.30078,170.89263,167.6540751,172.8797887,167.1969381,176.6224991,184.0188804,169.2261177,39.02793307,0.4122835748,1.711982921,-1.299699346,4.847858974,183.4703651,10511782000,12.08598094,5.589735857,30.67000008,"Rivian wÃÂÃÂ¤hlt AWS als bevorzugten Cloud-Anbieter, um die Effizienz, Leistung und Verfeinerung von Elektrofahrzeugen zu steigern","SEATTLE--(BUSINESS WIRE)--Amazon Web Services, Inc. (AWS), ein Unternehmen von Amazon.com, Inc. (NASDAQ: AMZN), gab heute bekannt, dass der Elektrofahrzeughersteller Rivian (NASDAQ: RIVN) AWS als seinen bevorzugten Cloud-Anbieter ausgewÃÂÃÂ¤hlt hat, wodurch die bestehenden Beziehungen der Unternehmen vertieft werden. Der Autohersteller setzt unternehmensweit AWS-Funktionen in den Bereichen Analyse, Computing, Container und maschinelles Lernen ein, um sein GeschÃÂÃÂ¤ft zu rationalisieren und die Leistung der Elektrofahrzeuge seiner Kunden zu verbessern ÃÂÃÂ in Bezug auf Batteriereichweite, Fahrerlebnis und Besitzererfahrung ÃÂÃÂ wÃÂÃÂ¤hrend gleichzeitig die technologischen Grundlagen fÃÂÃÂ¼r das Flottenmanagement von Elektrofahrzeugen der Kunden und eine effizientere Fahrzeugladung verbessert werden. Rivian wendet diese Innovationen in allen seinen Fahrzeuglinien an, einschlieÃÂÃÂlich speziell angefertigter elektrischer Lieferwagen (EDVs) fÃÂÃÂ¼r Amazon.com. Durch diese Entwicklungen mÃÂÃÂ¶chte Rivian die Umstellung von Verbrauchern und Unternehmen auf Elektrofahrzeuge beschleunigen und den Verkehr gemÃÂÃÂ¤ÃÂÃÂ den Zielen von The Climate Pledge sauberer und nachhaltiger gestalten. ÃÂÃÂRivian konzentriert sich darauf, fantastische, kategoriedefinierende Produkte zu entwickeln. Die Kombination unserer Vision mit der Breite und Tiefe der Dienstleistungen von AWS ermÃÂÃÂ¶glicht es uns, Daten und KonnektivitÃÂÃÂ¤t zu nutzen, um neu zu definieren, was in den Bereichen Transport, Logistik und Lieferung mÃÂÃÂ¶glich istÃÂÃÂ, sagte Wassym Bensaid, Vice President of Software Development bei Rivian. ÃÂÃÂBei Rivian haben wir eine softwaredefinierte Fahrzeugarchitektur mit einer technologischen Grundlage geschaffen, die fortschrittliche Funktionen wie tiefgreifende Over-the-Air-Software-Updates unterstÃÂÃÂ¼tzt, um kontinuierliche Verbesserungen an den Fahrzeugen zu erzielen, und die Erfassung eines reichhaltigen Satzes von Echtzeit-Fahrzeugdaten. Durch die Nutzung von AWS und den Aufbau eines zentralen Data Lake zur Verbindung von Rivians Betrieb, Produkten und Services kÃÂÃÂ¶nnen wir proaktive Diagnosen ermÃÂÃÂ¶glichen und unseren Fahrzeugen Intelligenz hinzufÃÂÃÂ¼gen und dann das Gelernte nutzen, um Synergien zu generieren und Effizienzsteigerungen zu erzielen. Wir freuen uns darauf, unsere Zusammenarbeit mit AWS fortzusetzen, um die Grenzen der Innovation in den Bereichen Technik, Kundenservice, FlottenmanagementlÃÂÃÂ¶sungen und Ladeerlebnisse weiter zu verschieben.ÃÂÃÂ AWS unterstÃÂÃÂ¼tzt Rivians Software-Defined Vehicle (SDV)-Architektur und Over-the-Air-Software-Updates, mit denen neue und verbesserte Funktionen aus der Ferne bereitgestellt werden kÃÂÃÂ¶nnen. Die SDV-Architektur behandelt das gesamte Fahrzeug als ein einziges, vollstÃÂÃÂ¤ndig integriertes System, das mit der Cloud verbunden ist, um Ferndiagnose, vorausschauende Wartung und schnelle Tests und Bereitstellung neuer softwaregestÃÂÃÂ¼tzter Funktionen zu ermÃÂÃÂ¶glichen, um die Freude der Kunden zu steigern. Rivian verwendet Amazon Elastic Kubernetes Service (Amazon EKS), um Software-Updates zu verwalten und zu orchestrieren, und Amazon CloudFront (AWS's Content Delivery Network Service), um die Bereitstellung von Updates in groÃÂÃÂem MaÃÂÃÂstab zu ermÃÂÃÂ¶glichen. Rivian plant, Funktionen wie Infotainment-Optionen und Flottenmanagement-Ressourcen wÃÂÃÂ¤hrend der Lebensdauer seiner Fahrzeuge kontinuierlich zu verbessern. Das Battery Data Science Team von Rivian nutzt auch AWS Managed Services, um seine AnalysefÃÂÃÂ¤higkeiten zu skalieren und schneller Erkenntnisse aus seiner Forschungs-, Entwicklungs- und Fahrzeugtestflotte zu gewinnen. ÃÂÃÂDas breite und umfassende Serviceportfolio von AWS hilft Rivian, Daten und KonnektivitÃÂÃÂ¤t als strategische Differenzierungsmerkmale in der Automobilindustrie zu nutzen. Unsere Analyse-, Machine-Learning-, Container- und Kundenservice-Funktionen unterstÃÂÃÂ¼tzen das GeschÃÂÃÂ¤ftsmodell von Rivian und werden ihm dabei helfen, das Kundenerlebnis zu skalieren und kontinuierlich zu verbessern, da immer mehr Einzelpersonen und Unternehmen auf Elektroenergie setzenÃÂÃÂ, sagte Werner Vogels, Vice President und Chief Technology Officer von Amazon.com, Inc. ÃÂÃÂAngetrieben von der weltweit fÃÂÃÂ¼hrenden Cloud gestaltet Rivian Fahrzeugbesitz, -betrieb und -service neu, um ein neues Erlebnis effizienter und angenehmer elektrischer SUVs, Trucks und Vans zu ermÃÂÃÂ¶glichen, die seine Kunden begeistern.ÃÂÃÂ DarÃÂÃÂ¼ber hinaus verwendet Rivian AWS-Analyse-, Datenbank-, Speicher- und Sicherheitsfunktionen, um die Transparenz und AgilitÃÂÃÂ¤t in seinem vertikal integrierten GeschÃÂÃÂ¤ftsmodell zu verbessern, unter dem das Unternehmen alle seine Konstruktions-, Produktions-, Vertriebs-, Verkaufs- und Fahrzeugservices intern verwaltet. Rivian hat einen Data Lake auf Amazon Simple Storage Service (Amazon S3) aufgebaut und verwendet AWS Glue (ein serverloser Datenintegrationsdienst, der das Auffinden, Vorbereiten und Kombinieren von Daten fÃÂÃÂ¼r Analysen, maschinelles Lernen und Anwendungsentwicklung vereinfacht), damit seine Teams problemlos Daten austauschen und Erkenntnisse gewinnen kÃÂÃÂ¶nnen, die seiner Meinung nach zu strukturellen Kosten- und Betriebsvorteilen gegenÃÂÃÂ¼ber herkÃÂÃÂ¶mmlichen Autoherstellern mit weniger integrierten GeschÃÂÃÂ¤ftsfunktionen fÃÂÃÂ¼hren kÃÂÃÂ¶nnen. ÃÂÃÂber Amazon Web Services Seit ÃÂÃÂ¼ber 15 Jahren bietet Amazon Web Services das umfassendste und am weitesten verbreitete Cloud-Angebot der Welt. AWS hat seine Services kontinuierlich erweitert, um nahezu jeden Cloud-Workload zu unterstÃÂÃÂ¼tzen, und verfÃÂÃÂ¼gt heute ÃÂÃÂ¼ber mehr als 200 voll funktionsfÃÂÃÂ¤hige Services in den Bereichen Rechenleistung, Datenspeicher, Datenbanken, Netzwerke, Analytik, maschinelles Lernen und kÃÂÃÂ¼nstliche Intelligenz (KI), Internet der Dinge (IoT), MobilitÃÂÃÂ¤t, Sicherheit, Hybrid, virtuelle und erweiterte RealitÃÂÃÂ¤t (VR und AR), Medien sowie Anwendungsentwicklung, -bereitstellung und -verwaltung aus 81 VerfÃÂÃÂ¼gbarkeitszonen in 25 geografischen Regionen, mit angekÃÂÃÂ¼ndigten PlÃÂÃÂ¤nen fÃÂÃÂ¼r 27 weitere VerfÃÂÃÂ¼gbarkeitszonen und 9 weitere AWS-Regionen in Australien, Kanada, Indien, Indonesien, Israel, Neuseeland, Spanien, der Schweiz und den Vereinigten Arabischen Emiraten. Millionen von Kunden ÃÂÃÂ darunter die wachstumsstÃÂÃÂ¤rksten Start-ups, die grÃÂÃÂ¶ÃÂÃÂten Konzerne und fÃÂÃÂ¼hrende RegierungsbehÃÂÃÂ¶rden ÃÂÃÂ verlassen sich auf AWS, um ihre Infrastruktur anzutreiben, agiler zu werden und Kosten zu senken. Weitere Informationen zu AWS erhalten Sie unter aws.amazon.com. ÃÂÃÂber Amazon Amazon orientiert sich an vier GrundsÃÂÃÂ¤tzen: Orientierung am Kunden statt an der Konkurrenz, Leidenschaft fÃÂÃÂ¼r Neuerungen, Einsatz fÃÂÃÂ¼r betriebliche Optimierung sowie langfristiges Denken. Amazon strebt danach, das kundenorientierteste Unternehmen der Welt, der beste Arbeitgeber der Welt und der sicherste Arbeitsplatz der Welt zu sein. Kundenrezensionen, 1-Klick-EinkÃÂÃÂ¤ufe, personalisierte Empfehlungen, Prime, Versand durch Amazon, AWS, Kindle Direct Publishing, Kindle, Career Choice, Fire-Tablets, Fire TV, Amazon Echo, Alexa, ÃÂÃÂJust Walk OutÃÂÃÂ-Technologie, Amazon Studios und The Climate Pledge sind einige der Pionierleistungen von Amazon. FÃÂÃÂ¼r weitere Informationen besuchen Sie amazon.com/about und folgen Sie @AmazonNews. ÃÂÃÂber Rivian Rivian entwickelt Energie- und Transportprodukte und -dienstleistungen mit dem Ziel, die Welt zu elektrifizieren. Wir konzipieren, entwickeln und produzieren kategoriedefinierende Elektrofahrzeuge und ZubehÃÂÃÂ¶r und verkaufen diese direkt an Kunden in den Verbraucher- und GewerbemÃÂÃÂ¤rkten. Rivian ergÃÂÃÂ¤nzt seine Fahrzeuge mit einer vollstÃÂÃÂ¤ndigen Palette proprietÃÂÃÂ¤rer Mehrwertdienste, die den gesamten Lebenszyklus des Fahrzeugs abdecken und die Kundenbeziehungen vertiefen. Die Ausgangssprache, in der der Originaltext verÃÂÃÂ¶ffentlicht wird, ist die offizielle und autorisierte Version. ÃÂÃÂbersetzungen werden zur besseren VerstÃÂÃÂ¤ndigung mitgeliefert. Nur die Sprachversion, die im Original verÃÂÃÂ¶ffentlicht wurde, ist rechtsgÃÂÃÂ¼ltig. Gleichen Sie deshalb ÃÂÃÂbersetzungen mit der originalen Sprachversion der VerÃÂÃÂ¶ffentlichung ab.",https://www.businesswire.com/news/home/20211202006071/de/,businesswire.com,5,seattlebusiness wireamazon web service inc aws ein unternehmen von amazoncom inc nasdaq amzn gab heute bekannt das der elektrofahrzeughersteller rivian nasdaq rivn aws al seinen bevorzugten cloudanbieter ausgewhlt hat wodurch die bestehenden beziehungen der unternehmen vertieft werden der autohersteller setzt unternehmensweit awsfunktionen den bereichen analyse computing container und maschinelles lernen ein um sein geschft zu rationalisieren und die leistung der elektrofahrzeuge seiner kunden zu verbessern bezug auf batteriereichweite fahrerlebnis und besitzererfahrung whrend gleichzeitig die technologischen grundlagen fr da flottenmanagement von elektrofahrzeugen der kunden und eine effizientere fahrzeugladung verbessert werden rivian wendet diese innovationen allen seinen fahrzeuglinien einschlielich speziell angefertigter elektrischer lieferwagen edvs fr amazoncom durch diese entwicklungen mchte rivian die umstellung von verbrauchern und unternehmen auf elektrofahrzeuge beschleunigen und den verkehr gem den zielen von climate pledge sauberer und nachhaltiger gestalt rivian konzentriert sich darauf fantastische kategoriedefinierende produkte zu entwickeln die kombination unserer vision mit der breite und tiefe der dienstleistungen von aws ermglicht e un daten und konnektivitt zu nutzen um neu zu definieren den bereichen transport logistik und lieferung mglich ist sagte wassym bensaid vice president software development bei rivian bei rivian haben wir eine softwaredefinierte fahrzeugarchitektur mit einer technologischen grundlage geschaffen die fortschrittliche funktionen wie tiefgreifende overtheairsoftwareupdates untersttzt um kontinuierliche verbesserungen den fahrzeugen zu erzielen und die erfassung eines reichhaltigen satzes von echtzeitfahrzeugdaten durch die nutzung von aws und den aufbau eines zentralen data lake zur verbindung von rivians betrieb produkten und service knnen wir proaktive diagnosen ermglichen und unseren fahrzeugen intelligenz hinzufgen und dann da gelernte nutzen um synergien zu generieren und effizienzsteigerungen zu erzielen wir freuen un darauf unsere zusammenarbeit mit aws fortzusetzen um die grenzen der innovation den bereichen technik kundenservice flottenmanagementlsungen und ladeerlebnisse weiter zu verschieben aws untersttzt rivians softwaredefined vehicle sdvarchitektur und overtheairsoftwareupdates mit denen neue und verbesserte funktionen au der ferne bereitgestellt werden knnen die sdvarchitektur behandelt da gesamte fahrzeug al ein einziges vollstndig integriertes system da mit der cloud verbunden ist um ferndiagnose vorausschauende wartung und schnelle test und bereitstellung neuer softwaregesttzter funktionen zu ermglichen um die freude der kunden zu steigern rivian verwendet amazon elastic kubernetes service amazon eks um softwareupdates zu verwalten und zu orchestrieren und amazon cloudfront awss content delivery network service um die bereitstellung von update groem mastab zu ermglichen rivian plant funktionen wie infotainmentoptionen und flottenmanagementressourcen whrend der lebensdauer seiner fahrzeuge kontinuierlich zu verbessern da battery data science team von rivian nutzt auch aws managed service um seine analysefhigkeiten zu skalieren und schneller erkenntnisse au seiner forschungs entwicklungs und fahrzeugtestflotte zu gewinnen da breite und umfassende serviceportfolio von aws hilft rivian daten und konnektivitt al strategische differenzierungsmerkmale der automobilindustrie zu nutzen unsere analyse machinelearning container und kundenservicefunktionen untersttzen da geschftsmodell von rivian und werden ihm dabei helfen da kundenerlebnis zu skalieren und kontinuierlich zu verbessern da immer mehr einzelpersonen und unternehmen auf elektroenergie setzen sagte werner vogels vice president und chief technology officer von amazoncom inc angetrieben von der weltweit fhrenden cloud gestaltet rivian fahrzeugbesitz betrieb und service neu um ein neues erlebnis effizienter und angenehmer elektrischer suv truck und van zu ermglichen die seine kunden begeistern darber hinaus verwendet rivian awsanalyse datenbank speicher und sicherheitsfunktionen um die transparenz und agilitt seinem vertikal integrierten geschftsmodell zu verbessern unter dem da unternehmen alle seine konstruktions produktions vertriebs verkaufs und fahrzeugservices intern verwaltet rivian hat einen data lake auf amazon simple storage service amazon aufgebaut und verwendet aws glue ein serverloser datenintegrationsdienst der da auffinden vorbereiten und kombinieren von daten fr analysen maschinelles lernen und anwendungsentwicklung vereinfacht damit seine team problemlos daten austauschen und erkenntnisse gewinnen knnen die seiner meinung nach zu strukturellen kosten und betriebsvorteilen gegenber herkmmlichen autoherstellern mit weniger integrierten geschftsfunktionen fhren knnen ber amazon web service seit ber jahren bietet amazon web service da umfassendste und weitesten verbreitete cloudangebot der welt aws hat seine service kontinuierlich erweitert um nahezu jeden cloudworkload zu untersttzen und verfgt heute ber mehr al voll funktionsfhige service den bereichen rechenleistung datenspeicher datenbanken netzwerke analytik maschinelles lernen und knstliche intelligenz ki internet der dinge iot mobilitt sicherheit hybrid virtuelle und erweiterte realitt vr und ar medien sowie anwendungsentwicklung bereitstellung und verwaltung au verfgbarkeitszonen geografischen regionen mit angekndigten plnen fr weitere verfgbarkeitszonen und weitere awsregionen australien kanada indien indonesien israel neuseeland spanien der schweiz und den vereinigten arabischen emiraten millionen von kunden darunter die wachstumsstrksten startup die grten konzerne und fhrende regierungsbehrden verlassen sich auf aws um ihre infrastruktur anzutreiben agiler zu werden und kosten zu senken weitere informationen zu aws erhalten sie unter awsamazoncom ber amazon amazon orientiert sich vier grundstzen orientierung kunden statt der konkurrenz leidenschaft fr neuerungen einsatz fr betriebliche optimierung sowie langfristiges denken amazon strebt danach da kundenorientierteste unternehmen der welt der beste arbeitgeber der welt und der sicherste arbeitsplatz der welt zu sein kundenrezensionen klickeinkufe personalisierte empfehlungen prime versand durch amazon aws kindle direct publishing kindle career choice firetablets fire tv amazon echo alexa walk outtechnologie amazon studio und climate pledge sind einige der pionierleistungen von amazon fr weitere informationen besuchen sie amazoncomabout und folgen sie amazonnews ber rivian rivian entwickelt energie und transportprodukte und dienstleistungen mit dem ziel die welt zu elektrifizieren wir konzipieren entwickeln und produzieren kategoriedefinierende elektrofahrzeuge und zubehr und verkaufen diese direkt kunden den verbraucher und gewerbemrkten rivian ergnzt seine fahrzeuge mit einer vollstndigen palette proprietrer mehrwertdienste die den gesamten lebenszyklus de fahrzeugs abdecken und die kundenbeziehungen vertiefen die ausgangssprache der der originaltext verffentlicht wird ist die offizielle und autorisierte version bersetzungen werden zur besseren verstndigung mitgeliefert nur die sprachversion die im original verffentlicht wurde ist rechtsgltig gleichen sie deshalb bersetzungen mit der originalen sprachversion der verffentlichung ab,-0.9977,-0.49885,0.177225,-0.676075,Negative Impact
06/12/2021,169.65,173.70,166.93,171.37,171.37,68860000,3.3,50.56966791,1.192,0,13.66057312,0.8419472675,0.2413396506,0.08,278.802,15225.15039,16591.9707,7232.299805,6865.779785,3589.310059,56747.14063,20861.09961,170.89448,167.7157326,172.8205225,167.2384462,176.3934494,184.1524234,168.6344754,40.66794086,0.1051989324,1.390626123,-1.285427191,5.085323879,181.4855204,10580642000,20.95859251,12.35547304,27.18000031,Amazon (AMZN) Expands Cloud Offerings With AWS Cloud WAN,"Amazon's (AMZN) AWS unveils a service, namely AWS Cloud WAN, which aids in seamless development, management, operation and monitoring of a global network with the help of a central dashboard.",https://www.zacks.com/stock/news/1835662/amazon-amzn-expands-cloud-offerings-with-aws-cloud-wan,zacks.com,8,amazon amzn aws unveils service namely aws cloud wan aid seamless development management operation monitoring global network help central dashboard,0.5267,0.42136,0.171762,0.249598,Positive Impact
07/12/2021,174.6,177.50,173.33,176.16,176.16,66410000,3.3,50.56966791,1.192,0,13.66057312,0.8419472675,0.2413396506,0.08,278.802,15686.91992,16853.57031,7339.899902,7065.390137,3595.090088,57633.64844,21162.69922,171.0119702,167.7979301,172.9516591,167.3272627,176.4792244,184.1854403,168.7730085,48.79903062,0.2459940167,1.161699702,-0.915705685,5.339860099,179.7388571,10647052000,43.60528832,25.54995392,21.88999939,How Big Tech is faring against U.S. lawsuits and probes,"Big Tech platforms Meta Platforms Inc, formerly known as Facebook, and Google have been hit with a series of antitrust lawsuits by the U.S. federal government and states on charges they are operating monopolies and abusing their power.",https://www.reuters.com/technology/big-tech-wins-two-battles-fight-with-us-antitrust-enforcers-2021-06-29/,reuters.com,10,big tech platform meta platform inc formerly known facebook google hit series antitrust lawsuit u federal government state charge operating monopoly abusing power,-0.5994,-0.5994,0.142937619,-0.742337619,Negative Impact
08/12/2021,176.1505,177.18,174.75,176.16,176.16,45254000,3.3,50.56966791,1.192,0,13.66057312,0.8419472675,0.2413396506,0.08,278.802,15786.99023,16899.91992,7337.399902,7014.569824,3637.570068,58649.67969,21077.40039,171.2191702,167.8888376,173.0773981,167.4151308,176.34655,183.9746701,168.7184299,48.19720383,0.3529816671,0.9999560951,-0.646974428,5.347145081,178.2017934,10601798000,43.57459422,36.04615835,19.89999962,"Amazon's trucking ambitions bump up against driver shortage, competition",Amazon.com Inc's push to recruit big-rig contractors to haul goods across its web of warehouses is colliding with a trucker shortage as the e-commerce company moves what are expected to be record numbers of packages this holiday season.,https://www.reuters.com/markets/commodities/amazons-trucking-ambitions-bump-up-against-driver-shortage-competition-2021-12-08/,reuters.com,10,amazoncom inc push recruit bigrig contractor haul good across web warehouse colliding trucker shortage ecommerce company move expected record number package holiday season,0.5267,0.5267,0.09661647059,0.4300835294,Positive Impact
09/12/2021,175.75,176.97,174.14,174.17,174.17,46062000,3.3,50.56966791,1.192,0,13.66057312,0.8419472675,0.2413396506,0.08,278.802,15517.37012,16780.4707,7321.299805,7008.22998,3673.040039,58807.12891,20925.5,171.4014703,167.9954026,173.1202847,167.4823534,176.3499756,183.973913,168.7260382,32.55163806,0.2742742337,0.8548197228,-0.580545489,4.995001657,166.9299927,10555736000,34.1919995,40.45729402,21.57999992,Amazon Plans Appeal Following $1.3B Fine in Italian Antitrust Case,"Amazon said it would appeal a $1.3 billion fine from Italy's antitrust regulator after the eCommerce giant was found to favor third-party sellers that use its logistics services, according to a statement from the Italian Competition Authority (ICA) on Thursday (Dec. 9). In addition to the fine, the watchdog ordered Amazon to offer listings from [ÃÂÃÂ]",https://www.pymnts.com/amazon/2021/amazon-plans-appeal-1-3b-fine-italian-antitrust-case/,pymnts.com,5,amazon said would appeal billion fine italy antitrust regulator ecommerce giant found favor thirdparty seller use logistics service according statement italian competition authority ica thursday dec addition fine watchdog ordered amazon offer listing,0.7906,0.3953,-0.158945,0.554245,Positive Impact
10/12/2021,175.417,175.93,170.50,172.21,172.21,60690000,3.3,50.56966791,1.192,0,13.66057312,0.8419472675,0.2413396506,0.08,278.802,15630.59961,16856.63086,7291.799805,6991.680176,3666.350098,58786.67188,20890.59961,171.5606705,168.0832301,173.0846659,167.5294146,176.2793259,184.0346429,168.5240088,31.53268934,0.05320975825,0.6944977299,-0.641287972,5.07396589,167.1307828,10495046000,28.18123943,35.31594438,18.69000053,Europe's Battle to Curb Big Tech's Power Continues With More Fines,"It's been another week of heavy fines and warnings aimed at curbing Big Tech's power in the European Union (EU) and across Europe. Earlier this week, Russia fined Alphabet's Google 9 million roubles (about $121,000) over its failure to delete banned content, the latest in a string of penalties that is part of a wider [ÃÂÃÂ]",https://www.pymnts.com/big-tech/2021/europe-battle-to-curb-big-tech-power-continues-with-more-fines/,pymnts.com,5,another week heavy fine warning aimed curbing big tech power european union eu across europe earlier week russia fined alphabet google million rouble failure delete banned content latest string penalty part wider,-0.872,-0.436,0.2000833333,-0.636083333,Negative Impact
13/12/2021,172,172.10,169.13,169.57,169.57,62170000,3.3,50.56966791,1.192,0,13.66057312,0.8419472675,0.2413396506,0.08,278.802,15413.28027,16719.57031,7231.399902,6942.910156,3681.080078,58283.42188,20748.5,171.6687607,168.1445326,172.946738,167.5496941,175.9448257,184.2609323,167.6287192,34.32138389,-0.331552607,0.4892876625,-0.82084027,4.772822789,167.3275571,10432876000,17.88748966,26.7535762,20.30999947,"Investigation opened into Amazon warehouse collapse in Illinois, says labor official","The U.S. workplace safety watchdog is investigating the circumstances around the collapse during Friday night's storm of an Amazon.com Inc building in Illinois in which six workers died, an official at the U.S. Department of Labor said on Monday.",https://www.reuters.com/world/us/investigation-into-amazoncom-illinois-building-collapse-opened-labor-official-2021-12-13/,reuters.com,10,u workplace safety watchdog investigating circumstance around collapse friday night storm amazoncom inc building illinois six worker died official u department labor said monday,-0.6124,-0.6124,0.1084033333,-0.720803333,Negative Impact
14/12/2021,167.55,169.50,166.44,169.09,169.09,55976000,3.3,50.56966791,1.192,0,13.66057312,0.8419472675,0.2413396506,0.08,278.802,15237.63965,16652.58008,7218.600098,6895.310059,3661.530029,58117.08984,20648.59961,171.8608109,168.2163577,172.7955525,167.5650356,175.5352013,184.3647866,166.705616,32.9120638,-0.66719757,0.2579906159,-0.925188186,4.662858146,176.9694977,10376900000,17.40403289,21.15758733,21.88999939,"Exclusive-Amazon says India revoking Future deal would boost Reliance, hurt competition","Amazon has warned India's antitrust body that revoking its 2019 deal with Future Group would send a negative signal to foreign investors and allow local retail behemoth Reliance to ""further restrict competition"", a legal document seen by Reuters showed.",https://www.reuters.com/markets/deals/exclusive-amazon-says-india-revoking-future-deal-would-boost-reliance-hurt-2021-12-14/,reuters.com,10,amazon warned india antitrust body revoking deal future group would send negative signal foreign investor allow local retail behemoth reliance restrict competition legal document seen reuters showed,-0.6486,-0.6486,0.1033825,-0.7519825,Negative Impact
15/12/2021,168.598,173.60,165.20,173.32,173.32,75794000,3.3,50.56966791,1.192,0,13.66057312,0.8419472675,0.2413396506,0.08,278.802,15565.58008,16813.57031,7170.799805,6927.629883,3647.629883,57788.03125,20769.19922,172.1061108,168.3316827,172.8159231,167.6222492,175.3492012,184.2024545,166.4959479,41.40830183,-0.585646861,0.08926312062,-0.674909981,4.988964626,176.7589078,10452694000,49.27182781,28.18778345,19.29000092,AWS lanÃÂÃÂ§a regiÃÂÃÂ£o na IndonÃÂÃÂ©sia,"SEATTLE--(BUSINESS WIRE)--Amazon Web Services, Inc., uma empresa da Amazon.com (NASDAQ:AMZN), anunciou hoje o lanÃÂÃÂ§amento da regiÃÂÃÂ£o ÃÂÃÂsia-PacÃÂÃÂ­fico (Jakarta) da AWS. A partir de hoje, desenvolvedores, startups, empreendedores e empreendimentos assim como organizaÃÂÃÂ§ÃÂÃÂµes governamentais, educacionais e sem fins lucrativos poderÃÂÃÂ£o executar suas aplicaÃÂÃÂ§ÃÂÃÂµes e servir usuÃÂÃÂ¡rios finais a partir de centros de dados localizados na IndonÃÂÃÂ©sia potencializando tecnologias AWS avanÃÂÃÂ§adas para impulsionar a inovaÃÂÃÂ§ÃÂÃÂ£o. A AWS liberou um estudo de impacto econÃÂÃÂ´mico (Economic Impact Study, EIS) estimando que os gastos da empresa na construÃÂÃÂ§ÃÂÃÂ£o e operaÃÂÃÂ§ÃÂÃÂ£o da nova regiÃÂÃÂ£o ÃÂÃÂsia-PacÃÂÃÂ­fico (Jakarta) da AWS criarÃÂÃÂ¡ 24.700 empregos diretos e indiretos com uma estimativa de US$ 5 bilhÃÂÃÂµes (IDR$ 71 trilhÃÂÃÂµes) em investimento planejado na economia local. A regiÃÂÃÂ£o adicionarÃÂÃÂ¡ uma estimativa de US$ 10,9 bilhÃÂÃÂµes (IDR$ 155 trilhÃÂÃÂµes) no decorrer dos prÃÂÃÂ³ximos 15 anos para o Produto Interno Bruto (PIB) da IndonÃÂÃÂ©sia. Para mais informaÃÂÃÂ§ÃÂÃÂµes sobre a infraestrutura global da AWS, acesse aws.amazon.com/about-aws/global-infrastructure/. ""A nuvem oferece a organizaÃÂÃÂ§ÃÂÃÂµes de todos os tipos e tamanhos, de empresas ÃÂÃÂ s instituiÃÂÃÂ§ÃÂÃÂµes educacionais ÃÂÃÂ s agÃÂÃÂªncias governamentais, oportunidades para transformar suas operaÃÂÃÂ§ÃÂÃÂµes e reinventar experiÃÂÃÂªncias para seus clientes e usuÃÂÃÂ¡rios finais"", disse Prasad Kalyanaraman, vice-presidente de ServiÃÂÃÂ§os de Infraestrutura da AWS. ""A AWS estÃÂÃÂ¡ entusiasmada em anunciar nova regiÃÂÃÂ£o na ÃÂÃÂsia-PacÃÂÃÂ­fico e ajudar instituiÃÂÃÂ§ÃÂÃÂµes da IndonÃÂÃÂ©sia, startups inovadoras e empresas lÃÂÃÂ­deres mundiais a entregar aplicaÃÂÃÂ§ÃÂÃÂµes alimentadas pela nuvem para fomentar o desenvolvimento econÃÂÃÂ´mico em todo o paÃÂÃÂ­s. As organizaÃÂÃÂ§ÃÂÃÂµes em todos os setores na IndonÃÂÃÂ©sia podem agora aproveitar a regiÃÂÃÂ£o ÃÂÃÂsia PacÃÂÃÂ­fico (Jakarta) da AWS para reduzir custos, aumentar agilidade e impulsionar a inovaÃÂÃÂ§ÃÂÃÂ£o"". ""A infraestrutura da provedora de nuvem lÃÂÃÂ­der mundial desempenha um papel fundamental na aceleraÃÂÃÂ§ÃÂÃÂ£o de nossa economia digital, disse Perry Warjiyo, diretor do Bank Indonesia, o banco central do paÃÂÃÂ­s. ""Esperamos que a tecnologia de nuvem da AWS nos ajude a alcanÃÂÃÂ§ar nossa visÃÂÃÂ£o e objetivos descritos no plano de Sistemas de Pagamento da Indonesia de 2045, digitalizando completamente os sistemas de pagamento do paÃÂÃÂ­s e integrando uma multitude de partes interessadas e atividades econÃÂÃÂ´micas sob os princÃÂÃÂ­pios de orientaÃÂÃÂ§ÃÂÃÂ£o de seguranÃÂÃÂ§a e proteÃÂÃÂ§ÃÂÃÂ£o de dados"". Com o lanÃÂÃÂ§amento da regiÃÂÃÂ£o ÃÂÃÂsia-PacÃÂÃÂ­fico (Jakarta) da AWS, a AWS possui 84 zonas de disponibilidade em 26 regiÃÂÃÂµes geogrÃÂÃÂ¡ficas globalmente, com planos para lanÃÂÃÂ§ar mais 24 zonas de disponibilidade e mais oito regiÃÂÃÂµes da AWS na AustrÃÂÃÂ¡lia, CanadÃÂÃÂ¡, ÃÂÃÂndia, Israel, Nova ZelÃÂÃÂ¢ndia, Espanha, SuÃÂÃÂ­ÃÂÃÂ§a e Emirados ÃÂÃÂrabes Unidos. As regiÃÂÃÂµes da AWS sÃÂÃÂ£o compostas por zonas de disponibilidade que posicionam a infraestrutura em localidades geogrÃÂÃÂ¡ficas separadas e distintas. As zonas de disponibilidade estÃÂÃÂ£o localizadas longe o suficiente umas das outras para dar suporte ÃÂÃÂ continuidade dos negÃÂÃÂ³cios dos clientes, mas perto o suficiente para fornecer baixa latÃÂÃÂªncia para aplicativos de alta disponibilidade que usam vÃÂÃÂ¡rias zonas de disponibilidade. Cada zona de disponibilidade possui energia, resfriamento, e seguranÃÂÃÂ§a fÃÂÃÂ­sica independentes e estÃÂÃÂ¡ conectada por redes redundantes de latÃÂÃÂªncia ultrabaixa. Os clientes da AWS focados em alta disponibilidade podem criar seus aplicativos para rodarem em mÃÂÃÂºltiplas zonas de disponibilidade para alcanÃÂÃÂ§ar uma tolerÃÂÃÂ¢ncia de falha ainda maior. O lanÃÂÃÂ§amento de uma regiÃÂÃÂ£o da AWS na IndonÃÂÃÂ©sia oferece aos clientes uma latÃÂÃÂªncia ainda mais baixa por todo o paÃÂÃÂ­s e apoia aplicaÃÂÃÂ§ÃÂÃÂµes de recuperaÃÂÃÂ§ÃÂÃÂ£o de desastres para a continuidade dos negÃÂÃÂ³cios. A AWS estÃÂÃÂ¡ planejando investir uma estimativa de US$ 5 bilhÃÂÃÂµes (IDR$ 71 trilhÃÂÃÂµes) na IndonÃÂÃÂ©sia durante os prÃÂÃÂ³ximos 15 anos atravÃÂÃÂ©s da nova regiÃÂÃÂ£o ÃÂÃÂsia PacÃÂÃÂ­fico (Jakarta) da AWS, incluindo despesas de capital na construÃÂÃÂ§ÃÂÃÂ£o de centros de dados, despesas operacionais relativas a custos contÃÂÃÂ­nuos de serviÃÂÃÂ§os pÃÂÃÂºblicos e de instalaÃÂÃÂ§ÃÂÃÂ£o e compras de bens e serviÃÂÃÂ§os de empresas regionais. O investimento ÃÂÃÂ© tambÃÂÃÂ©m estimado sustentar uma mÃÂÃÂ©dia de 24.700 empregos diretos e indiretos anualmente durante esse tempo. Esses empregos farÃÂÃÂ£o parte de uma cadeia de suprimentos da AWS na IndonÃÂÃÂ©sia, incluindo construÃÂÃÂ§ÃÂÃÂ£o, manutenÃÂÃÂ§ÃÂÃÂ£o de instalaÃÂÃÂ§ÃÂÃÂ£o, engenharia, telecomunicaÃÂÃÂ§ÃÂÃÂµes e empregos dentro da economia mais abrangente da IndonÃÂÃÂ©sia. A construÃÂÃÂ§ÃÂÃÂ£o e operaÃÂÃÂ§ÃÂÃÂ£o da infraestrutura da AWS na IndonÃÂÃÂ©sia ÃÂÃÂ© tambÃÂÃÂ©m estimada adicionar mais de US$ 10 bilhÃÂÃÂµes (IDR$ 155 trilhÃÂÃÂµes) para o PIB da IndonÃÂÃÂ©sia durante os prÃÂÃÂ³ximos 15 anos. Clientes e parceiros da AWS dÃÂÃÂ£o as boas-vindas ÃÂÃÂ regiÃÂÃÂ£o ÃÂÃÂsia PacÃÂÃÂ­fico (Jakarta) da AWS Clientes na IndonÃÂÃÂ©sia unem-se a milhÃÂÃÂµes de clientes ativos usando a AWS todos os meses em mais de 190 paÃÂÃÂ­ses em todo o mundo para acelerar inovaÃÂÃÂ§ÃÂÃÂ£o, aumentar a agilidade e impulsionar a reduÃÂÃÂ§ÃÂÃÂ£o de custos. OrganizaÃÂÃÂ§ÃÂÃÂµes por toda a IndonÃÂÃÂ©sia que mudaram suas cargas de trabalho de missÃÂÃÂ£o crÃÂÃÂ­tica para a nuvem incluem Adskom, Amartha, Anter Aja, ASEAN Foundation, Bhinekka, Bizzy, Bridestory, Bank Commonwealth Indonesia, Dinas Komunikasi dan Informatika Jawa Barat, Elevenia, FinAccel, Happyfresh, Haldin, Hara Token, Halodoc, Jawa Pos, Kumparan, Kompas, Lion Air, MNC Group, Mamikos, Optik Melawai, Optik Seis, Sayurbox, Sekolah.mu, Shipper, SiCepat, Simak Online, Sociolla, The Body Shop, Tokopedia, Traveloka, e XL Axiata. O MNC Group, um conglomerado multinacional indonÃÂÃÂ©sio na mÃÂÃÂ­dia, serviÃÂÃÂ§os financeiros, entretenimento, hospitalidade, ecommerce e outros negÃÂÃÂ³cios digitais escolheram a AWS como sua provedora de nuvem preferida para impulsionar ainda mais sua transformaÃÂÃÂ§ÃÂÃÂ£o digital e melhorar a experiÃÂÃÂªncia do cliente. ""As capacidades da AWS Cloud impulsionam com sucesso o desempenho de MNC Portal Indonesia, oferecendo uma experiÃÂÃÂªncia incomparÃÂÃÂ¡vel para seus visualizadores. Transformamos nosso negÃÂÃÂ³cio de mÃÂÃÂ­dia com a AWS e estamos agora buscando repetir esse sucesso com nossos negÃÂÃÂ³cios de serviÃÂÃÂ§os financeiros digitais"", disse Yudi Hamka, diretor de tecnologia do MNC Group. ""Estamos ansiosos para usar as capacidades avanÃÂÃÂ§adas da AWS como analÃÂÃÂ­tica e aprendizado de mÃÂÃÂ¡quina para melhor entender nossos clientes, prever tendÃÂÃÂªncias e preferÃÂÃÂªncias futuras e solucionar desafios financeiros de uma forma mais significativa. A regiÃÂÃÂ£o ÃÂÃÂsia-PacÃÂÃÂ­fico (Jakarta) da AWS serÃÂÃÂ¡ instrumental para alcanÃÂÃÂ§ar isso oferecendo os mais altos nÃÂÃÂ­veis de seguranÃÂÃÂ§a em baixa latÃÂÃÂªncia, que ÃÂÃÂ© de importÃÂÃÂ¢ncia fundamental para o setor de serviÃÂÃÂ§os financeiros"". A PT Pos Indonesia (Persero), provedora dos serviÃÂÃÂ§os postais da naÃÂÃÂ§ÃÂÃÂ£o, trabalha com a AWS como parte da sua jornada de digitalizaÃÂÃÂ§ÃÂÃÂ£o. ""A regiÃÂÃÂ£o ÃÂÃÂsia-PacÃÂÃÂ­fico (Jakarta) da AWS nos ajudarÃÂÃÂ¡ a alinhar e transformar digitalmente nossos negÃÂÃÂ³cios e prioridades sociais para oferecer serviÃÂÃÂ§os pÃÂÃÂºblicos mais eficazes para o benefÃÂÃÂ­cio de todos os indonÃÂÃÂ©sios"", disse Dr. Faizal Rochmad Djoemadi, diretor executivo da PT Pos Indonesia (Persero). ""A digitalizaÃÂÃÂ§ÃÂÃÂ£o e automaÃÂÃÂ§ÃÂÃÂ£o de processos tradicionais, juntamente com a expansÃÂÃÂ£o dos negÃÂÃÂ³cios possibilitada por aplicaÃÂÃÂ§ÃÂÃÂµes digitais desempenharÃÂÃÂ£o um importante papel na estratÃÂÃÂ©gia futura da PT Pos Indonesia (Persero). A PT Pos Indonesia (Persero) planeja mover suas cargas de trabalho crÃÂÃÂ­ticas e essenciais incluindo transferÃÂÃÂªncia digital de dinheiro para a AWS na regiÃÂÃÂ£o ÃÂÃÂsia-PacÃÂÃÂ­fico (Jakarta) da AWS. Ruparupa.com ÃÂÃÂ© um dos sites de compras on-line lÃÂÃÂ­der na IndonÃÂÃÂ©sia com mais de 700 mil clientes no paÃÂÃÂ­s. O site combina experiÃÂÃÂªncias de compra convencional e on-line com STOPS (Store Pick Up Service), permitindo que os clientes comprem on-line e recolham seus pedidos em determinadas lojas por toda a IndonÃÂÃÂ©sia. ""Nossa plataforma ecommerce estÃÂÃÂ¡ crescendo rapidamente ÃÂÃÂ medida que a pandemia da COVID-19 incentivou mais clientes a comprar on-line, e com a escalabilidade da AWS, podemos lidar facilmente com essa demanda crescente"", disse Ronny Winoto, diretor de tecnologia da Ruparupa.com. ""JÃÂÃÂ¡ estamos executando a maioria da nossa infraestrutura na nuvem lÃÂÃÂ­der mundial e, ao aproveitar a regiÃÂÃÂ£o ÃÂÃÂsia-PacÃÂÃÂ­fico (Jakarta) da AWS, podemos melhorar ainda mais nossa experiÃÂÃÂªncia do cliente com serviÃÂÃÂ§os ecommerce inovadores"". Halodoc, uma startup de tecnologia da saÃÂÃÂºde baseada em Jakarta operando com a AWS estÃÂÃÂ¡ apoiando a vacinaÃÂÃÂ§ÃÂÃÂ£o nacional da COVID-19, testes e iniciativas de telemedicina da IndonÃÂÃÂ©sia. ""A COVID-19 levou muitos a buscar por serviÃÂÃÂ§os de assistÃÂÃÂªncia mÃÂÃÂ©dica alternativos, acessÃÂÃÂ­veis remotamente. Quando nosso trÃÂÃÂ¡fego aumentou significativamente no inÃÂÃÂ­cio da pandemia, estÃÂÃÂ¡vamos confiantes que poderÃÂÃÂ­amos enfrentar os desafios em razÃÂÃÂ£o da sÃÂÃÂ³lida equipe adicional que inclui a AWS. Atualmente, estamos explorando tambÃÂÃÂ©m outras tecnologias da AWS, tais como aprendizado de mÃÂÃÂ¡quina para elevar a experiÃÂÃÂªncia do usuÃÂÃÂ¡rio ao usar nossa aplicaÃÂÃÂ§ÃÂÃÂ£o"", disse Alfonsius Timboel, diretor de produto da Halodoc. ""A disponibilidade da regiÃÂÃÂ£o ÃÂÃÂsia-PacÃÂÃÂ­fico (Jakarta) da AWS nos ajuda a atender nossa missÃÂÃÂ£o para tornar cuidados mÃÂÃÂ©dicos de qualidade acessÃÂÃÂ­veis a todos atravÃÂÃÂ©s de nossa rede de 20 mil mÃÂÃÂ©dicos licenciados, 2 mil hospitais/clÃÂÃÂ­nicos/laboratÃÂÃÂ³rios, e 4 mil farmÃÂÃÂ¡cias registradas, que estÃÂÃÂ£o espalhadas por centenas de cidades na IndonÃÂÃÂ©sia e conectadas pela nossa plataforma digital que usa a tecnologia confiÃÂÃÂ¡vel da AWS. Tokopedia, uma empresa de tecnologia indonÃÂÃÂ©sia e um marketplace on-line lÃÂÃÂ­der com mais de 100 milhÃÂÃÂµes de usuÃÂÃÂ¡rios mensais ativos e 11 milhÃÂÃÂµes de parceiros comerciais, confiam suas cargas de trabalho de missÃÂÃÂ£o crÃÂÃÂ­tica para a AWS. ""A IndonÃÂÃÂ©sia estÃÂÃÂ¡ vendo um aumento na adoÃÂÃÂ§ÃÂÃÂ£o digital e crescimento acelerado. Os serviÃÂÃÂ§os de nuvem, tais como a AWS, reduzem o trabalho pesado necessÃÂÃÂ¡rio para gerenciar infraestrutura e nos permite focar nas necessidades do cliente. A regiÃÂÃÂ£o ÃÂÃÂsia-PacÃÂÃÂ­fico (Jakarta) da AWS permitirÃÂÃÂ¡ que continuemos a focar na construÃÂÃÂ§ÃÂÃÂ£o e fortalecimento de nossas capacidades comerciais enquanto utilizamos a melhor tecnologia em termos de computaÃÂÃÂ§ÃÂÃÂ£o essencial e infraestrutura tecnolÃÂÃÂ³gica para atender ÃÂÃÂ s necessidades de nossos negÃÂÃÂ³cios e clientes"", disse Herman Widjaja, diretor de tecnologia da Tokopedia. A AWS Partner Network (APN) inclui dezenas de milhares de fornecedores independentes de software (Independent Software Vendors, ISVs) e integradores de sistemas (Systems Integrators, SIs) ao redor do mundo. Parceiros da AWS constroem soluÃÂÃÂ§ÃÂÃÂµes e serviÃÂÃÂ§os inovadores na AWS, e a APN fornece suporte empresarial, tÃÂÃÂ©cnico, de marketing e de entrada no mercado aos clientes. SIs, parceiros consultores e ISVs da AWS ajudam clientes empresariais e do setor pÃÂÃÂºblico a migrar para a AWS, implantar aplicativos de missÃÂÃÂ£o crÃÂÃÂ­tica e fornecer uma completa gama de serviÃÂÃÂ§os de monitoramento, automaÃÂÃÂ§ÃÂÃÂ£o e gerenciamento para ambientes de nuvem dos clientes. Exemplos de Parceiros da AWS na IndonÃÂÃÂ©sia incluem Metrodata, PT Berca Hardayaperkasa, PT Innovation Cloud Services (ICS Compute), Salesforce e muitos outros. Acesse aws.amazon.com/partners para a lista completa de Parceiros da AWS. A PT Innovation Cloud Services (ICS Compute) ÃÂÃÂ© uma firma de consultoria de nuvem e integraÃÂÃÂ§ÃÂÃÂ£o de sistemas. ""A AWS nos oferece um Well-Architected Framework para otimizar tempo, custos e a qualidade dos serviÃÂÃÂ§os que entregamos. Como resultado, nossas vendas cresceram 19 vezes desde que fundamos a empresa"", disse Budhi Wibawa, fundador e diretor executivo da ICS Compute. ""Com a nova regiÃÂÃÂ£o ÃÂÃÂsia-PacÃÂÃÂ­fico (Jakarta) da AWS, estamos ansiosos para ajudar nossos clientes a escalarem suas inovaÃÂÃÂ§ÃÂÃÂµes e acelerarem o crescimento. O lanÃÂÃÂ§amento da regiÃÂÃÂ£o melhora ainda mais a seguranÃÂÃÂ§a, escalabilidade, flexibilidade e confiabilidade que oferecemos a mais de 115 de nossos clientes, incluindo o aplicativo mÃÂÃÂ³vel getplus e e-wallet, o LinkAja! Os investimentos contÃÂÃÂ­nuos em inovaÃÂÃÂ§ÃÂÃÂ£o e infraestrutura da AWS tambÃÂÃÂ©m possibilitarÃÂÃÂ£o a expansÃÂÃÂ£o de nossos negÃÂÃÂ³cios e ajudarÃÂÃÂ£o a impulsionar a crescente comunidade tecnolÃÂÃÂ³gica na IndonÃÂÃÂ©sia ao contratar e treinar mais profissionais de nuvem para apoiar ainda mais a forÃÂÃÂ§a de trabalho local"". A plataforma de gestÃÂÃÂ£o de relacionamento com o cliente (Customer Relationship Management, CRM) lÃÂÃÂ­der global, a Salesforce, estÃÂÃÂ¡ planejando acelerar a transformaÃÂÃÂ§ÃÂÃÂ£o digital da sua base de clientes indonÃÂÃÂ©sios com a nova RegiÃÂÃÂ£o da AWS na ÃÂÃÂsia-PacÃÂÃÂ­fico (Jakarta). ""Estamos entusiasmados para combinar os serviÃÂÃÂ§os de nuvem da AWS com nossa confiÃÂÃÂ¡vel plataforma, a Hyperforce, para capacitar empresas indonÃÂÃÂ©sias, de startups a empreendimentos a vender, atender, comercializar e conduzir o comÃÂÃÂ©rcio"", disse Sujith Abraham, vice-presidente sÃÂÃÂªnior e gerente geral, ASEAN da Salesforce. ""Os contÃÂÃÂ­nuos investimentos da AWS em novas regiÃÂÃÂµes de infraestrutura trazem nossa plataforma Hyperforce para mercados que sÃÂÃÂ£o novos para nÃÂÃÂ³s como Jakarta, permitindo que os clientes implementem os aplicativos e serviÃÂÃÂ§os da Salesforce com seguranÃÂÃÂ§a de qualquer local com a escala e agilidade da AWS Cloud"". AWS investindo na IndonÃÂÃÂ©sia A nova regiÃÂÃÂ£o ÃÂÃÂsia-PacÃÂÃÂ­fico (Jakarta) da AWS ÃÂÃÂ© o mais recente dos contÃÂÃÂ­nuos investimentos da AWS na IndonÃÂÃÂ©sia. Em 2018, a AWS abriu um escritÃÂÃÂ³rio em Jakarta para apoiar sua base de clientes em rÃÂÃÂ¡pido crescimento em todo o paÃÂÃÂ­s com novos empregos incluindo especialistas tÃÂÃÂ©cnicos, arquitetos de soluÃÂÃÂ§ÃÂÃÂ£o, gerentes de conta tÃÂÃÂ©cnica (technical account managers, TAMs), gerentes de parceria, engenheiros de sistema e provedores de serviÃÂÃÂ§os profissionais. Em abril de 2020, a AWS lanÃÂÃÂ§ou a AWS Outposts, que oferece aos clientes e parceiros indonÃÂÃÂ©sios acesso ÃÂÃÂ mesma infraestrutura da AWS, serviÃÂÃÂ§os da AWS, interfaces de programaÃÂÃÂ§ÃÂÃÂ£o de aplicaÃÂÃÂ§ÃÂÃÂ£o (application programming interfaces, APIs) e ferramentas em virtualmente qualquer centro de dados, espaÃÂÃÂ§o de colocaÃÂÃÂ§ÃÂÃÂ£o, ou facilidade na premissa para uma verdadeira experiÃÂÃÂªncia hÃÂÃÂ­brida consistente. Hoje, a AWS Outposts permite que clientes e parceiros operem serviÃÂÃÂ§os importantes da AWS em seus prÃÂÃÂ³prios centros de dados, enquanto conectam-se com uma gama mais ampla de serviÃÂÃÂ§os na AWS Global Infrastructure. Em marÃÂÃÂ§o de 2021, a AWS lanÃÂÃÂ§ou seu primeiro local Amazon CloudFront inovador na IndonÃÂÃÂ©sia, oferecendo aos clientes na IndonÃÂÃÂ©sia uma latÃÂÃÂªncia de atÃÂÃÂ© 30% mais baixa. A Amazon CloudFront ÃÂÃÂ© uma rede de distribuiÃÂÃÂ§ÃÂÃÂ£o de conteÃÂÃÂºdo (content delivery network, CDN) altamente segura e programÃÂÃÂ¡vel que acelera a entrega de dados, vÃÂÃÂ­deos, aplicativos e APIs para usuÃÂÃÂ¡rios mundialmente, com baixa latÃÂÃÂªncia e altas velocidades de transferÃÂÃÂªncia. Em 2019, a AWS comprometeu-se a capacitar centenas de milhares de indonÃÂÃÂ©sios de todas as origens com proficiÃÂÃÂªncia da nuvem atÃÂÃÂ© 2025 em apoio ÃÂÃÂ iniciativa nacional ""Freedom of Learning"" (Merdeka Belajar). AtÃÂÃÂ© o momento, 200 mil indonÃÂÃÂ©sios foram treinados em habilidades da nuvem em colaboraÃÂÃÂ§ÃÂÃÂ£o com o governo indonÃÂÃÂ©sio e outras agÃÂÃÂªncias, incluindo instituiÃÂÃÂ§ÃÂÃÂµes educacionais e Parceiros da AWS. O programa investe em iniciativas para ajudar a forÃÂÃÂ§a de trabalho da IndonÃÂÃÂ©sia a se preparar para empregos do futuro focados na tecnologia, de alta remuneraÃÂÃÂ§ÃÂÃÂ£o e em demanda. A AWS permanece tambÃÂÃÂ©m fortemente comprometida em apoiar startups e negÃÂÃÂ³cios na IndonÃÂÃÂ©sia. Desde 2017, a AWS ajudou mais de 1.700 startups da IndonÃÂÃÂ©sia a desenvolver e escalar seus negÃÂÃÂ³cios da AWS. Nos prÃÂÃÂ³ximos cinco anos, a AWS planeja alcanÃÂÃÂ§ar mais de 1 milhÃÂÃÂ£o de beneficiÃÂÃÂ¡rios na IndonÃÂÃÂ©sia atravÃÂÃÂ©s de iniciativas de responsabilidade social corporativa sob a AWS InCommunities, que incluem educaÃÂÃÂ§ÃÂÃÂ£o em ciÃÂÃÂªncia, tecnologia, engenharia, artes e matemÃÂÃÂ¡tica (science, technology, engineering, arts and math, STEAM), desenvolvimento de forÃÂÃÂ§a de trabalho local em tecnologia, desenvolvimento comunitÃÂÃÂ¡rio e Iniciativas ambientais. Sobre a Amazon Web Services Por 15 anos, o Amazon Web Services tem sido a oferta em nuvem mais abrangente e amplamente adotada no mundo. A AWS tem expandido continuamente seus serviÃÂÃÂ§os para oferecer suporte a praticamente qualquer carga de trabalho em nuvem e agora tem mais de 200 serviÃÂÃÂ§os completos para computaÃÂÃÂ§ÃÂÃÂ£o, armazenamento, bancos de dados, redes, anÃÂÃÂ¡lises, aprendizado de mÃÂÃÂ¡quina e inteligÃÂÃÂªncia artificial (AI), Internet das Coisas (IoT), mobilidade, seguranÃÂÃÂ§a, hÃÂÃÂ­brido, realidade virtual e aumentada (VR e AR), desenvolvimento, implantaÃÂÃÂ§ÃÂÃÂ£o e gerenciamento de mÃÂÃÂ­dia e aplicativos de 84 zonas de disponibilidade em 26 regiÃÂÃÂµes geogrÃÂÃÂ¡ficas, com planos anunciados para mais 24 zonas de disponibilidade e mais oito regiÃÂÃÂµes da AWS na AustrÃÂÃÂ¡lia, CanadÃÂÃÂ¡, ÃÂÃÂndia, Israel, Nova ZelÃÂÃÂ¢ndia, Espanha, SuÃÂÃÂ­ÃÂÃÂ§a e Emirados ÃÂÃÂrabes Unidos. MilhÃÂÃÂµes de clientes ÃÂÃÂ inclusive as startups que mais crescem, as maiores empresas e as principais agÃÂÃÂªncias governamentais ÃÂÃÂ confiam na AWS para alimentar sua infraestrutura, tornar-se mais ÃÂÃÂ¡gil e reduzir custos. Para saber mais sobre a AWS, acesse aws.amazon.com. Sobre a Amazon A Amazon ÃÂÃÂ© orientada por quatro princÃÂÃÂ­pios: obsessÃÂÃÂ£o pelo cliente em vez de foco no concorrente, paixÃÂÃÂ£o por invenÃÂÃÂ§ÃÂÃÂ£o, compromisso com a excelÃÂÃÂªncia operacional e pensamento de longo prazo. A Amazon se dedica a ser a empresa mais centrada no cliente da Terra, a melhor empregadora da Terra, e o lugar mais seguro para trabalhar da Terra. AvaliaÃÂÃÂ§ÃÂÃÂµes de clientes, compras com um clique, recomendaÃÂÃÂ§ÃÂÃÂµes personalizadas, Prime, Fulfillment by Amazon, AWS, Kindle Direct Publishing, Kindle, Career Choice, tablets Fire, Fire TV, Amazon Echo, Alexa, a tecnologia Just Walk Out, e o The Climate Pledge sÃÂÃÂ£o algumas das coisas pioneiras da Amazon. Para saber mais, acesse amazon.com/about e siga @AmazonNews. O texto no idioma original deste anÃÂÃÂºncio ÃÂÃÂ© a versÃÂÃÂ£o oficial autorizada. As traduÃÂÃÂ§ÃÂÃÂµes sÃÂÃÂ£o fornecidas apenas como uma facilidade e devem se referir ao texto no idioma original, que ÃÂÃÂ© a ÃÂÃÂºnica versÃÂÃÂ£o do texto que tem efeito legal.",https://www.businesswire.com/news/home/20211212005170/pt/,businesswire.com,5,seattlebusiness wireamazon web service inc uma empresa da amazoncom nasdaqamzn anunciou hoje lanamento da regio siapacfico jakarta da aws partir de hoje desenvolvedores startup empreendedores e empreendimentos assim como organizaes governamentais educacionais e sem fin lucrativos podero executar suas aplicaes e servir usurios finais partir de centros de dado localizados na indonsia potencializando tecnologias aws avanadas para impulsionar inovao aws liberou um estudo de impacto econmico economic impact study eis estimando que o gastos da empresa na construo e operao da nova regio siapacfico jakarta da aws criar empregos diretos e indiretos com uma estimativa de u bilhes idr trilhes em investimento planejado na economia local regio adicionar uma estimativa de u bilhes idr trilhes decorrer do prximos ano para produto interno bruto pib da indonsia para mais informaes sobre infraestrutura global da aws acesse awsamazoncomaboutawsglobalinfrastructure nuvem oferece organizaes de todos o tipos e tamanhos de empresas instituies educacionais agncias governamentais oportunidades para transformar suas operaes e reinventar experincias para seus clientes e usurios finais disse prasad kalyanaraman vicepresidente de servios de infraestrutura da aws aws est entusiasmada em anunciar nova regio na siapacfico e ajudar instituies da indonsia startup inovadoras e empresas lderes mundiais entregar aplicaes alimentadas pela nuvem para fomentar desenvolvimento econmico em todo pa organizaes em todos o setores na indonsia podem agora aproveitar regio sia pacfico jakarta da aws para reduzir custos aumentar agilidade e impulsionar inovao infraestrutura da provedora de nuvem lder mundial desempenha um papel fundamental na acelerao de nossa economia digital disse perry warjiyo diretor bank indonesia banco central pa esperamos que tecnologia de nuvem da aws no ajude alcanar nossa viso e objetivos descritos plano de sistemas de pagamento da indonesia de digitalizando completamente o sistemas de pagamento pa e integrando uma multitude de partes interessadas e atividades econmicas sob o princpios de orientao de segurana e proteo de dado com lanamento da regio siapacfico jakarta da aws aws possui zona de disponibilidade em regies geogrficas globalmente com plano para lanar mais zona de disponibilidade e mais oito regies da aws na austrlia canad ndia israel nova zelndia espanha sua e emirados rabes unidos regies da aws compostas por zona de disponibilidade que posicionam infraestrutura em localidades geogrficas separadas e distintas zona de disponibilidade esto localizadas longe suficiente uma da outras para dar suporte continuidade do negcios do clientes ma perto suficiente para fornecer baixa latncia para aplicativos de alta disponibilidade que usam vrias zona de disponibilidade cada zona de disponibilidade possui energia resfriamento e segurana fsica independentes e est conectada por redes redundantes de latncia ultrabaixa o clientes da aws focados em alta disponibilidade podem criar seus aplicativos para rodarem em mltiplas zona de disponibilidade para alcanar uma tolerncia de falha ainda maior lanamento de uma regio da aws na indonsia oferece aos clientes uma latncia ainda mais baixa por todo pa e apoia aplicaes de recuperao de desastres para continuidade do negcios aws est planejando investir uma estimativa de u bilhes idr trilhes na indonsia durante o prximos ano atravs da nova regio sia pacfico jakarta da aws incluindo despesas de capital na construo de centros de dado despesas operacionais relativas custos contnuos de servios pblicos e de instalao e compras de ben e servios de empresas regionais investimento tambm estimado sustentar uma mdia de empregos diretos e indiretos anualmente durante esse tempo esses empregos faro parte de uma cadeia de suprimentos da aws na indonsia incluindo construo manuteno de instalao engenharia telecomunicaes e empregos dentro da economia mais abrangente da indonsia construo e operao da infraestrutura da aws na indonsia tambm estimada adicionar mais de u bilhes idr trilhes para pib da indonsia durante o prximos ano clientes e parceiros da aws boasvindas regio sia pacfico jakarta da aws clientes na indonsia unemse milhes de clientes ativos usando aws todos o meses em mais de pas em todo mundo para acelerar inovao aumentar agilidade e impulsionar reduo de custos organizaes por toda indonsia que mudaram suas cargas de trabalho de misso crtica para nuvem incluem adskom amartha anter aja asean foundation bhinekka bizzy bridestory bank commonwealth indonesia dinas komunikasi dan informatika jawa barat elevenia finaccel happyfresh haldin hara token halodoc jawa po kumparan kompas lion air mnc group mamikos optik melawai optik seis sayurbox sekolahmu shipper sicepat simak online sociolla body shop tokopedia traveloka e xl axiata mnc group um conglomerado multinacional indonsio na mdia servios financeiros entretenimento hospitalidade ecommerce e outros negcios digitais escolheram aws como sua provedora de nuvem preferida para impulsionar ainda mais sua transformao digital e melhorar experincia cliente capacidades da aws cloud impulsionam com sucesso desempenho de mnc portal indonesia oferecendo uma experincia incomparvel para seus visualizadores transformamos nosso negcio de mdia com aws e estamos agora buscando repetir esse sucesso com nossos negcios de servios financeiros digitais disse yudi hamka diretor de tecnologia mnc group estamos ansiosos para usar capacidades avanadas da aws como analtica e aprendizado de mquina para melhor entender nossos clientes prever tendncias e preferncias futuras e solucionar desafios financeiros de uma forma mais significativa regio siapacfico jakarta da aws ser instrumental para alcanar isso oferecendo o mais alto nveis de segurana em baixa latncia que de importncia fundamental para setor de servios financeiros pt po indonesia persero provedora do servios postais da nao trabalha com aws como parte da sua jornada de digitalizao regio siapacfico jakarta da aws no ajudar alinhar e transformar digitalmente nossos negcios e prioridades sociais para oferecer servios pblicos mais eficazes para benefcio de todos o indonsios disse dr faizal rochmad djoemadi diretor executivo da pt po indonesia persero digitalizao e automao de processos tradicionais juntamente com expanso do negcios possibilitada por aplicaes digitais desempenharo um importante papel na estratgia futura da pt po indonesia persero pt po indonesia persero planeja mover suas cargas de trabalho crticas e essenciais incluindo transferncia digital de dinheiro para aws na regio siapacfico jakarta da aws ruparupacom um do site de compras online lder na indonsia com mais de mil clientes pa site combina experincias de compra convencional e online com stop store pick service permitindo que o clientes comprem online e recolham seus pedidos em determinadas lojas por toda indonsia nossa plataforma ecommerce est crescendo rapidamente medida que pandemia da covid incentivou mais clientes comprar online e com escalabilidade da aws podemos lidar facilmente com essa demanda crescente disse ronny winoto diretor de tecnologia da ruparupacom j estamos executando maioria da nossa infraestrutura na nuvem lder mundial e ao aproveitar regio siapacfico jakarta da aws podemos melhorar ainda mais nossa experincia cliente com servios ecommerce inovadores halodoc uma startup de tecnologia da sade baseada em jakarta operando com aws est apoiando vacinao nacional da covid testis e iniciativas de telemedicina da indonsia covid levou muitos buscar por servios de assistncia mdica alternativos acessveis remotamente quando nosso trfego aumentou significativamente incio da pandemia estvamos confiantes que poderamos enfrentar o desafios em razo da slida equipe adicional que inclui aws atualmente estamos explorando tambm outras tecnologias da aws tai como aprendizado de mquina para elevar experincia usurio ao usar nossa aplicao disse alfonsius timboel diretor de produto da halodoc disponibilidade da regio siapacfico jakarta da aws no ajuda atender nossa misso para tornar cuidados mdicos de qualidade acessveis todos atravs de nossa rede de mil mdicos licenciados mil hospitaisclnicoslaboratrios e mil farmcias registradas que esto espalhadas por centenas de cidades na indonsia e conectadas pela nossa plataforma digital que usa tecnologia confivel da aws tokopedia uma empresa de tecnologia indonsia e um marketplace online lder com mais de milhes de usurios mensais ativos e milhes de parceiros comerciais confiam suas cargas de trabalho de misso crtica para aws indonsia est vendo um aumento na adoo digital e crescimento acelerado o servios de nuvem tai como aws reduzem trabalho pesado necessrio para gerenciar infraestrutura e no permite focar na necessidades cliente regio siapacfico jakarta da aws permitir que continuemos focar na construo e fortalecimento de nossas capacidades comerciais enquanto utilizamos melhor tecnologia em termos de computao essencial e infraestrutura tecnolgica para atender necessidades de nossos negcios e clientes disse herman widjaja diretor de tecnologia da tokopedia aws partner network apn inclui dezenas de milhares de fornecedores independentes de software independent software vendor isvs e integradores de sistemas system integrator si ao redor mundo parceiros da aws constroem solues e servios inovadores na aws e apn fornece suporte empresarial tcnico de marketing e de entrada mercado aos clientes si parceiros consultores e isvs da aws ajudam clientes empresariais e setor pblico migrar para aws implantar aplicativos de misso crtica e fornecer uma completa gama de servios de monitoramento automao e gerenciamento para ambientes de nuvem do clientes exemplos de parceiros da aws na indonsia incluem metrodata pt berca hardayaperkasa pt innovation cloud service ic compute salesforce e muitos outros acesse awsamazoncompartners para lista completa de parceiros da aws pt innovation cloud service ic compute uma firma de consultoria de nuvem e integrao de sistemas aws no oferece um wellarchitected framework para otimizar tempo custos e qualidade do servios que entregamos como resultado nossas vendas cresceram vezes desde que fundamos empresa disse budhi wibawa fundador e diretor executivo da ic compute com nova regio siapacfico jakarta da aws estamos ansiosos para ajudar nossos clientes escalarem suas inovaes e acelerarem crescimento lanamento da regio melhora ainda mais segurana escalabilidade flexibilidade e confiabilidade que oferecemos mais de de nossos clientes incluindo aplicativo mvel getplus e ewallet linkaja o investimentos contnuos em inovao e infraestrutura da aws tambm possibilitaro expanso de nossos negcios e ajudaro impulsionar crescente comunidade tecnolgica na indonsia ao contratar e treinar mais profissionais de nuvem para apoiar ainda mais forum de trabalho local plataforma de gesto de relacionamento com cliente customer relationship management crm lder global salesforce est planejando acelerar transformao digital da sua base de clientes indonsios com nova regio da aws na siapacfico jakarta estamos entusiasmados para combinar o servios de nuvem da aws com nossa confivel plataforma hyperforce para capacitar empresas indonsias de startup empreendimentos vender atender comercializar e conduzir comrcio disse sujith abraham vicepresidente snior e gerente geral asean da salesforce o contnuos investimentos da aws em nova regies de infraestrutura trazem nossa plataforma hyperforce para mercados que novos para n como jakarta permitindo que o clientes implementem o aplicativos e servios da salesforce com segurana de qualquer local com escala e agilidade da aws cloud aws investindo na indonsia nova regio siapacfico jakarta da aws mais recente do contnuos investimentos da aws na indonsia em aws abriu um escritrio em jakarta para apoiar sua base de clientes em rpido crescimento em todo pa com novos empregos incluindo especialistas tcnicos arquitetos de soluo gerentes de conta tcnica technical account manager tam gerentes de parceria engenheiros de sistema e provedores de servios profissionais em abril de aws lanou aws outpost que oferece aos clientes e parceiros indonsios acesso mesma infraestrutura da aws servios da aws interface de programao de aplicao application programming interface apis e ferramentas em virtualmente qualquer centro de dado espao de colocao ou facilidade na premissa para uma verdadeira experincia hbrida consistente hoje aws outpost permite que clientes e parceiros operem servios importantes da aws em seus prprios centros de dado enquanto conectamse com uma gama mais ampla de servios na aws global infrastructure em maro de aws lanou seu primeiro local amazon cloudfront inovador na indonsia oferecendo aos clientes na indonsia uma latncia de mais baixa amazon cloudfront uma rede de distribuio de contedo content delivery network cdn altamente segura e programvel que acelera entrega de dado vdeos aplicativos e apis para usurios mundialmente com baixa latncia e altas velocidades de transferncia em aws comprometeuse capacitar centenas de milhares de indonsios de toda origen com proficincia da nuvem em apoio iniciativa nacional freedom learning merdeka belajar momento mil indonsios foram treinados em habilidades da nuvem em colaborao com governo indonsio e outras agncias incluindo instituies educacionais e parceiros da aws programa investe em iniciativas para ajudar forum de trabalho da indonsia se preparar para empregos futuro focados na tecnologia de alta remunerao e em demanda aws permanece tambm fortemente comprometida em apoiar startup e negcios na indonsia desde aws ajudou mais de startup da indonsia desenvolver e escalar seus negcios da aws no prximos cinco ano aws planeja alcanar mais de milho de beneficirios na indonsia atravs de iniciativas de responsabilidade social corporativa sob aws incommunities que incluem educao em cincia tecnologia engenharia artes e matemtica science technology engineering art math steam desenvolvimento de forum de trabalho local em tecnologia desenvolvimento comunitrio e iniciativas ambientais sobre amazon web service por ano amazon web service tem sido oferta em nuvem mais abrangente e amplamente adotada mundo aws tem expandido continuamente seus servios para oferecer suporte praticamente qualquer carga de trabalho em nuvem e agora tem mais de servios completos para computao armazenamento bancos de dado redes anlises aprendizado de mquina e inteligncia artificial ai internet da coisas iot mobilidade segurana hbrido realidade virtual e aumentada vr e ar desenvolvimento implantao e gerenciamento de mdia e aplicativos de zona de disponibilidade em regies geogrficas com plano anunciados para mais zona de disponibilidade e mais oito regies da aws na austrlia canad ndia israel nova zelndia espanha sua e emirados rabes unidos milhes de clientes inclusive startup que mais crescem maiores empresas e principais agncias governamentais confiam na aws para alimentar sua infraestrutura tornarse mais gil e reduzir custos para saber mais sobre aws acesse awsamazoncom sobre amazon amazon orientada por quatro princpios obsesso pelo cliente em vez de foco concorrente paixo por inveno compromisso com excelncia operacional e pensamento de longo prazo amazon se dedica ser empresa mais centrada cliente da terra melhor empregadora da terra e lugar mais seguro para trabalhar da terra avaliaes de clientes compras com um clique recomendaes personalizadas prime fulfillment amazon aws kindle direct publishing kindle career choice tablet fire fire tv amazon echo alexa tecnologia walk e climate pledge algumas da coisas pioneiras da amazon para saber mais acesse amazoncomabout e siga amazonnews texto idioma original deste anncio verso oficial autorizada tradues fornecidas apenas como uma facilidade e devem se referir ao texto idioma original que nica verso texto que tem efeito legal,-0.9287,-0.46435,0.1121271429,-0.576477143,Negative Impact
16/12/2021,173.3685,174.17,168.16,168.87,168.87,60876000,3.3,50.56966791,1.192,0,13.66057312,0.8419472675,0.2413396506,0.08,278.802,15180.42969,16849.08984,7260.600098,7005.069824,3675.02002,57901.14063,20739.80078,172.221521,168.4316452,172.6612203,167.6346746,174.9202515,184.1674895,165.6730134,40.61144208,-0.869586958,-0.102506895,-0.767080063,4.955964225,176.2963518,10391818000,25.16943477,30.61509849,20.56999969,New Amazon Health Lead May Take a Page From Prime Membership Model on Healthcare,"On the news that Amazon's Neil Lindsay, who had been senior vice president of Prime and marketing, will now lead the eCommerce titan's Amazon Care health unit, it's worth considering how his experiences running Prime may inform and shape the company's future healthcare offerings.",https://www.pymnts.com/amazon/2021/new-amazon-health-lead-may-take-page-from-prime-membership-model/,pymnts.com,5,news amazon neil lindsay senior vice president prime marketing lead ecommerce titan amazon care health unit worth considering experience running prime may inform shape company future healthcare offering,0.7579,0.37895,-0.074449,0.453399,Positive Impact
17/12/2021,167.7105,170.90,165.61,170.02,170.02,85542000,3.3,50.56966791,1.192,0,13.66057312,0.8419472675,0.2413396506,0.08,278.802,15169.67969,16668.64063,7269.899902,6926.629883,3632.360107,57011.73828,20739.19922,172.3194409,168.5316177,172.557545,167.6583843,174.1809769,182.4095155,165.9524383,37.46383566,-0.990678666,-0.280141249,-0.710537416,5.006892613,175.852298,10477360000,34.21788571,36.2197161,21.56999969,Amazon (AMZN) to Boost Grocery Initiatives With New Plans,Amazon (AMZN) intends to expand its grocery delivery service Amazon Fresh Marketplace to the United States and the majority of Europe.,https://www.zacks.com/stock/news/1840620/amazon-amzn-to-boost-grocery-initiatives-with-new-plans,zacks.com,8,amazon amzn intends expand grocery delivery service amazon fresh marketplace united state majority europe,0.8316,0.66528,0.1512933333,0.5139866667,Positive Impact
20/12/2021,166.85,167.87,165.60,167.08,167.08,57372000,3.3,50.56966791,1.192,0,13.66057312,0.8419472675,0.2413396506,0.08,278.802,14980.94043,16442.31055,7198,6870.100098,3593.600098,55822.01172,20538.19922,172.3724008,168.6290252,172.3426999,167.6526192,173.3435013,180.8120746,165.8749279,37.21669558,-1.308672122,-0.485847424,-0.822824698,4.987570626,175.4260064,10419988000,14.71980639,24.70237562,22.87000084,The Valuation of Gores Guggenheim Is High Given Polestar's Weaknesses,"GGPI stock is trading at an elevated valuation, given the tough competition that Polestar is facing in the consumer EV market. The post The Valuation of Gores Guggenheim Is High Given Polestar's Weaknesses appeared first on InvestorPlace.",https://investorplace.com/2021/12/the-valuation-of-ggpi-stock-is-high-given-polestars-weaknesses/,investorplace.com,6,ggpi stock trading elevated valuation given tough competition polestar facing consumer ev market post valuation gore guggenheim high given polestar weakness appeared first investorplace,-0.5106,-0.30636,0.07185571429,-0.378215714,Negative Impact
21/12/2021,167.8505,170.72,165.65,170.42,170.42,55956000,3.3,50.56966791,1.192,0,13.66057312,0.8419472675,0.2413396506,0.08,278.802,15341.08984,16744.26953,7297.399902,6964.990234,3625.129883,56319.01172,20924.90039,172.5344409,168.7153977,172.2671826,167.6801256,172.9329269,180.073837,165.7920169,47.28139517,-1.276618437,-0.644001626,-0.63261681,4.927213396,175.0167664,10475944000,42.43979628,30.45916279,21.01000023,The Last Last Mile,"In the first quarter of this year alone, instant-delivery startups raised nearly $8 billion - more than in all of 2020. Some instant-delivery companies say they're competing with supermarkets. Jokr's co-founder says he's coming after Amazon.",https://seekingalpha.com/article/4476324-the-last-last-mile,seekingalpha.com,6,first quarter year alone instantdelivery startup raised nearly billion instantdelivery company say theyre competing supermarket jokrs cofounder say he coming amazon,-0.0772,-0.04632,0.335827,-0.382147,Negative Impact
22/12/2021,169.27,172.05,168.50,171.04,171.04,55036000,3.3,50.56966791,1.192,0,13.66057312,0.8419472675,0.2413396506,0.08,278.802,15521.88965,16874.88086,7341.700195,7051.669922,3622.620117,56930.55859,21070.09961,172.707851,168.8061727,172.2189402,167.7135273,172.5346771,179.1170086,165.9523456,48.73466896,-1.187498492,-0.752701,-0.434797493,4.934499468,174.623896,10530980000,47.47856798,34.87939022,18.62999916,Worried Over Big Tech Regulation? Bet on These 3 Smaller Stocks,"Here is a sneak-peek into three promising small tech companies that hold promise, given the challenging regulatory scenario being faced by the tech giants.",https://www.zacks.com/stock/news/1842233/worried-over-big-tech-regulation-bet-on-these-3-smaller-stocks,zacks.com,8,sneakpeek three promising small tech company hold promise given challenging regulatory scenario faced tech giant,0.6808,0.54464,0.120446,0.424194,Positive Impact
23/12/2021,170.428,171.98,170.15,171.07,171.07,36788000,3.3,50.56966791,1.192,0,13.66057312,0.8419472675,0.2413396506,0.08,278.802,15653.37012,16963.43945,7373.299805,7106.149902,3643.340088,57315.28125,21218.90039,172.8449408,168.8831177,172.1738248,167.7469101,172.1370773,177.9901168,166.2840378,52.58936449,-1.101630075,-0.822486815,-0.27914326,4.596035549,174.2467405,10567768000,47.73452449,45.88429625,17.95999908,These Health-Tech Deals Highlight a Big Private Investing Trend,Most of Google's products have been built up by acquiring companies that fill its blind spots. Biotech companies are doing the same thing.,https://investorplace.com/venturecapitaldigest/2021/12/these-health-tech-deals-highlight-a-big-private-investing-trend/,investorplace.com,6,google product built acquiring company fill blind spot biotech company thing,-0.4019,-0.24114,0.2466335714,-0.487773571,Negative Impact
27/12/2021,171.037,172.94,169.22,169.67,169.67,58688000,3.3,50.56966791,1.192,0,13.66057312,0.8419472675,0.2413396506,0.08,278.802,15871.25977,17141.08984,7373.299805,7140.390137,3615.969971,57420.23828,21218.90039,172.9384708,168.9590926,172.0756158,167.7660403,171.8591522,177.6213918,166.0969127,47.16926929,-1.133401365,-0.884669725,-0.24873164,4.379356384,173.8846712,10509080000,36.36467354,43.85925534,17.68000031,"Amazon has mostly avoided antitrust scrutiny, but that may change in 2022","Amazon.com Inc. has largely escaped the gaze of lawmakers in the antitrust battle, but that is changing rapidly and could lead to some challenges in 2022.",https://www.marketwatch.com/story/amazon-has-mostly-avoided-antitrust-scrutiny-but-that-may-change-in-2022-11640641305,marketwatch.com,8,amazoncom inc largely escaped gaze lawmaker antitrust battle changing rapidly could lead challenge,-0.3182,-0.25456,0.09509,-0.34965,Negative Impact
28/12/2021,170.1825,172.18,169.14,170.66,170.66,54638000,3.3,50.56966791,1.192,0,13.66057312,0.8419472675,0.2413396506,0.08,278.802,15781.71973,17134.16016,7373.299805,7181.109863,3630.112061,57897.48047,21218.90039,172.9426706,169.0419776,172.0201405,167.7948458,171.4882767,176.4665539,166.5099994,39.49932573,-1.066283062,-0.920992392,-0.14529067,4.158606393,173.5370846,10563718000,45.60696571,43.23538791,17.54000092,3 Things About Wish That Smart Investors Know,Did you overlook these facts about the fallen e-commerce company?,https://www.fool.com/investing/2021/12/28/3-things-about-wish-that-smart-investors-know/,fool.com,7,overlook fact fallen ecommerce company,-0.3612,-0.25284,0.1443,-0.39714,Negative Impact
29/12/2021,170.84,171.21,168.60,169.20,169.20,35754000,3.3,50.56966791,1.192,0,13.66057312,0.8419472675,0.2413396506,0.08,278.802,15766.21973,17149.92969,7420.700195,7161.52002,3597,57806.48828,21344.69922,172.8799506,169.1150176,171.9095861,167.8088375,171.1806519,175.9072711,166.4540327,37.42362054,-1.118012677,-0.960396449,-0.157616228,4.171607971,173.2034015,10527964000,34.022676,38.66477175,16.95000076,A Tight Technical Leash On Shiba Inu?,"It hasn't been an unusual bear market in Shiba Inu, but SHIB-USD has other inherent problems other than as a trading vehicle. The post A Tight Technical Leash On Shiba Inu?",https://investorplace.com/2021/12/a-tight-technical-leash-on-shiba-inu/,investorplace.com,6,hasnt unusual bear market shiba inu shibusd inherent problem trading vehicle post tight technical leash shiba inu,-0.4019,-0.24114,0.2169866667,-0.458126667,Negative Impact
30/12/2021,169.7,170.89,168.52,168.64,168.64,37584000,3.3,50.56966791,1.192,0,13.66057312,0.8419472675,0.2413396506,0.08,278.802,15741.55957,17164.24023,7403,7173.22998,3619.189941,57794.32031,21294.59961,172.8086905,169.1743076,171.7815435,167.8171525,171.0035767,175.835785,166.1713683,39.46469596,-1.190194118,-1.006355983,-0.183838135,4.138322013,172.8830657,10490380000,32.14214624,37.25726265,17.32999992,"ONLN: Buying Weakness Makes Sense, But Not With This Fund","ONLN: Buying Weakness Makes Sense, But Not With This Fund",https://seekingalpha.com/article/4477261-onln-etf-buying-weakness-not-make-sense,seekingalpha.com,6,onln buying weakness make sense fund,-0.4215,-0.2529,0.09077142857,-0.343671429,Negative Impact
31/12/2021,168.956,169.35,166.56,166.72,166.72,47830000,3.3,50.56966791,1.192,0,13.66057312,0.8419472675,0.2413396506,0.08,278.802,15644.96973,17164.13086,7384.5,7153.029785,3639.780029,58253.82031,21222.80078,172.7279703,169.2508951,171.5829338,167.8062057,170.7460266,175.9211604,165.5708928,39.51214057,-1.386944186,-1.082473623,-0.304470562,3.950072152,172.5755434,10442550000,16.96565707,27.71015977,17.21999931,New to the Stock Market? 3 Investments You Can't Go Wrong With,These three investments would all serve as pillars of any long-term portfolio.,https://www.fool.com/investing/2021/12/31/new-to-the-stock-market-3-investments-you-cant-go/,fool.com,7,three investment would serve pillar longterm portfolio,0,0,0.270705,-0.270705,Negative Impact
03/01/2022,167.55,170.70,166.16,170.40,170.40,63520000,-0.27,-314.4290963,1.192,0,14.33339876,0.959429757,-0.018638346,0.08,281.148,15832.7998,17226.09961,7384.5,7217.220215,3639.780029,59183.21875,21222.80078,172.7010501,169.3341776,171.5367205,167.8320593,170.7917763,175.936226,165.6473265,51.5363256,-1.231127923,-1.112204483,-0.11892344,4.05442919,172.280322,10506070000,58.07035955,35.72605429,16.60000038,Future Retail Wants Amazon Arbitration Ruled Illegal,"Indian department store chain Future Retail recently asked a New Delhi court to declare its arbitration proceedings with Amazon in Singapore illegal, saying India's antitrust agency had suspended a 2019 deal that Amazon used to assert its power over Future before it was factored into the arbitration. Amazon used its $200 million investment in Future [ÃÂÃÂ]",https://www.pymnts.com/news/retail/2022/future-retail-wants-amazon-arbitration-ruled-illegal/,pymnts.com,5,indian department store chain future retail recently asked new delhi court declare arbitration proceeding amazon singapore illegal saying india antitrust agency suspended deal amazon used assert power future factored arbitration amazon used million investment future,-0.5574,-0.2787,0.18393,-0.46263,Negative Impact
04/01/2022,170.438,171.40,166.35,167.52,167.52,70726000,-0.27,-314.4290963,1.192,0,14.33339876,0.959429757,-0.018638346,0.08,281.148,15622.71973,17336.75977,7505.200195,7317.410156,3632.330078,59855.92969,21236.5,172.7159402,169.3940701,171.3792806,167.8289742,170.5994514,175.9370935,165.2618094,47.35296948,-1.324962094,-1.154756005,-0.170206088,4.19178554,171.9969094,10435344000,25.93911107,33.6583759,16.90999985,India court dismisses Future's plea to declare arbitration with Amazon illegal,An Indian court on Tuesday dismissed Future Retail's plea to declare arbitration proceedings with its warring partner Amazon.com Inc as illegal.,https://www.reuters.com/business/india-court-dismisses-futures-plea-declare-arbitration-with-amazon-illegal-2022-01-04/,reuters.com,10,indian court tuesday dismissed future retail plea declare arbitration proceeding warring partner amazoncom inc illegal,-0.7579,-0.7579,-0.06368,-0.69422,Negative Impact
05/01/2022,166.883,167.13,164.36,164.36,164.36,64302000,-0.27,-314.4290963,1.192,0,14.33339876,0.959429757,-0.018638346,0.08,281.148,15100.16992,17112.59961,7516.899902,7376.370117,3595.179932,60223.14844,21039.69922,172.6827103,169.43148,171.1038969,167.7944271,170.0090759,175.3669444,164.6512074,34.33258039,-1.635858925,-1.250976589,-0.384882336,3.817500523,171.7248333,10371042000,0,28.00315688,19.72999954,"Roku tumbles after analyst says competition from Amazon, Google is stunting user growth","Roku shares dropped almost 10% on Wednesday, falling to their lowest price since October 2020.",https://www.cnbc.com/2022/01/05/roku-drops-on-concern-of-increased-competition-from-amazon-google.html,cnbc.com,9,roku share dropped almost wednesday falling lowest price since october,-0.1174,-0.10566,0.2366538889,-0.342313889,Negative Impact
06/01/2022,163.4505,164.80,161.94,163.25,163.25,51958000,-0.27,-314.4290963,1.192,0,14.33339876,0.959429757,-0.018638346,0.08,281.148,15080.86035,17156.51953,7450.399902,7249.660156,3586.080078,59601.83984,21072.19922,172.5717203,169.4759825,170.7960577,167.7492487,169.3638756,174.7118348,164.0159164,38.87590143,-1.948785147,-1.390538301,-0.558246846,3.593037197,171.3999939,10319084000,11.96621604,12.63510904,19.61000061,This Emerging-Market Stock Could Help Make You a Fortune in 2022,This stock bridges the gap between emerging-market consumers who have extra cash but lack an online payment method.,https://www.fool.com/investing/2022/01/06/this-emerging-market-stock-could-help-make-you-a-f/,fool.com,7,stock bridge gap emergingmarket consumer extra cash lack online payment method,-0.3182,-0.22274,0.137652,-0.360392,Negative Impact
07/01/2022,163.839,165.24,162.03,162.55,162.55,46606000,-0.27,-314.4290963,1.192,0,14.33339876,0.959429757,-0.018638346,0.08,281.148,14935.90039,17166.2793,7485.299805,7219.47998,3579.540039,59744.64844,21084.5,172.4303104,169.5271875,170.4728398,167.6975547,168.7830254,174.4467851,163.1192656,34.95292637,-2.227587099,-1.557948061,-0.669639039,3.445000785,170.6429541,10272478000,5.60607468,5.857430239,18.76000023,Amazon cuts paid Covid leave time for workers following changes to CDC guidance,"Amazon will now offer one week, or up to 40 hours, paid Covid leave for all U.S. employees, instead of two weeks paid leave.",https://www.cnbc.com/2022/01/07/amazon-cuts-paid-covid-leave-for-workers-as-cdc-guidance-shifts.html,cnbc.com,9,amazon offer one week hour paid covid leave u employee instead two week paid leave,0.0772,0.06948,0.3171566667,-0.247676667,Negative Impact
10/01/2022,160.5855,161.66,156.30,161.49,161.49,87798000,-0.27,-314.4290963,1.192,0,14.33339876,0.959429757,-0.018638346,0.08,281.148,14942.83008,17119.56055,7445.299805,7115.77002,3593.52002,60395.62891,21072.30078,172.2134601,169.57161,170.1204144,167.6357481,168.2467247,174.5397074,161.953742,37.80418582,-2.505833322,-1.747525113,-0.758308209,3.57585798,169.9464775,10184680000,31.14157847,16.2379564,19.39999962,How to Beat the S&P 500 in 2022,The S&P 500's up nearly 25% over the past year. Can it be beaten?,https://www.fool.com/investing/2022/01/10/how-to-beat-the-sp-500-in-2022/,fool.com,7,sp nearly past year beaten,-0.4215,-0.29505,0.140241,-0.435291,Negative Impact
11/01/2022,161.5,166.35,160.70,165.36,165.36,62806000,-0.27,-314.4290963,1.192,0,14.33339876,0.959429757,-0.018638346,0.08,281.148,15153.4502,17294.53906,7491.399902,7183.379883,3567.439941,60616.89063,21274.80078,172.14827,169.6294875,169.9338099,167.6131237,168.0364494,174.4239473,161.6489516,39.2299995,-2.386078848,-1.87523586,-0.510842988,3.617250715,168.5822802,10247486000,54.43700592,30.39488636,18.40999985,Amazon One: The Future Of Contactless Payments,"In 2020, Amazon introduced Amazon One, a convenient and secure way for somebody to pay or be identified with the palm of their hand. This fall, Amazon announced a partnership with AXS to use Amazon One at the Red Rocks Amphitheater, so theatergoers can use their palm as their ticket for admission.",https://seekingalpha.com/article/4478679-amazon-one-the-future-of-contactless-payments,seekingalpha.com,6,amazon introduced amazon one convenient secure way somebody pay identified palm hand fall amazon announced partnership ax use amazon one red rock amphitheater theatergoer use palm ticket admission,0.8402,0.50412,0.194164,0.309956,Positive Impact
12/01/2022,166.575,166.88,164.42,165.21,165.21,50030000,-0.27,-314.4290963,1.192,0,14.33339876,0.959429757,-0.018638346,0.08,281.148,15188.38965,17353.75977,7551.700195,7237.189941,3597.429932,61150.03906,21395,172.1342999,169.6917,169.7484448,167.5891822,167.8422241,174.3300877,161.3543605,37.32773918,-2.277426912,-1.95567407,-0.321752841,3.539500645,167.3545026,10197456000,53.50543827,46.36134089,17.62000084,3 Blue-Chip Bargains I Just Bought For My 401(k) And So Should You,"Maxing out your retirement accounts is one of the smartest and most tax-efficient strategies you can use to retire in safety and splendor. At the start of every year, I max out my SEP 401(k) accounts to save $14,000 per year in taxes and benefit from Ultra SWAN yield and hyper-growth.",https://seekingalpha.com/article/4479399-3-blue-chip-bargains-i-just-bought-for-my-401k-and-so-should-you,seekingalpha.com,6,maxing retirement account one smartest taxefficient strategy use retire safety splendor start every year max sep k account save per year tax benefit ultra swan yield hypergrowth,0.9517,0.57102,0.170786,0.400234,Positive Impact
13/01/2022,165.2505,166.22,161.09,161.21,161.21,52188000,-0.27,-314.4290963,1.192,0,14.33339876,0.959429757,-0.018638346,0.08,281.148,14806.80957,17259.01953,7563.899902,7201.140137,3555.26001,61235.30078,21293,172.0458301,169.72425,169.4137609,167.5257476,167.2371742,173.8322132,160.6421353,31.72692013,-2.48487678,-2.061514612,-0.423362168,3.775606428,166.3500061,10145268000,29.50688725,45.81644382,20.30999947,Why Amazon Stock Traded Lower on Thursday,It wasn't just the down market that dragged the cloud computing giant lower. It may be losing share to a competitor.,https://www.fool.com/investing/2022/01/13/why-amazon-stock-traded-lower-on-thursday/,fool.com,7,wasnt market dragged cloud computing giant lower may losing share competitor,-0.351,-0.2457,0.1633654545,-0.409065455,Negative Impact
14/01/2022,160.15,162.25,159.80,162.14,162.14,45974000,-0.27,-314.4290963,1.192,0,14.33339876,0.959429757,-0.018638346,0.08,281.148,14893.75,17219.06055,7543,7143,3521.26001,61223.03125,21357.59961,171.9045901,169.74469,169.1284369,167.4721382,166.9005241,173.8236292,159.9774191,35.78400199,-2.545381964,-2.158288082,-0.387093881,3.684320722,166.878006,10191242000,36.7545575,39.92229434,19.19000053,Children's robes sold on Amazon recalled due to burn risk,"HulovoX, a retailer in China, issued the recall for thousands of robes sold on Amazon because they don't meet the flammability standards for children's sleepwear and pose ""a risk of burn injuries to children,"" according to the recall notice.",https://www.foxbusiness.com/lifestyle/amazon-bathrobes-burn-risk-recall,foxbusiness.com,5,hulovox retailer china issued recall thousand robe sold amazon dont meet flammability standard childrens sleepwear pose risk burn injury child according recall notice,-0.4939,-0.24695,0.152258,-0.399208,Negative Impact
18/01/2022,159.105,159.73,157.66,158.92,158.92,67292000,-0.27,-314.4290963,1.192,0,14.33339876,0.959429757,-0.018638346,0.08,281.148,14506.90039,16950.91016,7563.600098,7133.830078,3569.909912,60754.85938,21274.59961,171.6059399,169.732595,168.7280079,167.3870174,166.3455238,173.9615355,158.7295122,29.55412476,-2.82068547,-2.29076756,-0.52991791,3.786677769,166.2214966,10123950000,17.30974893,27.85706456,22.79000092,10 Top Stocks That Can Make You Richer in 2022,Building wealth is easy when you owns stakes in high-quality businesses.,https://www.fool.com/investing/2022/01/18/10-top-stocks-thatll-make-you-richer-in-2022/,fool.com,7,building wealth easy owns stake highquality business,0.7269,0.50883,0.26689,0.24194,Positive Impact
19/01/2022,158.762,159.25,156.25,156.30,156.30,53242000,-0.27,-314.4290963,1.192,0,14.33339876,0.959429757,-0.018638346,0.08,281.148,14340.25977,16818.98047,7589.700195,7172.97998,3558.179932,60098.82031,21205.19922,171.21293,169.708135,168.2405956,167.2766888,165.8065239,174.6335349,156.9795129,28.40813679,-3.213117709,-2.47523759,-0.737880119,3.814426967,165.2297974,10070708000,0.323405884,18.12923744,23.85000038,"Got $3,000? 5 Buffett Stocks to Buy and Hold Forever",These Berkshire Hathaway-backed winners could supercharge your portfolio.,https://www.fool.com/investing/2022/01/19/got-3000-5-buffett-stocks-to-buy-and-hold-forever/,fool.com,7,berkshire hathawaybacked winner could supercharge portfolio,0.5859,0.41013,0.14449,0.26564,Positive Impact
20/01/2022,156.766,158.00,151.35,151.67,151.67,71974000,-0.27,-314.4290963,1.192,0,14.33339876,0.959429757,-0.018638346,0.08,281.148,14154.01953,16663.76953,7585,7194.160156,3555.060059,59464.62109,21058.19922,170.7572998,169.646625,167.5906702,167.1213734,164.8690483,175.4438937,154.294203,24.99852814,-3.853426545,-2.750875381,-1.102551164,4.120498657,164.1522217,9998734000,1.578621708,6.403925508,25.59000015,Amazon is opening a real-world clothing store with high-tech fitting rooms,"Amazon has made an effort to increase its apparel share in recent years, launching a range of private label brands and luxury stores to court online shoppers.",https://www.cnbc.com/2022/01/20/amazon-opening-new-apparel-store-amazon-style-with-fitting-rooms.html,cnbc.com,9,amazon made effort increase apparel share recent year launching range private label brand luxury store court online shopper,0.6369,0.57321,0.1707608,0.4024492,Positive Impact
21/01/2022,149.95,150.90,142.07,142.64,142.64,163972000,-0.27,-314.4290963,1.192,0,14.33339876,0.959429757,-0.018638346,0.08,281.148,13768.91992,16397.33984,7494.100098,7068.589844,3522.570068,59037.17969,20621.40039,170.0339301,169.535015,166.6123304,166.8778076,163.4493484,177.5678119,149.330885,20.67651803,-5.031081684,-3.206916642,-1.824165043,4.60660553,162.3600504,9834762000,1.951993041,1.284673544,28.85000038,Next Week's Opportunity to Tame the Bears,Part of what's motivating the sell-off is the prospect of four interest rate hikes coming in 2022.,https://www.zacks.com/stock/news/1855418/next-week-s-opportunity-to-tame-the-bears,zacks.com,8,part whats motivating selloff prospect four interest rate hike coming,0.8126,0.65008,0.03818466667,0.6118953333,Positive Impact
24/01/2022,139,144.95,135.35,144.54,144.54,155624000,-0.27,-314.4290963,1.192,0,14.33339876,0.959429757,-0.018638346,0.08,281.148,13855.12988,16413.9707,7297.200195,6787.790039,3524.110107,57491.51172,20571.30078,169.4427603,169.4146851,165.7469059,166.6555807,162.1231239,178.090231,146.1560169,17.06718765,-5.744764901,-3.714486294,-2.030278608,4.967320033,159.1137216,9990386000,25.4993458,9.676653518,29.89999962,Why Amazon Shares Are Trading Lower Today,Amazon.com Inc (NASDAQ: AMZN) is trading lower Monday amid continued overall market weakness as Fed rate hike concerns weigh on stocks. The Federal Reserve is expected to start hiking interest rates and reducing the amount of bonds it buys each month.,https://www.benzinga.com/news/earnings/22/01/25190105/why-amazon-shares-are-trading-lower-today,benzinga.com,5,amazoncom inc nasdaq amzn trading lower monday amid continued overall market weakness fed rate hike concern weigh stock federal reserve expected start hiking interest rate reducing amount bond buy month,-0.25,-0.125,0.1290625,-0.2540625,Negative Impact
25/01/2022,142.2425,143.60,138.15,139.99,139.99,90824000,-0.27,-314.4290963,1.192,0,14.33339876,0.959429757,-0.018638346,0.08,281.148,13539.29004,16340.32031,7371.5,6837.959961,3433.060059,57858.14844,20591,168.7699802,169.2697675,164.736674,166.3902117,160.6389488,178.9925217,142.2853759,16.36865736,-6.602053262,-4.291999687,-2.310053575,5.063642229,154.8366126,9899562000,14.58398663,14.01177516,31.15999985,"Amazon At 10 Year Low, Now Cheaper Than Microsoft","Ignore the age-old P/E argument with Amazon. Remember, they intentionally suppress it by reinvesting in growth. When you cut through the accounting and look at other metrics, Amazon is the cheapest it has been in a long time. Perhaps a decade.",https://seekingalpha.com/article/4481339-amazon-10-year-low-cheaper-than-microsoft,seekingalpha.com,6,ignore ageold pe argument amazon remember intentionally suppress reinvesting growth cut accounting look metric amazon cheapest long time perhaps decade,-0.2732,-0.16392,0.2241708333,-0.388090833,Negative Impact
26/01/2022,144.75,145.19,137.32,138.87,138.87,95602000,-0.27,-314.4290963,1.192,0,14.33339876,0.959429757,-0.018638346,0.08,281.148,13542.12012,16236.50977,7469.799805,6981.959961,3455.669922,57858.14844,20595.90039,168.02228,169.11413,163.7223926,166.1164036,159.0495239,179.1695131,138.9295347,17.23220949,-7.28730666,-4.891061082,-2.396245578,5.399463109,151.3293832,9803960000,11.16694933,17.08342725,31.95999908,Amazon's Ad Business Will Continue to Outpace in 2022,"The high-margin business is a significant source of profits, and it's growing fast.",https://www.fool.com/investing/2022/01/26/amazons-ad-business-will-continue-to-outpace-2022/,fool.com,7,highmargin business significant source profit growing fast,0.6597,0.46179,0.149698,0.312092,Positive Impact
27/01/2022,140.8,144.24,139.35,139.64,139.64,77516000,-0.27,-314.4290963,1.192,0,14.33339876,0.959429757,-0.018638346,0.08,281.148,13352.78027,16152.12012,7554.299805,7023.799805,3394.25,57276.94141,20544.09961,167.26935,168.9790675,162.7778868,165.8529319,157.5713486,178.8610324,136.2816647,19.36781439,-7.680114281,-5.448871722,-2.231242559,5.578605652,148.4534552,9881476000,13.59351586,13.11481727,30.48999977,7 High Growth Stocks to Buy Despite Rising Interest Rates,These seven top high-growth stocks are among the best options for long-term investors seeking sustainable growth and reasonable returns. The post 7 High Growth Stocks to Buy Despite Rising Interest Rates appeared first on InvestorPlace.,https://investorplace.com/2022/01/7-high-growth-stocks-to-buy-despite-rising-interest-rates/,investorplace.com,6,seven top highgrowth stock among best option longterm investor seeking sustainable growth reasonable return post high growth stock buy despite rising interest rate appeared first investorplace,0.828,0.4968,0.1571966667,0.3396033333,Positive Impact
28/01/2022,140.8605,144.00,137.93,143.98,143.98,74392000,-0.27,-314.4290963,1.192,0,14.33339876,0.959429757,-0.018638346,0.08,281.148,13770.57031,16397.85938,7466.100098,6965.879883,3361.439941,57200.23047,20741.80078,166.6082098,168.854185,162.0406363,165.6352708,156.3380234,177.7840792,134.8919676,27.98478353,-7.554096167,-5.869916611,-1.684179556,5.782605852,146.0951941,9955868000,27.36151606,17.37399375,27.65999985,What really happens to Amazon returns,"Returns are at a record high as online shopping booms. Now Amazon is trying to destroy less inventory with new options to refurbish, resell and liquidate items.",https://www.cnbc.com/2022/01/28/amazon-returns-what-really-happens-to-them.html,cnbc.com,9,return record high online shopping boom amazon trying destroy less inventory new option refurbish resell liquidate item,-0.4215,-0.37935,0.210514,-0.589864,Negative Impact
31/01/2022,144.75,150.36,144.30,149.57,149.57,78308000,-0.27,-314.4290963,1.192,0,14.33339876,0.959429757,-0.018638346,0.08,281.148,14239.87988,16659.76953,7464.399902,6999.200195,3361.439941,58014.17188,21098.30078,166.0506799,168.7521925,161.551729,165.4754522,155.4808487,176.5472797,134.4144177,37.25023378,-6.922912408,-6.08051577,-0.842396638,5.792106628,135.352005,10034176000,45.11037284,28.68846825,24.82999992,Alphabet and Amazon Will Make or Break the Nasdaq This Week,The Nasdaq is bouncing but remains on shaky footing as investors wait to see if the correction is over or will worsen.,https://www.fool.com/investing/2022/01/31/alphabet-and-amazon-will-make-or-break-the-nasdaq/,fool.com,7,nasdaq bouncing remains shaky footing investor wait see correction worsen,-0.6369,-0.44583,0.1434877778,-0.589317778,Negative Impact
01/02/2022,150,151.71,147.63,151.19,151.19,59220000,-0.27,-314.4290963,1.192,0,14.33339876,0.959429757,-0.018638346,0.08,283.716,14346,16829.7207,7535.799805,7099.490234,3361.439941,58862.57031,21319.90039,165.37849,168.6651575,161.1455238,165.3333432,154.5202988,174.4424472,134.5981504,34.06618864,-6.22027125,-6.108466866,-0.111804384,5.680106027,135.652175,10093396000,50.24897294,40.90695395,21.95999908,TRAYVON: TEN YEARS LATER ÃÂÃÂ A Mother's Essay from Sybrina Fulton Now Available from Amazon Original Stories,"SEATTLE--(BUSINESS WIRE)--Ten years after the tragic killing of her son Trayvon Martin, Sybrina Fulton reflects on her grief and hope in an essay from Amazon Original Stories",https://www.businesswire.com/news/home/20220201005075/en/TRAYVON-TEN-YEARS-LATER-%E2%80%94-A-Mother%E2%80%99s-Essay-from-Sybrina-Fulton-Now-Available-from-Amazon-Original-Stories/,businesswire.com,5,seattlebusiness wireten year tragic killing son trayvon martin sybrina fulton reflects grief hope essay amazon original story,-0.6908,-0.3454,0.1121622222,-0.457562222,Negative Impact
02/02/2022,155.0505,155.08,148.86,150.61,150.61,87330000,-0.27,-314.4290963,1.192,0,14.33339876,0.959429757,-0.018638346,0.08,283.716,14417.5498,16904.51953,7583,7115.27002,3361.439941,59558.32813,21362.40039,164.7141699,168.5845476,160.7324642,165.1868672,153.6748238,172.6882095,134.661438,33.74288375,-5.645229708,-6.015819435,0.3705897266,5.947999137,136.2944077,10006066000,49.43553414,48.26495997,22.09000015,"Amazon to create 1,500 new apprenticeships in UK in 2022","Amazon will create 1,500 new apprenticeships in the United Kingdom in 2022, it said on Wednesday.",https://www.reuters.com/business/retail-consumer/britains-tesco-calls-time-jacks-stores-2022-01-31/,reuters.com,10,amazon create new apprenticeship united kingdom said wednesday,0.6808,0.6808,0.27995,0.40085,Positive Impact
03/02/2022,141.7375,144.25,138.33,138.85,138.85,225532000,-0.27,-314.4290963,1.192,0,14.33339876,0.959429757,-0.018638346,0.08,283.716,13878.82031,16677.39063,7528.799805,7005.629883,3361.439941,58788.01953,21094,163.9185101,168.4382701,159.8741521,164.9247641,152.3992493,171.8139756,132.9845229,28.76159249,-6.06904341,-6.02646423,-0.04257918,6.458643232,137.421243,9780534000,12.987956,37.55748769,24.35000038,Amazon Q4 2021 Earnings Report Recap,"Amazon's (AMZN) Q4 earnings crushed analysts estimates, while revenue missed expectations. AWS revenue came in above forecasts.",https://www.investopedia.com/amazon-q4-fy2021-earnings-report-recap-5217982,investopedia.com,5,amazon amzn q earnings crushed analyst estimate revenue missed expectation aws revenue came forecast,-0.5106,-0.2553,0.291891875,-0.547191875,Negative Impact
04/02/2022,155.6065,161.20,150.61,157.64,157.64,253456000,-0.27,-314.4290963,1.192,0,14.33339876,0.959429757,-0.018638346,0.08,283.716,14098.00977,16701.58008,7516.399902,6951.379883,3361.439941,58644.82031,21271.90039,163.4912601,168.3992076,159.7865185,164.8522739,152.1185242,171.0281908,133.2088576,46.81095025,-4.832692537,-5.787709891,0.9550173539,7.880428859,138.3329926,10033990000,86.22523132,49.54957382,23.21999931,Rivian Covers a Multitude of Sins by Amazon,AMZN stock is rising despite the fact that Amazon would have had a bad quarter except for its gain on Rivian stock (most of which is gone). The post Rivian Covers a Multitude of Sins by Amazon appeared first on InvestorPlace.,https://investorplace.com/2022/02/amzn-stock-rivian-covers-a-multitude-of-sins-by-amazon/,investorplace.com,6,amzn stock rising despite fact amazon would bad quarter except gain rivian stock gone post rivian cover multitude sin amazon appeared first investorplace,-0.6943,-0.41658,0.2455620408,-0.662142041,Negative Impact
07/02/2022,158.52,162.69,157.25,157.94,157.94,102624000,-0.27,-314.4290963,1.192,0,14.33339876,0.959429757,-0.018638346,0.08,283.716,14015.66992,16722.75977,7573.5,7009.25,3429.580078,57621.19141,21235.5,163.0695602,168.3536651,159.7139296,164.7834502,151.8875992,170.3686285,133.4065699,49.27373694,-3.785355195,-5.387238952,1.601883757,7.949535915,138.3329926,10136614000,82.60545363,60.60621365,22.86000061,"Peloton surges on reports of buyout interest from Amazon, Nike",Peloton Interactive Inc's shares jumped 22% premarket on Monday after reports of takeover interest from Amazon.com Inc and Nike Inc in the exercise bike maker that recently lost a majority of its share gains made during the pandemic.,https://www.reuters.com/article/peloton-stock-takeover/peloton-surges-on-reports-of-buyout-interest-from-amazon-nike-idUSKBN2KC18Q,reuters.com,10,peloton interactive inc share jumped premarket monday report takeover interest amazoncom inc nike inc exercise bike maker recently lost majority share gain made pandemic,0.8176,0.8176,0.1882912,0.6293088,Positive Impact
08/02/2022,156.7505,161.79,155.55,161.41,161.41,76040000,-0.27,-314.4290963,1.192,0,14.33339876,0.959429757,-0.018638346,0.08,283.716,14194.4502,16853.71094,7567.100098,7028.410156,3452.629883,57808.57813,21377.19922,162.7932703,168.3084826,159.7805793,164.7499184,151.8839745,170.3571039,133.410845,53.73509512,-2.644206759,-4.838632513,2.194425754,8.181106567,140.7687927,10212654000,95.32719982,88.05262826,21.44000053,"India's Maharashtra hopes to persuade Amazon, Uber, others to go electric faster","India's Maharashtra state will offer companies like Amazon.com Inc and Uber new incentives to electrify their delivery fleets ahead of a 2025 target for cleaner air, its environment minister told Reuters.",https://www.reuters.com/world/india/indias-maharashtra-hopes-persuade-amazon-uber-others-go-electric-faster-2022-02-08/,reuters.com,10,india maharashtra state offer company like amazoncom inc uber new incentive electrify delivery fleet ahead target cleaner air environment minister told reuters,0.7165,0.7165,0.3317764286,0.3847235714,Positive Impact
09/02/2022,162.8735,163.83,160.25,161.19,161.19,68786000,-0.27,-314.4290963,1.192,0,14.33339876,0.959429757,-0.018638346,0.08,283.716,14490.37012,17069.66016,7643.399902,7130.879883,3479.949951,58465.96875,21604.19922,162.4554901,168.2600726,159.8358311,164.7144913,151.6753494,169.5934883,133.7572106,57.43233136,-1.737880052,-4.218482021,2.480601969,7.962213789,142.9610129,10143868000,90.71358047,89.54874464,19.95999908,Amazon must adhere to UK supplier rules after grocery turnover tops 1 billion pounds,Amazon's food retail business in Britain faces increased regulation after the competition watchdog said rules setting out how grocers should treat their suppliers will now apply to the U.S. giant.,https://www.reuters.com/business/retail-consumer/amazon-must-adhere-uk-supplier-rules-after-grocery-turnover-tops-1-bln-pounds-2022-02-09/,reuters.com,10,amazon food retail business britain face increased regulation competition watchdog said rule setting grocer treat supplier apply u giant,0.6705,0.6705,0.1557215385,0.5147784615,Positive Impact
10/02/2022,158.35,160.72,157.75,159.00,159.00,68268000,-0.27,-314.4290963,1.192,0,14.33339876,0.959429757,-0.018638346,0.08,283.716,14185.63965,16855.96094,7672.399902,7101.549805,3485.909912,58926.03125,21531.69922,162.12849,168.190465,159.8031904,164.6576655,151.3651741,168.4944382,134.23591,64.29625351,-1.182372261,-3.611260069,2.428887808,7.522392273,145.4658317,10075600000,83.0386756,89.69315197,23.90999985,A Pairing of Peloton and Amazon Makes a Lot of Sense,"While nothing about the prospect of an acquisition is certain, it's not too soon to think about possible synergies.",https://www.fool.com/investing/2022/02/10/a-pairing-of-peloton-and-amazon-makes-a-lot-of-sen/,fool.com,7,nothing prospect acquisition certain soon think possible synergy,-0.4023,-0.28161,0.2913683333,-0.572978333,Negative Impact
11/02/2022,158.1345,159.00,152.73,153.29,153.29,77100000,-0.27,-314.4290963,1.192,0,14.33339876,0.959429757,-0.018638346,0.08,283.716,13791.15039,16664.99023,7661,7011.600098,3462.949951,58152.92188,21548.80078,161.75064,168.089105,159.5479085,164.5445892,150.969149,167.4952865,134.4430116,57.16837064,-1.189168925,-3.12684184,1.937672915,7.284999302,147.6700723,9998500000,60.24665185,77.99963598,27.36000061,"Amazon Games and Smilegate RPG's Lost Ark Launches in North America, Europe, Latin America, and Oceania","SEATTLE--(BUSINESS WIRE)-- #lostark--Today, Amazon Games and Smilegate RPG welcome players to journey into the land of Arkesia in Lost Ark, available now for PC via Steam. Lost Ark is a free-to-play, massively multiplayer online action role-playing game (MMOARPG) that immerses players in new lands where they must seek out lost treasures as they battle to reclaim the eternal power and light of the Lost Ark. In Lost Ark, players will experience a unique blend of high-octane action combat and deep MMORPG gam",https://www.businesswire.com/news/home/20220208006298/en/Amazon-Games-and-Smilegate-RPG%E2%80%99s-Lost-Ark-Launches-in-North-America-Europe-Latin-America-and-Oceania/,businesswire.com,5,seattlebusiness wire lostarktoday amazon game smilegate rpg welcome player journey land arkesia lost ark available pc via steam lost ark freetoplay massively multiplayer online action roleplaying game mmoarpg immerses player new land must seek lost treasure battle reclaim eternal power light lost ark lost ark player experience unique blend highoctane action combat deep mmorpg gam,-0.8225,-0.41125,0.25255,-0.6638,Negative Impact
14/02/2022,151.751,158.45,151.65,155.17,155.17,83230000,-0.27,-314.4290963,1.192,0,14.33339876,0.959429757,-0.018638346,0.08,283.716,13790.91992,16531.31055,7531.600098,6852.200195,3428.879883,56405.83984,21352.5,161.4166202,167.998085,159.3761085,164.45128,150.6205994,166.4335642,134.8076345,63.00992434,-1.031488802,-2.707771233,1.67628243,7.313535418,149.609804,10081730000,67.31221296,70.19918014,28.32999992,Prime Video prÃÂÃÂ¤sentiert ersten offiziellen Teaser-Trailer von Der Herr der Ringe: Die Ringe der Macht wÃÂÃÂ¤hrend des Super Bowl LVI,"LOS ANGELES--(BUSINESS WIRE)--Tolkien-, Popkultur- und Football-Fans gleichermaÃÂÃÂen haben wÃÂÃÂ¤hrend des dritten Viertels des Super Bowl LVI am Sonntag einen Moment innegehalten, als sie von Amazon auf eine langersehnte Zeitreise zurÃÂÃÂ¼ck nach Mittelerde befÃÂÃÂ¶rdert wurden. Prime Video verÃÂÃÂ¶ffentlichte nÃÂÃÂ¤mlich den ersten offiziellen Teaser-Trailer fÃÂÃÂ¼r die mit groÃÂÃÂer Spannung erwartete neue Serie Der Herr der Ringe: Die Ringe der Macht, die 2022 anlÃÂÃÂ¤uft. Der 60-sekÃÂÃÂ¼ndige Werbespot bot den Zuschauern des Super Bowl die allerersten audiovisuellen EindrÃÂÃÂ¼cke des sagenhaften Zweiten Zeitalters von J. R. R. Tolkien und enthÃÂÃÂ¼llte die legendÃÂÃÂ¤re neue TV-Serie von Amazon Studios und den Showrunnern J. D. Payne und Patrick McKay, die am 2. September erstmals ausgestrahlt werden soll. Mit einer vielfÃÂÃÂ¤ltigen Auswahl an Figuren aus dem Ensemble ÃÂÃÂ von Elben ÃÂÃÂ¼ber Zwerge bis hin zu Orks ÃÂÃÂ und ganz Arda umspannenden Gebieten entfÃÂÃÂ¼hrt der Teaser-Trailer die Zuschauer auf eine actionreiche Reise voller Wunder und Aufregung nach allen Regeln der Filmkunst. Die Freigabe des Teaser-Trailers wÃÂÃÂ¤hrend des Super Bowl LVI am 13. Februar ist der bisher spannendste Moment in einer der grÃÂÃÂ¶ÃÂÃÂten globalen Marketingkampagnen des Jahres 2022. Anfang dieses Jahres goss Prime Video den Titel der Serie mit flÃÂÃÂ¼ssigem Metall in eine Form, die den unstillbaren Hunger der Fans anfachte, sodass innerhalb der ersten 24 Stunden auf organische Weise rund eine Milliarde Seitenaufrufe erreicht wurden. Auf diesen Meilenstein der Kampagne folgte rasch die EnthÃÂÃÂ¼llung von 23 mit viel Liebe zum Detail gestalteten Postern, die lediglich die HÃÂÃÂ¤nde der Hauptfiguren der Serie darstellten und die online zu gewaltigen Diskussionen um die IdentitÃÂÃÂ¤t und die Vorgeschichte dieser Figuren fÃÂÃÂ¼hrt. Die mit Spannung erwartete Serie Der Herr der Ringe: Die Ringe der Macht feiert ihre Exklusivpremiere in mehr als 240 LÃÂÃÂ¤ndern und Hoheitsgebieten rund um die Welt und in mehreren Sprachversionen am Freitag, 2. September, auf Prime Video, worauf jede Woche neue Folgen freigegeben werden. Der Herr der Ringe: Die Ringe der Macht bringt auf Prime Video zum allerersten Mal die Helden und Legenden des sagenhaften Zweiten Zeitalters aus der Geschichte von Mittelerde auf den Bildschirm. Das Epos spielt sich mehrere Tausend Jahre vor den Ereignissen aus den BÃÂÃÂ¼chern Der Hobbit und Der Herr der Ringe ab und entfÃÂÃÂ¼hrt die Zuschauer in eine Zeit, in der enorme KrÃÂÃÂ¤fte geschmiedet wurden, KÃÂÃÂ¶nigreiche zu Ruhm kamen und wieder in den Ruin versanken, ÃÂÃÂ¼berraschende Helden auf die Probe gestellt wurden, die Hoffnung an einem seidenen Faden hing und eine der mÃÂÃÂ¤chtigsten VerkÃÂÃÂ¶rperungen des BÃÂÃÂ¶sen, die J. R. R. Tolkien je aus der Feder flossen, die ganze Welt in Dunkelheit zu stÃÂÃÂ¼rzen drohte. Zu Beginn der Serie ist das Leben in Mittelerde noch relativ friedlich, doch das Ensemble aus vertrauten und neuen Figuren muss sich schon bald der Tatsache stellen, dass das BÃÂÃÂ¶se wieder an Macht gewinnt. Von den dunkelsten Tiefen im Nebelgebirge ÃÂÃÂ¼ber die majestÃÂÃÂ¤tischen WÃÂÃÂ¤lder des Elbenreichs von Lindon und das atemberaubende InselkÃÂÃÂ¶nigreich NÃÂÃÂºmenor bis hin zu den ÃÂÃÂ¤uÃÂÃÂersten Gefilden, die auf der Karte verzeichnet sind, werden diese Welten und Figuren ein Erbe hinterlassen, das noch lange weiterleben wird, nachdem sie selbst lÃÂÃÂ¤ngst verschwunden sind. Die Idee fÃÂÃÂ¼r die Serie stammt von den Showrunnern und Executive Producers J. D. Payne und Patrick McKay. Ihnen zur Seite stehen die Executive Producers Lindsey Weber, Callum Greene, J. A. Bayona, BelÃÂÃÂ©n Atienza, Justin Doble, Jason Cahill, Gennifer Hutchison, Bruce Richmond und Sharon Tal Yguado sowie die Produzenten Ron Ames und Christopher Newman. Wayne Che Yip ist als Co-Executive Producer sowie zusammen mit J. A. Bayona und Charlotte BrÃÂÃÂ¤ndstrÃÂÃÂ¶m als Regisseur verantwortlich. Das ÃÂÃÂ¼ber mehrere Staffeln konzipierte Epos wird zum ersten Mal am Freitag, 2. September, in mehr als 240 LÃÂÃÂ¤ndern und Hoheitsgebieten rund um die Welt und in mehreren Sprachversionen exklusiv auf Prime Video ausgestrahlt, worauf jede Woche neue Folgen freigegeben werden. Der Roman Der Herr der Ringe wurde in ÃÂÃÂ¼ber 38 Sprachen ÃÂÃÂ¼bersetzt, und bisher wurden mehr als 150 Millionen Exemplare des Buchs verkauft. ÃÂÃÂber Prime Video Prime Video bietet Abonnenten eine reiche Auswahl an Filmen, Serien und SportÃÂÃÂ¼bertragungen, die auf Hunderten von kompatiblen GerÃÂÃÂ¤ten angeschaut werden kÃÂÃÂ¶nnen. Prime Video umfasst: Filme, TV-Serien und Sportsendungen wie beispielsweise Thursday Night Football. Die Serien und Filme umfassen das fÃÂÃÂ¼r mehrere Emmy Awards nominierte satirische Superhelden-Drama The Boys, die Miniserie The Underground Railroad und die Filme SylvieÃÂÃÂs Love und Uncle Frank, aber auch die Riesenerfolge Der Prinz aus Zamunda 2, Tom ClancyÃÂÃÂs Gnadenlos, The Tomorrow War, Tom ClancyÃÂÃÂs Jack Ryan, Upload und Der Spion von nebenan sowie die mit mehreren Emmys und Golden Globes ausgezeichneten Serien Fleabag und The Marvelous Mrs. Maisel, die mit einem Golden Globe ausgezeichnete Filmreihe Small Axe, den Oscar-PreistrÃÂÃÂ¤ger Sound of Metal, den mit zwei Golden Globes ausgezeichneten und fÃÂÃÂ¼r zwei Oscars nominierten Borat Anschluss Moviefilm sowie die fÃÂÃÂ¼r mehrere Oscars nominierten Filme One Night in Miami und Time. Prime-Abonnenten erhalten auÃÂÃÂerdem Zugriff auf weitere lizenzierte Inhalte. Prime-Video-KanÃÂÃÂ¤le: Prime-Mitglieder kÃÂÃÂ¶nnen KanÃÂÃÂ¤le wie discovery+, Paramount+, BET+, EPIX, Noggin, NBA League Pass, MLB.TV, STARZ und SHOWTIME hinzufÃÂÃÂ¼gen ÃÂÃÂ ohne dass zusÃÂÃÂ¤tzliche Apps heruntergeladen werden mÃÂÃÂ¼ssen oder ein Kabelanschluss notwendig wÃÂÃÂ¤re. Sie bezahlen nur fÃÂÃÂ¼r die KanÃÂÃÂ¤le, die Sie wollen, und kÃÂÃÂ¶nnen sie jederzeit kÃÂÃÂ¼ndigen. Die vollstÃÂÃÂ¤ndige Liste der verfÃÂÃÂ¼gbaren KanÃÂÃÂ¤le finden Sie unter amazon.com/channels. Filme ausleihen oder kaufen: Sie kÃÂÃÂ¶nnen neu verÃÂÃÂ¶ffentlichte Filme ausleihen oder kaufen, ganze Staffeln aktueller Fernsehsendungen kaufen und Spezialangebote fÃÂÃÂ¼r Prime-Mitglieder in Anspruch nehmen. Sofortiger Zugriff: Sehen Sie sich alles zu Hause oder unterwegs mit dem GerÃÂÃÂ¤t Ihrer Wahl an ÃÂÃÂ Hunderte von GerÃÂÃÂ¤ten sind kompatibel. Streamen Sie aus dem Netz oder ÃÂÃÂ¼ber die Prime-Video-App auf Smartphone, Tablet, Set-Top-Box, Spielkonsole oder einem ausgewÃÂÃÂ¤hlten Smart-TV. Verbessertes Erlebnis: Mit 4K Ultra HD und High Dynamic Range (HDR) kompatiblen Inhalten kÃÂÃÂ¶nnen Sie das Beste aus jeder Wiedergabe herausholen. Blicken Sie hinter die Kulissen Ihrer Lieblingsfilme und -fernsehsendungen mit exklusivem X-Ray-Zugang, unterstÃÂÃÂ¼tzt von IMDb. Speichern Sie es fÃÂÃÂ¼r spÃÂÃÂ¤ter mit ausgewÃÂÃÂ¤hlten mobilen Downloads zur Offline-Betrachtung. Prime Video ist nur eines von vielen Shopping- und Unterhaltungsangeboten, die in der Prime-Mitgliedschaft inbegriffen sind. Ebenfalls angeboten wird die kostenlose Lieferung von Millionen von sogenannten Prime-eligible-Artikeln auf Amazon.com, unbegrenzter Speicherplatz fÃÂÃÂ¼r Fotos, exklusive Angebote und Rabatte sowie Zugang auf werbefreie Musik und Kindle-E-Books. Melden Sie sich an oder testen Sie Prime 30 Tage lang kostenlos: amazon.com/prime. Die Ausgangssprache, in der der Originaltext verÃÂÃÂ¶ffentlicht wird, ist die offizielle und autorisierte Version. ÃÂÃÂbersetzungen werden zur besseren VerstÃÂÃÂ¤ndigung mitgeliefert. Nur die Sprachversion, die im Original verÃÂÃÂ¶ffentlicht wurde, ist rechtsgÃÂÃÂ¼ltig. Gleichen Sie deshalb ÃÂÃÂbersetzungen mit der originalen Sprachversion der VerÃÂÃÂ¶ffentlichung ab.",https://www.businesswire.com/news/home/20220213005079/de/,businesswire.com,5,los angelesbusiness wiretolkien popkultur und footballfans gleichermaen haben whrend de dritten viertels de super bowl lvi sonntag einen moment innegehalten al sie von amazon auf eine langersehnte zeitreise zurck nach mittelerde befrdert wurden prime video verffentlichte nmlich den ersten offiziellen teasertrailer fr die mit groer spannung erwartete neue serie der herr der ringe die ringe der macht die anluft der sekndige werbespot bot den zuschauern de super bowl die allerersten audiovisuellen eindrcke de sagenhaften zweiten zeitalters von j r r tolkien und enthllte die legendre neue tvserie von amazon studio und den showrunnern j payne und patrick mckay die september erstmals ausgestrahlt werden soll mit einer vielfltigen auswahl figuren au dem ensemble von elben ber zwerge bi hin zu orks und ganz arda umspannenden gebieten entfhrt der teasertrailer die zuschauer auf eine actionreiche reise voller wunder und aufregung nach allen regeln der filmkunst die freigabe de teasertrailers whrend de super bowl lvi februar ist der bisher spannendste moment einer der grten globalen marketingkampagnen de jahres anfang diesis jahres goss prime video den titel der serie mit flssigem metall eine form die den unstillbaren hunger der fan anfachte sodass innerhalb der ersten stunden auf organische weise rund eine milliarde seitenaufrufe erreicht wurden auf diesen meilenstein der kampagne folgte rasch die enthllung von mit viel liebe zum detail gestalteten postern die lediglich die hnde der hauptfiguren der serie darstellten und die online zu gewaltigen diskussionen um die identitt und die vorgeschichte dieser figuren fhrt die mit spannung erwartete serie der herr der ringe die ringe der macht feiert ihre exklusivpremiere mehr al lndern und hoheitsgebieten rund um die welt und mehreren sprachversionen freitag september auf prime video worauf jede woche neue folgen freigegeben werden der herr der ringe die ringe der macht bringt auf prime video zum allerersten mal die helden und legenden de sagenhaften zweiten zeitalters au der geschichte von mittelerde auf den bildschirm da epos spielt sich mehrere tausend jahre vor den ereignissen au den bchern der hobbit und der herr der ringe ab und entfhrt die zuschauer eine zeit der enorme krfte geschmiedet wurden knigreiche zu ruhm kamen und wieder den ruin versanken berraschende helden auf die probe gestellt wurden die hoffnung einem seidenen faden hing und eine der mchtigsten verkrperungen de bsen die j r r tolkien je au der feder flossen die ganze welt dunkelheit zu strzen drohte zu beginn der serie ist da leben mittelerde noch relativ friedlich doch da ensemble au vertrauten und neuen figuren mus sich schon bald der tatsache stellen das da bse wieder macht gewinnt von den dunkelsten tiefen im nebelgebirge ber die majesttischen wlder de elbenreichs von lindon und da atemberaubende inselknigreich nmenor bi hin zu den uersten gefilden die auf der karte verzeichnet sind werden diese welten und figuren ein erbe hinterlassen da noch lange weiterleben wird nachdem sie selbst lngst verschwunden sind die idee fr die serie stammt von den showrunnern und executive producer j payne und patrick mckay ihnen zur seite stehen die executive producer lindsey weber callum greene j bayona beln atienza justin doble jason cahill gennifer hutchison bruce richmond und sharon tal yguado sowie die produzenten ron ames und christopher newman wayne che yip ist al coexecutive producer sowie zusammen mit j bayona und charlotte brndstrm al regisseur verantwortlich da ber mehrere staffeln konzipierte epos wird zum ersten mal freitag september mehr al lndern und hoheitsgebieten rund um die welt und mehreren sprachversionen exklusiv auf prime video ausgestrahlt worauf jede woche neue folgen freigegeben werden der roman der herr der ringe wurde ber sprachen bersetzt und bisher wurden mehr al millionen exemplare de buchs verkauft ber prime video prime video bietet abonnenten eine reiche auswahl filmen serien und sportbertragungen die auf hunderten von kompatiblen gerten angeschaut werden knnen prime video umfasst filme tvserien und sportsendungen wie beispielsweise thursday night football die serien und filme umfassen da fr mehrere emmy award nominierte satirische superheldendrama boy die miniserie underground railroad und die filme sylvies love und uncle frank aber auch die riesenerfolge der prinz au zamunda tom clancys gnadenlos tomorrow war tom clancys jack ryan upload und der spion von nebenan sowie die mit mehreren emmy und golden globe ausgezeichneten serien fleabag und marvelous mr maisel die mit einem golden globe ausgezeichnete filmreihe small axe den oscarpreistrger sound metal den mit zwei golden globe ausgezeichneten und fr zwei oscar nominierten borat anschluss moviefilm sowie die fr mehrere oscar nominierten filme one night miami und time primeabonnenten erhalten auerdem zugriff auf weitere lizenzierte inhalte primevideokanle primemitglieder knnen kanle wie discovery paramount bet epix noggin nba league pas mlbtv starz und showtime hinzufgen ohne das zustzliche apps heruntergeladen werden mssen oder ein kabelanschluss notwendig wre sie bezahlen nur fr die kanle die sie wollen und knnen sie jederzeit kndigen die vollstndige liste der verfgbaren kanle finden sie unter amazoncomchannels filme ausleihen oder kaufen sie knnen neu verffentlichte filme ausleihen oder kaufen ganze staffeln aktueller fernsehsendungen kaufen und spezialangebote fr primemitglieder anspruch nehmen sofortiger zugriff sehen sie sich alles zu hause oder unterwegs mit dem gert ihrer wahl hunderte von gerten sind kompatibel streamen sie au dem netz oder ber die primevideoapp auf smartphone tablet settopbox spielkonsole oder einem ausgewhlten smarttv verbessertes erlebnis mit k ultra hd und high dynamic range hdr kompatiblen inhalten knnen sie da beste au jeder wiedergabe herausholen blicken sie hinter die kulissen ihrer lieblingsfilme und fernsehsendungen mit exklusivem xrayzugang untersttzt von imdb speichern sie e fr spter mit ausgewhlten mobilen downloads zur offlinebetrachtung prime video ist nur eines von vielen shopping und unterhaltungsangeboten die der primemitgliedschaft inbegriffen sind ebenfalls angeboten wird die kostenlose lieferung von millionen von sogenannten primeeligibleartikeln auf amazoncom unbegrenzter speicherplatz fr fotos exklusive angebote und rabatte sowie zugang auf werbefreie musik und kindleebooks melden sie sich oder testen sie prime tage lang kostenlos amazoncomprime die ausgangssprache der der originaltext verffentlicht wird ist die offizielle und autorisierte version bersetzungen werden zur besseren verstndigung mitgeliefert nur die sprachversion die im original verffentlicht wurde ist rechtsgltig gleichen sie deshalb bersetzungen mit der originalen sprachversion der verffentlichung ab,-0.9996,-0.4998,0.2380317647,-0.737831765,Negative Impact
15/02/2022,157.6055,158.01,154.64,156.51,156.51,56440000,-0.27,-314.4290963,1.192,0,14.33339876,0.959429757,-0.018638346,0.08,283.716,14139.75977,16745.83008,7608.899902,6979.970215,3446.090088,58142.05078,21502.59961,161.1570401,167.934015,159.2637316,164.3722672,150.5002495,166.0822875,134.9182115,65.05617521,-0.789022347,-2.324021456,1.534999108,6.992321559,151.3167679,10138170000,71.72744462,66.42876981,25.70000076,7 Grocery Outlet Stocks That Will Benefit From The Rising Inflation Trend,"Following the recent release of Consumer Price Index (CPI) data from January, inflation is flashing warning signs as prices soared 7.5% compare to a year ago, and have increased by 0.6% from the previous month. Telsey Advisory Group says the Food-At-Home CPI accelerated to 7.4%, with Food PPI remaining high in the double digits at 12.1%.",https://www.benzinga.com/analyst-ratings/analyst-color/22/02/25572739/7-grocery-outlet-stocks-that-will-benefit-from-the-rising-inflation-trend,benzinga.com,5,following recent release consumer price index cpi data january inflation flashing warning sign price soared compare year ago increased previous month telsey advisory group say foodathome cpi accelerated food ppi remaining high double digit,-0.0772,-0.0386,0.26371,-0.30231,Negative Impact
16/02/2022,155.7905,158.83,154.73,158.10,158.10,52704000,-0.27,-314.4290963,1.192,0,14.33339876,0.959429757,-0.018638346,0.08,283.716,14124.08984,16770.35938,7603.799805,6964.97998,3465.830078,57996.67969,21383.59961,160.89168,167.89655,159.2181145,164.3098615,150.5903244,166.3334971,134.8471517,65.54151272,-0.463226729,-1.95186251,1.488635781,6.901500157,151.6499939,10190874000,77.865242,72.30163319,24.29000092,Long Live the FAANG Stocks?,"The FAANG stocks are all down year-to-date, some with double digit losses. Here's what you need to do to stay ahead of the losses.",https://investorplace.com/smartmoney/2022/02/long-live-the-faang-stocks/,investorplace.com,6,faang stock yeartodate double digit loss here need stay ahead loss,-0.5574,-0.33444,0.2508653846,-0.585305385,Negative Impact
17/02/2022,158.146,160.35,154.50,154.65,154.65,64032000,-0.27,-314.4290963,1.192,0,14.33339876,0.959429757,-0.018638346,0.08,283.716,13716.71973,16492.05078,7537.399902,6946.819824,3468.040039,57892.01172,21176.30078,160.4614398,167.8521775,159.0390706,164.2137683,150.7395744,166.582029,134.8971199,59.12249497,-0.47774879,-1.657039766,1.179290976,6.885821751,153.112135,10126842000,63.99426304,71.19564988,28.11000061,Amazon and Visa agree to end global dispute over credit card fees,"Amazon has been piling pressure on Visa to lower its fees, signaling growing frustration from retailers over the costs associated with major card networks.",https://www.cnbc.com/2022/02/17/amazon-and-visa-reach-global-truce-over-credit-card-fees.html,cnbc.com,9,amazon piling pressure visa lower fee signaling growing frustration retailer cost associated major card network,-0.6249,-0.56241,0.2521942857,-0.814604286,Negative Impact
18/02/2022,155.4995,155.50,150.89,152.60,152.60,63604000,-0.27,-314.4290963,1.192,0,14.33339876,0.959429757,-0.018638346,0.08,283.716,13548.07031,16392.32031,7513.600098,6929.629883,3490.76001,57832.96875,21008.19922,159.9903098,167.7885925,158.7866169,164.0982234,151.2374992,166.6280277,135.8469707,52.75463237,-0.647294169,-1.455090647,0.8077964777,6.758963449,163.8345032,10063238000,55.95162233,65.93704246,27.75,"Peace is at Hand: Amazon, Visa, Settle Differences",The simmering dispute over payment fees in the United Kingdom and elsewhere between Amazon and Visa has been settled. The eCommerce giant and the global payment company reached a deal to end the months-long dispute over rising card fees.,https://www.pymnts.com/big-tech/2022/peace-is-at-hand-amazon-visa-settle-differences/,pymnts.com,5,simmering dispute payment fee united kingdom elsewhere amazon visa settled ecommerce giant global payment company reached deal end monthslong dispute rising card fee,-0.128,-0.064,0.2856457143,-0.349645714,Negative Impact
22/02/2022,150.4785,152.98,148.49,150.20,150.20,66128000,-0.27,-314.4290963,1.192,0,14.33339876,0.959429757,-0.018638346,0.08,283.716,13381.51953,16215.62012,7494.200195,6787.600098,3457.149902,57300.67969,20907.80078,159.5108395,167.7166775,158.4497886,163.9599077,151.5201736,166.5975559,136.4427914,49.10665994,-0.964524931,-1.356977504,0.3924525727,6.788713728,163.5756732,9997110000,46.52470252,55.49019596,28.80999947,Analysis-Amazon defies break-up wave sweeping conglomerates,"Amazon.com Inc has become the poster child of technology giants bucking the trend of major conglomerates breaking up, thanks to bright growth prospects shielding it from pressure to follow suit, investors and dealmakers said.",https://www.reuters.com/markets/us/amazon-defies-break-up-wave-sweeping-conglomerates-2022-02-22/,reuters.com,10,amazoncom inc become poster child technology giant bucking trend major conglomerate breaking thanks bright growth prospect shielding pressure follow suit investor dealmakers said,0.8126,0.8126,0.06424533333,0.7483546667,Positive Impact
23/02/2022,151.6505,151.76,144.65,144.83,144.83,64244000,-0.27,-314.4290963,1.192,0,14.33339876,0.959429757,-0.018638346,0.08,283.716,13037.49023,16019.58008,7498.200195,6780.669922,3489.149902,57232.05859,20744.19922,158.9631393,167.6431899,157.9155614,163.7695304,151.7622238,166.2018982,137.3225494,45.22139122,-1.630491661,-1.411680335,-0.218811326,6.853034973,162.9720665,9932866000,25.46517103,42.64716529,31.02000046,"Amazon labor organizer Smalls arrested, faces trespass charge after dropping off food for workers","Amazon.com Inc labor organizer Christian Smalls was arrested on Wednesday after allegedly trespassing on company property, the New York City Police Department (NYPD) said.",https://www.reuters.com/business/amazon-labor-organizer-smalls-arrested-faces-trespass-charge-after-dropping-off-2022-02-24/,reuters.com,10,amazoncom inc labor organizer christian small arrested wednesday allegedly trespassing company property new york city police department nypd said,-0.4767,-0.4767,0.2556322222,-0.732332222,Negative Impact
24/02/2022,139.8375,151.75,139.50,151.36,151.36,100786000,-0.27,-314.4290963,1.192,0,14.33339876,0.959429757,-0.018638346,0.08,283.716,13473.58984,15995.99023,7207,6521.049805,3429.959961,54529.91016,20761.90039,158.5989493,167.5940025,157.6584022,163.6460326,152.386499,165.4983169,139.2746811,61.31339389,-1.612687444,-1.451881757,-0.160805687,6.850855146,161.8728025,10033652000,48.72917119,40.23968158,30.31999969,"Amazon, Apple and Tesla shares plunge in ÃÂÃÂscary tech sell-off' on Russia war","Shares of American tech giants ÃÂÃÂ including Amazon, Apple and Google ÃÂÃÂ were hammered on Thursday as Russia's brutal invasion of Ukraine shocked global markets. The tech-heavy Nasdaq composite index was down 2.5% ÃÂÃÂ with its losses worse than the market as a whole ÃÂÃÂ as stocks opened on Thursday.",https://nypost.com/2022/02/24/amazon-apple-and-tesla-shares-plunge-after-russia-invasion/,nypost.com,5,share american tech giant including amazon apple google hammered thursday russia brutal invasion ukraine shocked global market techheavy nasdaq composite index loss worse market whole stock opened thursday,-0.836,-0.418,0.109938,-0.527938,Negative Impact
25/02/2022,150.55,153.99,149.21,153.79,153.79,62396000,-0.27,-314.4290963,1.192,0,14.33339876,0.959429757,-0.018638346,0.08,283.716,13694.62012,16427.96094,7489.5,6752.430176,3451.409912,55858.51953,21106,158.2928891,167.5749599,157.5066413,163.5479477,153.0940491,164.7562679,141.4318302,45.05470647,-1.386474329,-1.438800271,0.05232594213,5.595284598,160.0829783,10096048000,58.71703163,44.30379128,27.59000015,"Stock Market News for Feb 25, 2022",U.S. stocks made a dramatic comeback in the late afternoon session on Thursday after President Joe Biden imposed a new round of harsher sanctions against Moscow after Russia's President Vladimir Putin ordered a full-fledged war against Ukraine.,https://www.zacks.com/stock/news/1873373/stock-market-news-for-feb-25-2022,zacks.com,8,u stock made dramatic comeback late afternoon session thursday president joe biden imposed new round harsher sanction moscow russia president vladimir putin ordered fullfledged war ukraine,-0.8126,-0.65008,0.083962,-0.734042,Negative Impact
28/02/2022,152.425,154.45,150.85,153.56,153.56,57684000,-0.27,-314.4290963,1.192,0,14.33339876,0.959429757,-0.018638346,0.08,283.716,13751.40039,16313.88965,7458.299805,6658.830078,3462.310059,56247.28125,21126.40039,157.8978491,167.5524075,157.3519888,163.448595,153.5732994,164.4172528,142.729346,44.37483118,-1.211429711,-1.393326159,0.1818964487,5.463784354,158.4363401,10038364000,57.79038692,55.07886325,30.14999962,Teladoc stock jumps after teaming up with Amazon Alexa,"Shares of Teladoc Health Inc. TDOC, +7.93% shot up 12.7% in premarket trading Monday, after the provider of tele-healthcare services said it has teamed up with Amazon.com Inc. AMZN, -0.68% Alexa on voice-activated virtual care services. The service will be available on Amazon Alexa devices, including the Echo, the Echo Dot and Echo Show.",https://www.marketwatch.com/story/teladoc-stock-jumps-after-teaming-up-with-amazon-alexa-2022-02-28,marketwatch.com,8,share teladoc health inc tdoc shot premarket trading monday provider telehealthcare service said teamed amazoncom inc amzn alexa voiceactivated virtual care service service available amazon alexa device including echo echo dot echo show,0.7269,0.58152,0.1662327273,0.4152872727,Positive Impact
01/03/2022,152.7325,154.10,149.98,151.14,151.14,44874000,-0.27,-314.4290963,1.192,0,14.33339876,0.959429757,-0.018638346,0.2,287.504,13532.45996,16069.16016,7330.200195,6396.490234,3488.830078,56247.28125,21004.5,157.543269,167.5023924,157.1084598,163.3261413,153.6517242,164.3961096,142.9073389,36.41641009,-1.253609648,-1.365382857,0.1117732091,5.312356131,156.9214329,9993490000,47.84152858,54.78298238,33.31999969,Better Amazon Disruptor: Etsy vs. DigitalOcean,These tech stocks have more in common than one might assume.,https://www.fool.com/investing/2022/03/01/better-amazon-disruptor-etsy-vs-digitalocean/,fool.com,7,tech stock common one might assume,0,0,0.3974011111,-0.397401111,Negative Impact
02/03/2022,150.849,153.00,148.75,152.05,152.05,47334000,-0.27,-314.4290963,1.192,0,14.33339876,0.959429757,-0.018638346,0.2,287.504,13752.01953,16380.91016,7429.600098,6498.02002,3484.189941,55468.89844,21255.59961,157.1839691,167.4450574,156.910187,163.2139659,153.6946747,164.4044966,142.9848528,38.13223202,-1.199737404,-1.332253766,0.1325163622,5.359855652,155.5277182,10040824000,59.16386481,54.93192677,30.73999977,Exclusive-Amazon plans to file criminal case against India's Future over store transfers -sources,"Amazon.com Inc plans to initiate criminal court proceedings this week against its Indian partner Future Retail for allowing the transfer of assets to a major rival despite a legal prohibition, three sources with direct knowledge of the matter told Reuters.",https://www.reuters.com/article/amazon-com-india-future-reliance-exclusi/exclusive-amazon-plans-to-file-criminal-case-against-indias-future-over-store-transfers-sources-idUSKBN2KZ29J,reuters.com,10,amazoncom inc plan initiate criminal court proceeding week indian partner future retail allowing transfer asset major rival despite legal prohibition three source direct knowledge matter told reuters,-0.2892,-0.2892,0.213045,-0.502245,Negative Impact
03/03/2022,153.5315,153.93,146.86,147.90,147.90,65198000,-0.27,-314.4290963,1.192,0,14.33339876,0.959429757,-0.018638346,0.2,287.504,13537.94043,16287.49023,7238.899902,6378.370117,3481.110107,55102.67969,21250.40039,156.8003592,167.3764799,156.5567875,163.0615731,153.5589745,164.4995213,142.6184276,36.27759134,-1.475231359,-1.360849285,-0.114382074,5.619391305,154.2455008,9975626000,40.28250242,49.09596527,30.47999954,Amazon calls for dialogue with India's Future amid raging legal dispute,Amazon.com Inc on Thursday proposed a dialogue with its warring partner Future Group to end legal battles over a contractual dispute that has soured relations between the two sides.,https://www.reuters.com/business/amazon-calls-dialogue-with-indias-future-amid-raging-legal-dispute-2022-03-03/,reuters.com,10,amazoncom inc thursday proposed dialogue warring partner future group end legal battle contractual dispute soured relation two side,-0.7717,-0.7717,0.1802675,-0.9519675,Negative Impact
04/03/2022,147.159,147.85,143.81,145.64,145.64,60934000,-0.27,-314.4290963,1.192,0,14.33339876,0.959429757,-0.018638346,0.2,287.504,13313.44043,16129.66016,6987.100098,6061.660156,3447.649902,54333.80859,21402.40039,156.3048392,167.296735,156.1287177,162.8882342,153.8987495,163.2171301,144.580369,39.66172202,-1.854347285,-1.459548885,-0.3947984,5.463819231,153.9290009,9914692000,29.45468251,42.96701658,31.97999954,Amazon Is Finally Gaining Traction in Video Gaming,"With a successful new game, Amazon Game Studios continues to grow.",https://www.fool.com/investing/2022/03/04/amazon-is-finally-gaining-traction-in-video-gaming/,fool.com,7,successful new game amazon game studio continues grow,0.6705,0.46935,0.125665,0.343685,Positive Impact
07/03/2022,145.4435,146.09,137.42,137.45,137.45,86934000,-0.27,-314.4290963,1.192,0,14.33339876,0.959429757,-0.018638346,0.2,287.504,12830.95996,15708.23047,6959.5,5982.27002,3372.860107,52842.75,21304.40039,155.6331592,167.17208,155.3963367,162.6351473,152.8894249,164.5743022,141.2045476,29.5568312,-2.783417341,-1.724322576,-1.059094765,5.598068237,153.9290009,9827758000,0.1591585357,23.29878116,36.45000076,Worried About Another Market Crash? Buy Amazon.,The company is investing in its future.,https://www.fool.com/investing/2022/03/07/worried-about-another-market-crash-buy-amazon/,fool.com,7,company investing future,0,0,0.179064,-0.179064,Negative Impact
08/03/2022,136.6835,140.70,133.57,136.01,136.01,91662000,-0.27,-314.4290963,1.192,0,14.33339876,0.959429757,-0.018638346,0.2,287.504,12795.5498,15625.92969,6964.100098,5962.959961,3293.530029,53424.08984,21232,154.9320792,167.0513824,154.6362645,162.3702652,151.7933746,165.4340377,138.1527116,26.39797805,-3.594354077,-2.098328876,-1.496025201,5.866460528,152.2777512,9736096000,9.119940735,12.91126059,35.13000107,Amazon accused of using Chinese suppliers with links to forced Uyghur labor,"The nonprofit Tech Transparency Project said it found five companies on Amazon's supplier list had ""well-documented ties to forced labor in Xinjiang.""",https://www.businessinsider.com/amazon-china-suppliers-allegations-forced-uyghur-labor-links-report-2022-3,businessinsider.com,7,nonprofit tech transparency project said found five company amazon supplier list welldocumented tie forced labor xinjiang,-0.3182,-0.22274,0.167731,-0.390471,Negative Impact
09/03/2022,139.5,140.25,136.83,139.28,139.28,82656000,-0.27,-314.4290963,1.192,0,14.33339876,0.959429757,-0.018638346,0.2,287.504,13255.5498,15977.54004,7190.700195,6387.830078,3256.389893,54647.32813,21493.19922,154.3242694,166.93653,154.0340191,162.1405014,150.6866501,164.6292947,136.7440055,29.13107401,-3.928325231,-2.464328147,-1.463997084,5.876174927,150.0331204,9818752000,21.31164076,10.19691334,32.45000076,The Wall Street Journal: Amazon halts shipments to customers in Russia and suspends Prime Video access over Ukraine invasion,"Amazon.com Inc. has suspended shipments of retail products and access to Prime Video to customers in Russia, part of a broader effort by the company and other technology giants to remove ties with the country.",https://www.marketwatch.com/story/amazon-halts-shipments-to-customers-in-russia-and-suspends-prime-video-access-over-ukraine-invasion-11646870997,marketwatch.com,8,amazoncom inc suspended shipment retail product access prime video customer russia part broader effort company technology giant remove tie country,-0.4767,-0.38136,0.2051902941,-0.586550294,Negative Impact
10/03/2022,145.685,148.67,143.98,146.82,146.82,135062000,-0.27,-314.4290963,1.192,0,14.33339876,0.959429757,-0.018638346,0.2,287.504,13129.95996,15929.55957,7099.100098,6207.200195,3296.090088,55464.39063,21581.69922,153.8473996,166.855855,153.7510185,161.9880338,149.9680504,163.0887059,136.8473949,42.03518656,-3.543854645,-2.680233447,-0.863621198,6.129495893,133.5724945,9953814000,60.4050221,30.27886787,30.22999954,Amazon Announces Stock Split Providing Some Green In A Sea Of Red,"After falling overnight, S&P 500 futures rally off lows as Consumer Price Index (CPI) comes in on target.",https://www.forbes.com/sites/jjkinahan/2022/03/10/amazon-announces-stock-split-providing-some-green-in-a-sea-of-red/,forbes.com,8,falling overnight sp future rally low consumer price index cpi come target,-0.4019,-0.32152,0.2177276744,-0.539247674,Negative Impact
11/03/2022,149.5745,149.68,145.37,145.52,145.52,68900000,-0.27,-314.4290963,1.192,0,14.33339876,0.959429757,-0.018638346,0.2,287.504,12843.80957,15753.7002,7155.600098,6260.25,3309.75,55550.30078,21461.80078,153.3738696,166.7671876,153.4284102,161.8242176,149.294101,161.8323942,136.7558077,42.69313492,-3.305390685,-2.805264895,-0.50012579,6.108032227,133.8745346,9884914000,57.24828026,46.32164771,30.75,"General Electric, Amazon, and the New Wave of Stock Buybacks",Companies announce buybacks when they're feeling good about their business and when they're confident in their ability to execute.,https://www.barrons.com/articles/general-electric-amazon-and-the-new-wave-of-stock-buybacks-51647046822,barrons.com,9,company announce buyback theyre feeling good business theyre confident ability execute,0.836,0.7524,0.1847063636,0.5676936364,Positive Impact
14/03/2022,145.981,147.45,140.88,141.85,141.85,74086000,-0.27,-314.4290963,1.192,0,14.33339876,0.959429757,-0.018638346,0.2,287.504,12581.21973,15694.34961,7193.5,6369.939941,3223.530029,56486.01953,21180.80078,152.8380396,166.6689251,152.9744724,161.625499,148.7220757,161.5330278,135.9111235,41.6042098,-3.373775569,-2.918967029,-0.454808539,6.255817958,134.5065533,9810828000,39.66232236,52.43854157,31.77000046,"Amazon accuses India's Future, Reliance of 'fraud' in newspaper ads","Amazon.com Inc on Tuesday took out ads in Indian newspapers that accuse Future Retail and Reliance of ""fraud"" after Reliance took over many of Future's stores.",https://www.reuters.com/world/india/amazon-accuses-indias-future-reliance-fraud-newspaper-ads-2022-03-15/,reuters.com,10,amazoncom inc tuesday took ad indian newspaper accuse future retail reliance fraud reliance took many future store,-0.6808,-0.6808,0.08462588235,-0.765425882,Negative Impact
15/03/2022,142.85,147.99,142.00,147.37,147.37,75584000,-0.27,-314.4290963,1.192,0,14.33339876,0.959429757,-0.018638346,0.2,287.504,12948.62012,15895.66992,7175.700195,6355,3063.969971,55776.85156,21187.80078,152.4510297,166.5999901,152.754552,161.4836184,148.3320503,160.7868561,135.8772445,52.54778328,-2.949082201,-2.924990064,-0.024092138,6.185818263,135.1132913,9886412000,66.07115188,54.3272515,29.82999992,Exclusive-Amazon talks with India's Future broke down over U.S. firm's demand of $200 million-sources,"Dispute settlement talks between Amazon.com Inc and India's Future Retail broke due to disagreement over the U.S. group's demand for the return of at least $200 million it had invested in the Indian firm, two sources told Reuters.",https://www.reuters.com/business/retail-consumer/exclusive-amazon-talks-with-indias-future-broke-down-over-us-firms-demand-200-2022-03-15/,reuters.com,10,dispute settlement talk amazoncom inc india future retail broke due disagreement u group demand return least million invested indian firm two source told reuters,-0.8176,-0.8176,0.2801611538,-1.097761154,Negative Impact
16/03/2022,148.5,153.15,147.35,153.10,153.10,84958000,-0.27,-314.4290963,1.192,0,14.33339876,0.959429757,-0.018638346,0.2,287.504,13436.5498,16261.5,7291.700195,6588.640137,3170.709961,56816.64844,21468.80078,152.1050198,166.5608476,152.768256,161.4002392,148.1617256,160.2328718,136.0905794,51.78003516,-2.125044907,-2.765001032,0.6399561255,5.72492545,135.6957598,9971370000,93.552902,66.42879208,26.67000008,"The Climate Pledge gibt fast 100 neue Unterzeichner bekannt, darunter Maersk, SAP, Weyerhaeuser, Sunrun und HARMAN, womit sich insgesamt ÃÂÃÂ¼ber 300 Unternehmen auf der ganzen Welt verpflichtet haben","SEATTLE--(BUSINESS WIRE)--Amazon und Global Optimism verkÃÂÃÂ¼ndeten heute, dass inzwischen ÃÂÃÂ¼ber 300 Unternehmen The Climate Pledge unterzeichnet haben, was einem Anstieg der Unterzeichner um fast 600 % im letzten Jahr entspricht. Zu den fast 100 neuen Unterzeichnern gehÃÂÃÂ¶ren die grÃÂÃÂ¶ÃÂÃÂte Container-Reederei der Welt Maersk, der fÃÂÃÂ¼hrende Entwickler von Unternehmenssoftware, SAP, das nordamerikanische Holzunternehmen Weyerhaeuser, das grÃÂÃÂ¶ÃÂÃÂte Solarunternehmen fÃÂÃÂ¼r Privathaushalte in den USA, Sunrun, und der MarktfÃÂÃÂ¼hrer fÃÂÃÂ¼r vernetzte Autos und Audiodienste, HARMAN. Die Unterzeichner der VerpflichtungserklÃÂÃÂ¤rung erwirtschaften insgesamt einen weltweiten Jahresumsatz von ÃÂÃÂ¼ber 3,5 Billionen USD und haben mehr als 8 Millionen Mitarbeiter in 51 Branchen in 29 LÃÂÃÂ¤ndern. Die Unterzeichner von The Climate Pledge mÃÂÃÂ¼ssen zustimmen: Treibhausgasemissionen regelmÃÂÃÂ¤ÃÂÃÂig zu messen und darÃÂÃÂ¼ber zu berichten. Dekarbonisierungsstrategien im Einklang mit dem ÃÂÃÂbereinkommen von Paris durch echte geschÃÂÃÂ¤ftliche VerÃÂÃÂ¤nderungen und Innovationen umzusetzen, einschlieÃÂÃÂlich Effizienzsteigerungen, erneuerbarer Energien, Materialreduzierungen und anderer Strategien zur Beseitigung von CO2-Emissionen. alle verbleibenden Emissionen durch zusÃÂÃÂ¤tzliche, quantifizierbare, reale, dauerhafte und sozial nÃÂÃÂ¼tzliche AusgleichsmaÃÂÃÂnahmen zu neutralisieren, um bis 2040 einen jÃÂÃÂ¤hrlichen Netto-KohlenstoffausstoÃÂÃÂ von Null zu erreichen. ÃÂÃÂDie Folgen des Klimawandels werden in unserer Umgebung und in unserem alltÃÂÃÂ¤glichen Leben immer offensichtlicher, und wir sind fest davon ÃÂÃÂ¼berzeugt, dass der private Sektor weiterhin innovativ sein und ÃÂÃÂ¼ber Regionen und Branchen hinweg zusammenarbeiten muss, damit die globale Wirtschaft in groÃÂÃÂem Umfang dekarbonisiert werden kannÃÂÃÂ, sagte Andy Jassy, CEO von Amazon. ÃÂÃÂEs ist ein ermutigendes Zeichen, dass inzwischen ÃÂÃÂ¼ber 300 Unternehmen Climate Pledge unterzeichnet haben, mit dem sie sich verpflichten, dem Klimawandel direkt entgegenzutreten, indem sie echte geschÃÂÃÂ¤ftliche VerÃÂÃÂ¤nderungen umsetzen, die einen bleibenden Einfluss auf unseren Planeten haben werden. Wir kÃÂÃÂ¶nnen das nur gemeinsam schaffen.ÃÂÃÂ Viele der neuen Unterzeichner des Climate Pledge machen bereits bedeutende Fortschritte bei der Reduzierung ihrer CO2-Emissionen: Maersk bietet branchenfÃÂÃÂ¼hrende grÃÂÃÂ¼ne Kundenangebote fÃÂÃÂ¼r die gesamte Lieferkette, darunter Maersk ECO Delivery, das auf die Verringerung der Emissionen im Seeverkehr abzielt. Im Jahr 2020 begann Amazon mit der Teilnahme an diesem Service und setzt ihn heute fort. Durch die Teilnahme von Amazon werden die Emissionen im Jahr 2021 um etwa 20.000 Tonnen CO2e (das entspricht 50 Millionen durchschnittlichen Pkw-Kilometern) reduziert. SAP verlegte kÃÂÃÂ¼rzlich sein Ziel, Netto-Null-Emissionen zu erreichen, auf 2030 ÃÂÃÂ 20 Jahre frÃÂÃÂ¼her als ursprÃÂÃÂ¼nglich geplant. Weyerhaeuser bewirtschaftet auf nachhaltige Weise WÃÂÃÂ¤lder und stellt Holzprodukte in ganz Nordamerika her, um eine nachhaltige Versorgung mit Holz fÃÂÃÂ¼r HÃÂÃÂ¤user und unzÃÂÃÂ¤hlige weitere Produkte zu gewÃÂÃÂ¤hrleisten und zur Zeit den Lebensraum von Wildtieren zu schÃÂÃÂ¼tzen und durch die Bindung und Speicherung von Kohlenstoff eine natÃÂÃÂ¼rliche LÃÂÃÂ¶sung fÃÂÃÂ¼r das Klima zu bieten. Weyerhaeuser forstet 100 Prozent seiner WaldflÃÂÃÂ¤chen nach der Ernte wieder auf und pflanzt jÃÂÃÂ¤hrlich zwischen 130 und 150 Millionen BÃÂÃÂ¤ume. Die Systeme von Sunrun haben 8,1 Millionen Tonnen CO2-Emissionen vermieden, was einer Einsparung von 20 Milliarden Kilometern entspricht, die von einem durchschnittlichen Pkw gefahren werden. Nachhaltigkeit ist seit Langem eine der wichtigsten strategischen GeschÃÂÃÂ¤ftssÃÂÃÂ¤ulen von HARMAN und hat einen hohen Stellenwert. Im Rahmen von HARMANs Verpflichtung, bis 2040 eine Netto-Null-Emission in den Bereichen 1, 2 und 3 zu erreichen, strebt das Unternehmen ehrgeizige, messbare, kurzfristige Ziele an, die auf die Reduzierung von Emissionen, Energieverbrauch und Abfall in seiner gesamten WertschÃÂÃÂ¶pfungskette ausgerichtet sind. HARMAN hat neue Produktlinien eingefÃÂÃÂ¼hrt, hergestellt aus verantwortungsvoll beschafften und recycelten Materialien, und sich dazu verpflichtet, bis 2025 in allen HARMAN-Fabriken zu 100 Prozent erneuerbare Energien einzusetzen. Heute heiÃÂÃÂt The Climate Pledge auch verschiedene Unternehmen willkommen, die zuvor Investitionen ÃÂÃÂ¼ber den mit 2 Milliarden USD dotierten Climate Pledge Fund erhalten haben, Amazons unternehmenseigener Risikokapitalfonds, der in Unternehmen investiert, die einen Beitrag zur schnelleren ErfÃÂÃÂ¼llung von The Climate Pledge leisten kÃÂÃÂ¶nnen. Unter diesen Unternehmen befinden sich BETA Technologies, ein Unternehmen fÃÂÃÂ¼r elektrische Luft- und Raumfahrt, und Infinium, ein Technologieunternehmen fÃÂÃÂ¼r erneuerbare Kraftstoffe, die beide darauf abzielen, die MaÃÂÃÂnahmen zur Dekarbonisierung der globalen Transportbranche zu unterstÃÂÃÂ¼tzen. Im Jahr 2020 war diese Branche fÃÂÃÂ¼r etwa 7,3 Milliarden Tonnen CO2-Emissionen verantwortlich. Fast 13 % der Unterzeichner stammen aus den Bereichen Transport, Luftfahrt und Logistik, was ein wichtiges Signal dafÃÂÃÂ¼r ist, dass die Nachfrage nach Produkten und Dienstleistungen, die zur Verringerung der CO2-Emissionen in diesem wichtigen Sektor beitragen, schnell ansteigen wird. Pachama, ein InvestitionsempfÃÂÃÂ¤nger des Climate Pledge Fund und neuer Unterzeichner, sorgt fÃÂÃÂ¼r QualitÃÂÃÂ¤t, Transparenz und GrÃÂÃÂ¶ÃÂÃÂenordnung auf den naturbasierten KohlenstoffmÃÂÃÂ¤rkten. Pachama verwendet Fernerkundung und maschinelles Lernen, um den CO2-Gehalt zu messen, der in den WÃÂÃÂ¤ldern gespeichert ist, und diese langfristig zu ÃÂÃÂ¼berwachen, sodass Organisationen und Einzelpersonen ihre Emissionen vertrauensvoll kompensieren kÃÂÃÂ¶nnen, indem sie Projekte zur Wiederaufforstung und Erhaltung der WÃÂÃÂ¤lder unterstÃÂÃÂ¼tzen. Die heutige AnkÃÂÃÂ¼ndigung verdeutlicht die Ergebnisse des jÃÂÃÂ¼ngsten Berichts des Intergovernmental Panel on Climate Change (IPCC) der Vereinten Nationen, in dem die Notwendigkeit sofortiger MaÃÂÃÂnahmen zur Verringerung der Treibhausgasemissionen, zur Investition in natÃÂÃÂ¼rliche KlimalÃÂÃÂ¶sungen zur Begrenzung der ErwÃÂÃÂ¤rmung auf etwa 1,5 Grad Celsius und zur Schadensbegrenzung betont wird. ÃÂÃÂIm Hinblick auf die groÃÂÃÂe Gefahr, die nach neuesten wissenschaftlichen Erkenntnissen besteht, muss die Wirtschaft einen klaren Weg nach vorn einschlagen: Die Reduktion der Emissionen muss beschleunigt werden, damit wir die schlimmsten SchÃÂÃÂ¤den vermeiden kÃÂÃÂ¶nnenÃÂÃÂ, sagte Christiana Figueres, Founding Partner von Global Optimism und ehemalige Klimachefin der Vereinten Nationen. ÃÂÃÂDeshalb ist es ermutigend, dass sich 300 Unternehmen zur Zusammenarbeit verpflichtet haben, um mit dem Climate Pledge bis 2040 oder frÃÂÃÂ¼her eine Netto-Null-Emission zu erzielen. Aber 300 Unternehmen sind nicht genug, um die nÃÂÃÂ¶tigen VerÃÂÃÂ¤nderungen herbeizufÃÂÃÂ¼hren. Ich fordere alle WirtschaftsfÃÂÃÂ¼hrer dazu auf, sich mit den wissenschaftlichen Erkenntnissen auseinanderzusetzen, sie fÃÂÃÂ¼r ihr Unternehmen zu nutzen und die erforderlichen VerÃÂÃÂ¤nderungen ohne VerzÃÂÃÂ¶gerung zu ermÃÂÃÂ¶glichen.ÃÂÃÂ Amazon und Global Optimism begrÃÂÃÂ¼ÃÂÃÂen die neuen Unterzeichner des Climate Pledge: Informationen zu allen 95 neuen Unterzeichnern, die sich zu The Climate Pledge verpflichtet haben, und zu den MaÃÂÃÂnahmen, die sie zur Dekarbonisierung ihrer Unternehmen ergreifen, sind auf der ÃÂÃÂThe Climate PledgeÃÂÃÂ-Website verfÃÂÃÂ¼gbar, darunter: Maersk A.P. Moller ÃÂÃÂ Maersk (Maersk) ist ein integriertes Logistikunternehmen und weltweit die grÃÂÃÂ¶ÃÂÃÂte Containerreederei. Als internationaler Anbieter von durchgÃÂÃÂ¤ngigen Logistikdienstleistungen fÃÂÃÂ¼r alle VerkehrstrÃÂÃÂ¤ger engagiert sich das Unternehmen dafÃÂÃÂ¼r, eine wesentliche Rolle bei der weltweiten Dekarbonisierung des Langstreckentransports zu spielen. Neben der Verringerung aller direkten und indirekten Emissionen im gesamten Unternehmen bis 2040 hat sich Maersk zudem dazu verpflichtet, sein Angebot fÃÂÃÂ¼r umweltbewusste Kunden auszubauen. Dazu zÃÂÃÂ¤hlt die Verpflichtung, bis 2030 25 % der Seefracht mit umweltfreundlichen Kraftstoffen zu transportieren, 90 % der Kontraktlogistik und der KÃÂÃÂ¼hlkette umweltfreundlich zu betreiben und mindestens 30 % der Luftfracht mit nachhaltigem Flugbenzin zu transportieren. Um diese ehrgeizigen Ziele zu erreichen, erforscht und testet Maersk nachhaltige Innovationen und investiert in diese, um einen Wandel in der gesamten Lieferkette zu ermÃÂÃÂ¶glichen. Maersk investiert derzeit in innovative neue Kraftstoffe, Schiffe, Elektro-LKWs, Netzwerkplanungssoftware, Technologien fÃÂÃÂ¼r den Informationsaustausch und viele weitere Bereiche. Dazu gehÃÂÃÂ¶rt unter anderem die Bestellung von 12 Schiffen, die mit grÃÂÃÂ¼nem Methanol betrieben werden kÃÂÃÂ¶nnen ÃÂÃÂ diese Schiffe werden 2024 einsatzbereit sein. ÃÂÃÂDie LÃÂÃÂ¶sung des Klimaproblems und die Dekarbonisierung der Lieferketten unserer Kunden ist fÃÂÃÂ¼r Maersk eine strategische NotwendigkeitÃÂÃÂ, sagte Soren Skou, A. P. Moller ÃÂÃÂ Maersk CEO. ÃÂÃÂAus diesem Grund haben wir bereits im Januar 2021 unsere Dekarbonisierungsverpflichtung auf Netto-Null-Emissionen bis 2040 vorgezogen ÃÂÃÂ ein Jahrzehnt frÃÂÃÂ¼her als unsere ursprÃÂÃÂ¼nglichen Ambitionen fÃÂÃÂ¼r 2050 und als im ÃÂÃÂbereinkommen von Paris vorgesehen. Wir alle mÃÂÃÂ¼ssen jetzt handeln, um den massiven Ausbau der grÃÂÃÂ¼nen Kraftstoffe voranzutreiben. Wenn wir in diesem Jahrzehnt VerÃÂÃÂ¤nderungen sehen wollen, kÃÂÃÂ¶nnen wir es uns nicht leisten, abzuwarten. In dieser Hinsicht freuen wir uns darauf, dem Climate Pledge beizutreten, eine Gelegenheit, mit einigen unserer wichtigsten Kunden zusammenzuarbeiten, von ihnen zu lernen und Best Practices und LÃÂÃÂ¶sungen auszutauschen.ÃÂÃÂ SAP SAP ist ein weltweit fÃÂÃÂ¼hrender Anbieter von Anwendungssoftware und -dienstleistungen fÃÂÃÂ¼r Unternehmen. SAP verfolgt die Vision, Unternehmen aller GrÃÂÃÂ¶ÃÂÃÂen und Branchen dabei zu unterstÃÂÃÂ¼tzen, intelligente, nachhaltige Unternehmen zu werden. Dies geschieht durch ein effizienteres, zuverlÃÂÃÂ¤ssigeres und wettbewerbsfÃÂÃÂ¤higeres Management von GeschÃÂÃÂ¤ftsdaten und -prozessen. SAP bietet nachhaltigkeitsspezifische LÃÂÃÂ¶sungen fÃÂÃÂ¼r das Management und die Berichterstattung ÃÂÃÂ¼ber die Nachhaltigkeitsperformance von Unternehmen, die CO2-Bilanzierung, das Abfallmanagement fÃÂÃÂ¼r Prozesse der Kreislaufwirtschaft sowie das verantwortungsvolle und inklusive Management der WertschÃÂÃÂ¶pfungskette. SAP hat vor kurzem seine Verpflichtung zu einer Netto-Null-Emission vom Jahr 2050 auf das Jahr 2030 vorgezogen. Das Unternehmen setzt sich wissenschaftsbasierte Ziele, um entlang seiner gesamten WertschÃÂÃÂ¶pfungskette Netto-Null-Emissionen zu erreichen, die mit einer zukÃÂÃÂ¼nftigen ErwÃÂÃÂ¤rmung um nur noch 1,5 Grad Celsius in Einklang stehen. SAP verfolgt eine langfristige Strategie des nachhaltigen GeschÃÂÃÂ¤ftsbetriebs in der ganzen Welt. Dazu gehÃÂÃÂ¶rt, dass SAP seit 2014 weltweit 100 Prozent erneuerbare Energien fÃÂÃÂ¼r die eigenen Rechenzentren und GebÃÂÃÂ¤ude einsetzt. DarÃÂÃÂ¼ber hinaus investiert SAP direkt in erneuerbare Energien sowie in naturbezogene und technische Fonds, um die verbleibenden CO2-Emissionen zu neutralisieren. ÃÂÃÂDer Klimawandel stellt eine der grÃÂÃÂ¶ÃÂÃÂten Herausforderungen unserer Zeit dar und es ist an der Zeit zu handelnÃÂÃÂ, sagte Christian Klein, CEO von SAP. ÃÂÃÂTechnologie gibt uns die MÃÂÃÂ¶glichkeit, einen bleibenden, positiven Einfluss fÃÂÃÂ¼r kÃÂÃÂ¼nftige Generationen zu erzielen, und SAP ist stolz darauf, sich dem Climate Pledge anzuschlieÃÂÃÂen, um diesen Wandel voranzutreiben.ÃÂÃÂ Weyerhaeuser Weyerhaeuser bewirtschaftet Millionen von Hektar an Holzland und betreibt 35 ProduktionsstÃÂÃÂ¤tten und 18 Vertriebszentren fÃÂÃÂ¼r Holzprodukte in ganz Nordamerika. Seit mehr als 120 Jahren bewirtschaftet Weyerhaeuser WÃÂÃÂ¤lder, die in einem kontinuierlichen Zyklus aufgeforstet, geerntet und wieder aufgeforstet werden. Die WÃÂÃÂ¤lder von Weyerhaeuser sorgen fÃÂÃÂ¼r saubere Luft und sauberes Wasser, Lebensraum fÃÂÃÂ¼r Wildtiere, ErholungsmÃÂÃÂ¶glichkeiten, erneuerbare Energie und eine nachhaltige Versorgung mit Holz fÃÂÃÂ¼r HÃÂÃÂ¤user und zahllose andere Produkte, auf die die Menschen tÃÂÃÂ¤glich vertrauen. Die WÃÂÃÂ¤lder und Werke von Weyerhaeuser bieten groÃÂÃÂartige ArbeitsplÃÂÃÂ¤tze und unterstÃÂÃÂ¼tzen die lokale Wirtschaft in den lÃÂÃÂ¤ndlichen Gebieten Nordamerikas. ÃÂÃÂNachhaltigkeit ist seit ÃÂÃÂ¼ber einem Jahrhundert ein Leitmotiv bei Weyerhaeuser, und wir vertreten seit langem die Ansicht, dass unser Unternehmen die Verpflichtung hat, einen positiven Einfluss auf unsere Gemeinden und die Gesellschaft im weiteren Sinne zu nehmenÃÂÃÂ, sagte Devin W. Stockfish, PrÃÂÃÂ¤sident und CEO von Weyerhaeuser. ÃÂÃÂUnsere bewirtschafteten WÃÂÃÂ¤lder und die nachhaltigen Holzerzeugnisse, die wir produzieren, spielen eine wesentliche Rolle bei der BekÃÂÃÂ¤mpfung der Auswirkungen des Klimawandels. Im Rahmen unserer laufenden NachhaltigkeitsaktivitÃÂÃÂ¤ten haben wir unseren ersten, branchenfÃÂÃÂ¼hrenden Carbon Record verÃÂÃÂ¶ffentlicht und uns durch die Festlegung eines ehrgeizigen, wissenschaftsbasierten Ziels zur Reduzierung von Treibhausgasen eine FÃÂÃÂ¼hrungsposition unter den nordamerikanischen Branchenkollegen erarbeitet. Die Unterzeichnung des Climate Pledge spiegelt unseren Einsatz fÃÂÃÂ¼r die Erreichung dieser Ziele wider und trÃÂÃÂ¤gt dazu bei, den Weg zu Netto-Null-Emissionen auf globaler Ebene anzufÃÂÃÂ¼hren.ÃÂÃÂ Sunrun Sunrun ist der landesweit fÃÂÃÂ¼hrende Anbieter von Solaranlagen, Batteriespeichern und Energiedienstleistungen fÃÂÃÂ¼r Privathaushalte. Sunrun wurde im Jahr 2007 gegrÃÂÃÂ¼ndet und leistete Pionierarbeit bei der Entwicklung von Service-PlÃÂÃÂ¤nen fÃÂÃÂ¼r Solaranlagen, die jedem den Zugang zu sauberer Energie vor Ort zu geringen oder gar keinen Vorlaufkosten ermÃÂÃÂ¶glichen. Die innovative Batterie-LÃÂÃÂ¶sung von Sunrun bietet Familien erschwingliche, bestÃÂÃÂ¤ndige und zuverlÃÂÃÂ¤ssige Energie. Im Jahr 2021 hat das Unternehmen 792 Megawatt an sauberer Energie fÃÂÃÂ¼r mehr als 110.000 Kunden bereitgestellt und damit die gesamte netzgebundene SolarenergiekapazitÃÂÃÂ¤t auf 4,7 Gigawatt erhÃÂÃÂ¶ht. Allein die im Jahr 2021 neu hinzugekommenen Anlagen werden in den nÃÂÃÂ¤chsten 30 Jahren voraussichtlich mehr als 17 Millionen Tonnen CO2 ausgleichen. Dem jÃÂÃÂ¼ngsten Impact Report des Unternehmens zufolge hat Sunrun seit 2007 mehr als 11 Milliarden Kilowattstunden an sauberer Energie erzeugt. ÃÂÃÂBei Sunrun stehen die Menschen und der Planet an erster StelleÃÂÃÂ, sagte Mary Powell, CEO von Sunrun. ÃÂÃÂSeit unserer GrÃÂÃÂ¼ndung haben wir mehr als 660.000 Kunden in den USA dabei geholfen, mit unseren Solar- und Batteriespeichersystemen fÃÂÃÂ¼r Privathaushalte auf saubere Energie umzusteigen und ihre CO2-Emissionen zu reduzieren, und wir stehen erst am Anfang. Wir konzentrieren uns darauf, weitere Wege zu erschlieÃÂÃÂen, um Haushalte zu elektrifizieren und allen Amerikanern die MÃÂÃÂ¶glichkeit zu geben, etwas gegen den Klimawandel zu unternehmen, Energiekosten zu senken und EnergieunabhÃÂÃÂ¤ngigkeit zu erlangen. Wir sind stolz darauf, dass wir dieses Engagement durch die Unterzeichnung des Climate Pledge zusammen mit anderen fÃÂÃÂ¼hrenden Unternehmen im Bereich der Nachhaltigkeit unter Beweis stellen kÃÂÃÂ¶nnen.ÃÂÃÂ HARMAN HARMAN konzipiert und erarbeitet vernetzte Produkte und LÃÂÃÂ¶sungen fÃÂÃÂ¼r Autohersteller, Verbraucher und Unternehmen weltweit, einschlieÃÂÃÂlich vernetzter Automobilsysteme, Audio- und visuellen Produkten, AutomatisierungslÃÂÃÂ¶sungen fÃÂÃÂ¼r Unternehmen; und Leistungen zur UnterstÃÂÃÂ¼tzung des Internet of Things (Internets der Dinge). Mit fÃÂÃÂ¼hrenden Marken wie AKG, Harman Kardon, Infinity, JBL, Lexicon, Mark Levinson und Revel wird HARMAN von Audiophilen, Musikern und den Veranstaltungsorten, an denen sie weltweit auftreten, bewundert. Mehr als 50 Millionen Automobile, die heute auf der StraÃÂÃÂe im Einsatz sind, sind mit HARMAN Audio- und vernetzten Automobilsystemen ausgerÃÂÃÂ¼stet. Die Software-Services von HARMAN versorgen Milliarden mobiler GerÃÂÃÂ¤te und Systeme, die ÃÂÃÂ¼ber alle Plattformen hinweg vernetzt, integriert und sicher sind, von der Arbeit und dem Zuhause bis hin zum Auto und Mobiltelefon. Im MÃÂÃÂ¤rz 2017 wurde HARMAN eine hundertprozentige Tochtergesellschaft von Samsung Electronics Co., Ltd. ÃÂÃÂBei HARMAN wissen wir, dass das Vorantreiben der Nachhaltigkeit eine kontinuierliche Aufgabe ist, die von einer konstanten Zusammenarbeit profitiertÃÂÃÂ, sagte Tom Mooney, Senior Director des Bereichs Government Affairs and Sustainability bei HARMAN. ÃÂÃÂJeder der anderen Unterzeichner des Climate Pledge hat sich ebenso wie wir fÃÂÃÂ¼r eine nachhaltigere Zukunft verpflichtet und weiÃÂÃÂ, wie wichtig es ist, auf unser gemeinsames Ziel hinzuarbeiten. Wir freuen uns, mit dieser Gemeinschaft von innovativen Unternehmen und Vordenkern zusammenzuarbeiten, um einen bedeutenden Wandel herbeizufÃÂÃÂ¼hren.ÃÂÃÂ ÃÂÃÂber den Climate Pledge Im Jahr 2019 riefen Amazon und Global Optimism gemeinsam das Klimaschutzversprechen The Climate Pledge ins Leben ÃÂÃÂ eine Verpflichtung, die Vorgaben des Pariser Abkommens zehn Jahre frÃÂÃÂ¼her zu erreichen und bis 2040 netto klimaneutral zu sein. Mittlerweile haben 312 Organisationen den Climate Pledge unterzeichnet und damit ein wichtiges Signal gesendet, dass die Nachfrage nach Produkten und Dienstleistungen, die zur Verringerung der CO2-Emissionen beitragen, schnell wachsen wird. Weitere Informationen erhalten Sie unter www.theclimatepledge.com. ÃÂÃÂber Amazon Amazon orientiert sich an vier GrundsÃÂÃÂ¤tzen: Orientierung am Kunden statt an der Konkurrenz, Leidenschaft fÃÂÃÂ¼r Neuerungen, Einsatz fÃÂÃÂ¼r betriebliche Optimierung sowie langfristiges Denken. Amazon strebt danach, das kundenorientierteste Unternehmen der Welt, der beste Arbeitgeber der Welt und der sicherste Arbeitsplatz der Welt zu sein. Kundenrezensionen, 1-Klick-EinkÃÂÃÂ¤ufe, personalisierte Empfehlungen, Prime, Versand durch Amazon, AWS, Kindle Direct Publishing, Kindle, Career Choice, Fire-Tablets, Fire TV, Amazon Echo, Alexa, ÃÂÃÂJust Walk OutÃÂÃÂ-Technologie, Amazon Studios und The Climate Pledge sind einige der Pionierleistungen von Amazon. FÃÂÃÂ¼r weitere Informationen besuchen Sie amazon.com/about und folgen Sie @AmazonNews. ÃÂÃÂber Global Optimism Global Optimism existiert, um transformatorische, branchenweite VerÃÂÃÂ¤nderungen herbeizufÃÂÃÂ¼hren. Das Erreichen einer emissionsfreien Zukunft ist keine weit in der Ferne liegende Herausforderung. Es ist eine, die wir jetzt in Angriff nehmen mÃÂÃÂ¼ssen. Jede wissenschaftliche Bewertung zeigt, dass wir unsere Emissionen zwischen 2020 und 2030 halbieren mÃÂÃÂ¼ssen, um das Ziel von Netto-Emissionen von Null bis 2050 zu erreichen und die globale ErwÃÂÃÂ¤rmung unter 1,5 Grad Celsius zu halten. Die BewÃÂÃÂ¤ltigung der Klimakrise ist nur mÃÂÃÂ¶glich, wenn alle ÃÂÃÂ¼berall ihren Beitrag leisten. Wir arbeiten mit gleichgesinnten Kollektiven aus allen Branchen zusammen, die bereit sind, in die erforderlichen Entscheidungen zu investieren, um sich auf diese herausfordernde ÃÂÃÂ lebensbejahende ÃÂÃÂ Reise zu begeben. Weitere Informationen finden Sie unter https://globaloptimism.com. Die Ausgangssprache, in der der Originaltext verÃÂÃÂ¶ffentlicht wird, ist die offizielle und autorisierte Version. ÃÂÃÂbersetzungen werden zur besseren VerstÃÂÃÂ¤ndigung mitgeliefert. Nur die Sprachversion, die im Original verÃÂÃÂ¶ffentlicht wurde, ist rechtsgÃÂÃÂ¼ltig. Gleichen Sie deshalb ÃÂÃÂbersetzungen mit der originalen Sprachversion der VerÃÂÃÂ¶ffentlichung ab.",https://www.businesswire.com/news/home/20220314005212/de/,businesswire.com,5,seattlebusiness wireamazon und global optimism verkndeten heute das inzwischen ber unternehmen climate pledge unterzeichnet haben einem anstieg der unterzeichner um fast im letzten jahr entspricht zu den fast neuen unterzeichnern gehren die grte containerreederei der welt maersk der fhrende entwickler von unternehmenssoftware sap da nordamerikanische holzunternehmen weyerhaeuser da grte solarunternehmen fr privathaushalte den usa sunrun und der marktfhrer fr vernetzte auto und audiodienste harman die unterzeichner der verpflichtungserklrung erwirtschaften insgesamt einen weltweiten jahresumsatz von ber billionen usd und haben mehr al millionen mitarbeiter branchen lndern die unterzeichner von climate pledge mssen zustimmen treibhausgasemissionen regelmig zu messen und darber zu berichten dekarbonisierungsstrategien im einklang mit dem bereinkommen von paris durch echte geschftliche vernderungen und innovationen umzusetzen einschlielich effizienzsteigerungen erneuerbarer energien materialreduzierungen und anderer strategien zur beseitigung von coemissionen alle verbleibenden emissionen durch zustzliche quantifizierbare reale dauerhafte und sozial ntzliche ausgleichsmanahmen zu neutralisieren um bi einen jhrlichen nettokohlenstoffaussto von null zu erreichen die folgen de klimawandels werden unserer umgebung und unserem alltglichen leben immer offensichtlicher und wir sind fest davon berzeugt das der private sektor weiterhin innovativ sein und ber regionen und branchen hinweg zusammenarbeiten mus damit die globale wirtschaft groem umfang dekarbonisiert werden kann sagte andy jassy ceo von amazon e ist ein ermutigendes zeichen das inzwischen ber unternehmen climate pledge unterzeichnet haben mit dem sie sich verpflichten dem klimawandel direkt entgegenzutreten indem sie echte geschftliche vernderungen umsetzen die einen bleibenden einfluss auf unseren planeten haben werden wir knnen da nur gemeinsam schaffen viele der neuen unterzeichner de climate pledge machen bereits bedeutende fortschritte bei der reduzierung ihrer coemissionen maersk bietet branchenfhrende grne kundenangebote fr die gesamte lieferkette darunter maersk eco delivery da auf die verringerung der emissionen im seeverkehr abzielt im jahr begann amazon mit der teilnahme diesem service und setzt ihn heute fort durch die teilnahme von amazon werden die emissionen im jahr um etwa tonnen coe da entspricht millionen durchschnittlichen pkwkilometern reduziert sap verlegte krzlich sein ziel nettonullemissionen zu erreichen auf jahre frher al ursprnglich geplant weyerhaeuser bewirtschaftet auf nachhaltige weise wlder und stellt holzprodukte ganz nordamerika um eine nachhaltige versorgung mit holz fr huser und unzhlige weitere produkte zu gewhrleisten und zur zeit den lebensraum von wildtieren zu schtzen und durch die bindung und speicherung von kohlenstoff eine natrliche lsung fr da klima zu bieten weyerhaeuser forstet prozent seiner waldflchen nach der ernte wieder auf und pflanzt jhrlich zwischen und millionen bume die systeme von sunrun haben millionen tonnen coemissionen vermieden einer einsparung von milliarden kilometern entspricht die von einem durchschnittlichen pkw gefahren werden nachhaltigkeit ist seit langem eine der wichtigsten strategischen geschftssulen von harman und hat einen hohen stellenwert im rahmen von harmans verpflichtung bi eine nettonullemission den bereichen und zu erreichen strebt da unternehmen ehrgeizige messbare kurzfristige ziele die auf die reduzierung von emissionen energieverbrauch und abfall seiner gesamten wertschpfungskette ausgerichtet sind harman hat neue produktlinien eingefhrt hergestellt au verantwortungsvoll beschafften und recycelten materialien und sich dazu verpflichtet bi allen harmanfabriken zu prozent erneuerbare energien einzusetzen heute heit climate pledge auch verschiedene unternehmen willkommen die zuvor investitionen ber den mit milliarden usd dotierten climate pledge fund erhalten haben amazon unternehmenseigener risikokapitalfonds der unternehmen investiert die einen beitrag zur schnelleren erfllung von climate pledge leisten knnen unter diesen unternehmen befinden sich beta technology ein unternehmen fr elektrische luft und raumfahrt und infinium ein technologieunternehmen fr erneuerbare kraftstoffe die beide darauf abzielen die manahmen zur dekarbonisierung der globalen transportbranche zu untersttzen im jahr war diese branche fr etwa milliarden tonnen coemissionen verantwortlich fast der unterzeichner stammen au den bereichen transport luftfahrt und logistik ein wichtiges signal dafr ist das die nachfrage nach produkten und dienstleistungen die zur verringerung der coemissionen diesem wichtigen sektor beitragen schnell ansteigen wird pachama ein investitionsempfnger de climate pledge fund und neuer unterzeichner sorgt fr qualitt transparenz und grenordnung auf den naturbasierten kohlenstoffmrkten pachama verwendet fernerkundung und maschinelles lernen um den cogehalt zu messen der den wldern gespeichert ist und diese langfristig zu berwachen sodass organisationen und einzelpersonen ihre emissionen vertrauensvoll kompensieren knnen indem sie projekte zur wiederaufforstung und erhaltung der wlder untersttzen die heutige ankndigung verdeutlicht die ergebnisse de jngsten berichts de intergovernmental panel climate change ipcc der vereinten nationen dem die notwendigkeit sofortiger manahmen zur verringerung der treibhausgasemissionen zur investition natrliche klimalsungen zur begrenzung der erwrmung auf etwa grad celsius und zur schadensbegrenzung betont wird im hinblick auf die groe gefahr die nach neuesten wissenschaftlichen erkenntnissen besteht mus die wirtschaft einen klaren weg nach vorn einschlagen die reduktion der emissionen mus beschleunigt werden damit wir die schlimmsten schden vermeiden knnen sagte christiana figueres founding partner von global optimism und ehemalige klimachefin der vereinten nationen deshalb ist e ermutigend das sich unternehmen zur zusammenarbeit verpflichtet haben um mit dem climate pledge bi oder frher eine nettonullemission zu erzielen aber unternehmen sind nicht genug um die ntigen vernderungen herbeizufhren ich fordere alle wirtschaftsfhrer dazu auf sich mit den wissenschaftlichen erkenntnissen auseinanderzusetzen sie fr ihr unternehmen zu nutzen und die erforderlichen vernderungen ohne verzgerung zu ermglichen amazon und global optimism begren die neuen unterzeichner de climate pledge informationen zu allen neuen unterzeichnern die sich zu climate pledge verpflichtet haben und zu den manahmen die sie zur dekarbonisierung ihrer unternehmen ergreifen sind auf der climate pledgewebsite verfgbar darunter maersk ap moller maersk maersk ist ein integriertes logistikunternehmen und weltweit die grte containerreederei al internationaler anbieter von durchgngigen logistikdienstleistungen fr alle verkehrstrger engagiert sich da unternehmen dafr eine wesentliche rolle bei der weltweiten dekarbonisierung de langstreckentransports zu spielen neben der verringerung aller direkten und indirekten emissionen im gesamten unternehmen bi hat sich maersk zudem dazu verpflichtet sein angebot fr umweltbewusste kunden auszubauen dazu zhlt die verpflichtung bi der seefracht mit umweltfreundlichen kraftstoffen zu transportieren der kontraktlogistik und der khlkette umweltfreundlich zu betreiben und mindestens der luftfracht mit nachhaltigem flugbenzin zu transportieren um diese ehrgeizigen ziele zu erreichen erforscht und testet maersk nachhaltige innovationen und investiert diese um einen wandel der gesamten lieferkette zu ermglichen maersk investiert derzeit innovative neue kraftstoffe schiffe elektrolkws netzwerkplanungssoftware technologien fr den informationsaustausch und viele weitere bereiche dazu gehrt unter anderem die bestellung von schiffen die mit grnem methanol betrieben werden knnen diese schiffe werden einsatzbereit sein die lsung de klimaproblems und die dekarbonisierung der lieferketten unserer kunden ist fr maersk eine strategische notwendigkeit sagte soren skou p moller maersk ceo au diesem grund haben wir bereits im januar unsere dekarbonisierungsverpflichtung auf nettonullemissionen bi vorgezogen ein jahrzehnt frher al unsere ursprnglichen ambitionen fr und al im bereinkommen von paris vorgesehen wir alle mssen jetzt handeln um den massiven ausbau der grnen kraftstoffe voranzutreiben wenn wir diesem jahrzehnt vernderungen sehen wollen knnen wir e un nicht leisten abzuwarten dieser hinsicht freuen wir un darauf dem climate pledge beizutreten eine gelegenheit mit einigen unserer wichtigsten kunden zusammenzuarbeiten von ihnen zu lernen und best practice und lsungen auszutauschen sap sap ist ein weltweit fhrender anbieter von anwendungssoftware und dienstleistungen fr unternehmen sap verfolgt die vision unternehmen aller gren und branchen dabei zu untersttzen intelligente nachhaltige unternehmen zu werden dy geschieht durch ein effizienteres zuverlssigeres und wettbewerbsfhigeres management von geschftsdaten und prozessen sap bietet nachhaltigkeitsspezifische lsungen fr da management und die berichterstattung ber die nachhaltigkeitsperformance von unternehmen die cobilanzierung da abfallmanagement fr prozesse der kreislaufwirtschaft sowie da verantwortungsvolle und inklusive management der wertschpfungskette sap hat vor kurzem seine verpflichtung zu einer nettonullemission vom jahr auf da jahr vorgezogen da unternehmen setzt sich wissenschaftsbasierte ziele um entlang seiner gesamten wertschpfungskette nettonullemissionen zu erreichen die mit einer zuknftigen erwrmung um nur noch grad celsius einklang stehen sap verfolgt eine langfristige strategie de nachhaltigen geschftsbetriebs der ganzen welt dazu gehrt das sap seit weltweit prozent erneuerbare energien fr die eigenen rechenzentren und gebude einsetzt darber hinaus investiert sap direkt erneuerbare energien sowie naturbezogene und technische fonds um die verbleibenden coemissionen zu neutralisieren der klimawandel stellt eine der grten herausforderungen unserer zeit dar und e ist der zeit zu handeln sagte christian klein ceo von sap technologie gibt un die mglichkeit einen bleibenden positiven einfluss fr knftige generationen zu erzielen und sap ist stolz darauf sich dem climate pledge anzuschlieen um diesen wandel voranzutreiben weyerhaeuser weyerhaeuser bewirtschaftet millionen von hektar holzland und betreibt produktionssttten und vertriebszentren fr holzprodukte ganz nordamerika seit mehr al jahren bewirtschaftet weyerhaeuser wlder die einem kontinuierlichen zyklus aufgeforstet geerntet und wieder aufgeforstet werden die wlder von weyerhaeuser sorgen fr saubere luft und sauberes wasser lebensraum fr wildtiere erholungsmglichkeiten erneuerbare energie und eine nachhaltige versorgung mit holz fr huser und zahllose andere produkte auf die die menschen tglich vertrauen die wlder und werke von weyerhaeuser bieten groartige arbeitspltze und untersttzen die lokale wirtschaft den lndlichen gebieten nordamerikas nachhaltigkeit ist seit ber einem jahrhundert ein leitmotiv bei weyerhaeuser und wir vertreten seit langem die ansicht das unser unternehmen die verpflichtung hat einen positiven einfluss auf unsere gemeinden und die gesellschaft im weiteren sinne zu nehmen sagte devin w stockfish prsident und ceo von weyerhaeuser unsere bewirtschafteten wlder und die nachhaltigen holzerzeugnisse die wir produzieren spielen eine wesentliche rolle bei der bekmpfung der auswirkungen de klimawandels im rahmen unserer laufenden nachhaltigkeitsaktivitten haben wir unseren ersten branchenfhrenden carbon record verffentlicht und un durch die festlegung eines ehrgeizigen wissenschaftsbasierten ziels zur reduzierung von treibhausgasen eine fhrungsposition unter den nordamerikanischen branchenkollegen erarbeitet die unterzeichnung de climate pledge spiegelt unseren einsatz fr die erreichung dieser ziele wider und trgt dazu bei den weg zu nettonullemissionen auf globaler ebene anzufhren sunrun sunrun ist der landesweit fhrende anbieter von solaranlagen batteriespeichern und energiedienstleistungen fr privathaushalte sunrun wurde im jahr gegrndet und leistete pionierarbeit bei der entwicklung von serviceplnen fr solaranlagen die jedem den zugang zu sauberer energie vor ort zu geringen oder gar keinen vorlaufkosten ermglichen die innovative batterielsung von sunrun bietet familien erschwingliche bestndige und zuverlssige energie im jahr hat da unternehmen megawatt sauberer energie fr mehr al kunden bereitgestellt und damit die gesamte netzgebundene solarenergiekapazitt auf gigawatt erhht allein die im jahr neu hinzugekommenen anlage werden den nchsten jahren voraussichtlich mehr al millionen tonnen co ausgleichen dem jngsten impact report de unternehmens zufolge hat sunrun seit mehr al milliarden kilowattstunden sauberer energie erzeugt bei sunrun stehen die menschen und der planet erster stelle sagte mary powell ceo von sunrun seit unserer grndung haben wir mehr al kunden den usa dabei geholfen mit unseren solar und batteriespeichersystemen fr privathaushalte auf saubere energie umzusteigen und ihre coemissionen zu reduzieren und wir stehen erst anfang wir konzentrieren un darauf weitere wege zu erschlieen um haushalte zu elektrifizieren und allen amerikanern die mglichkeit zu geben etwas gegen den klimawandel zu unternehmen energiekosten zu senken und energieunabhngigkeit zu erlangen wir sind stolz darauf das wir diesis engagement durch die unterzeichnung de climate pledge zusammen mit anderen fhrenden unternehmen im bereich der nachhaltigkeit unter beweis stellen knnen harman harman konzipiert und erarbeitet vernetzte produkte und lsungen fr autohersteller verbraucher und unternehmen weltweit einschlielich vernetzter automobilsysteme audio und visuellen produkten automatisierungslsungen fr unternehmen und leistungen zur untersttzung de internet thing internet der dinge mit fhrenden marken wie akg harman kardon infinity jbl lexicon mark levinson und revel wird harman von audiophilen musikern und den veranstaltungsorten denen sie weltweit auftreten bewundert mehr al millionen automobile die heute auf der strae im einsatz sind sind mit harman audio und vernetzten automobilsystemen ausgerstet die softwareservices von harman versorgen milliarden mobiler gerte und systeme die ber alle plattformen hinweg vernetzt integriert und sicher sind von der arbeit und dem zuhause bi hin zum auto und mobiltelefon im mrz wurde harman eine hundertprozentige tochtergesellschaft von samsung electronics co ltd bei harman wissen wir das da vorantreiben der nachhaltigkeit eine kontinuierliche aufgabe ist die von einer konstanten zusammenarbeit profitiert sagte tom mooney senior director de bereichs government affair sustainability bei harman jeder der anderen unterzeichner de climate pledge hat sich ebenso wie wir fr eine nachhaltigere zukunft verpflichtet und wei wie wichtig e ist auf unser gemeinsames ziel hinzuarbeiten wir freuen un mit dieser gemeinschaft von innovativen unternehmen und vordenkern zusammenzuarbeiten um einen bedeutenden wandel herbeizufhren ber den climate pledge im jahr riefen amazon und global optimism gemeinsam da klimaschutzversprechen climate pledge in leben eine verpflichtung die vorgaben de pariser abkommens zehn jahre frher zu erreichen und bi netto klimaneutral zu sein mittlerweile haben organisationen den climate pledge unterzeichnet und damit ein wichtiges signal gesendet das die nachfrage nach produkten und dienstleistungen die zur verringerung der coemissionen beitragen schnell wachsen wird weitere informationen erhalten sie unter ber amazon amazon orientiert sich vier grundstzen orientierung kunden statt der konkurrenz leidenschaft fr neuerungen einsatz fr betriebliche optimierung sowie langfristiges denken amazon strebt danach da kundenorientierteste unternehmen der welt der beste arbeitgeber der welt und der sicherste arbeitsplatz der welt zu sein kundenrezensionen klickeinkufe personalisierte empfehlungen prime versand durch amazon aws kindle direct publishing kindle career choice firetablets fire tv amazon echo alexa walk outtechnologie amazon studio und climate pledge sind einige der pionierleistungen von amazon fr weitere informationen besuchen sie amazoncomabout und folgen sie amazonnews ber global optimism global optimism existiert um transformatorische branchenweite vernderungen herbeizufhren da erreichen einer emissionsfreien zukunft ist keine weit der ferne liegende herausforderung e ist eine die wir jetzt angriff nehmen mssen jede wissenschaftliche bewertung zeigt das wir unsere emissionen zwischen und halbieren mssen um da ziel von nettoemissionen von null bi zu erreichen und die globale erwrmung unter grad celsius zu halten die bewltigung der klimakrise ist nur mglich wenn alle berall ihren beitrag leisten wir arbeiten mit gleichgesinnten kollektiven au allen branchen zusammen die bereit sind die erforderlichen entscheidungen zu investieren um sich auf diese herausfordernde lebensbejahende reise zu begeben weitere informationen finden sie unter die ausgangssprache der der originaltext verffentlicht wird ist die offizielle und autorisierte version bersetzungen werden zur besseren verstndigung mitgeliefert nur die sprachversion die im original verffentlicht wurde ist rechtsgltig gleichen sie deshalb bersetzungen mit der originalen sprachversion der verffentlichung ab,-0.9998,-0.4999,0.14549,-0.64539,Negative Impact
17/03/2022,152.6405,157.50,152.14,157.24,157.24,72934000,-0.27,-314.4290963,1.192,0,14.33339876,0.959429757,-0.018638346,0.2,287.504,13614.78027,16483.58008,7385.299805,6612.52002,3215.040039,57863.92969,21771.19922,151.8993597,166.5385452,152.9435792,161.3588338,148.1186508,160.0457571,136.1915445,53.399606,-1.125357494,-2.437072325,1.31171483,5.766496931,136.7430138,10044304000,98.91538027,86.17981139,25.67000008,Why You Should Buy Cybersecurity Stocks & ETFs Now,We could see surge in cybersecurity attacks as the war escalates.,https://www.zacks.com/stock/news/1883727/why-you-should-buy-cybersecurity-stocks-etfs-now,zacks.com,8,could see surge cybersecurity attack war escalates,-0.7906,-0.63248,0.1641979167,-0.796677917,Negative Impact
18/03/2022,156.813,161.59,156.01,161.25,161.25,102962000,-0.27,-314.4290963,1.192,0,14.33339876,0.959429757,-0.018638346,0.2,287.504,13893.83984,16612.64063,7404.700195,6620.240234,3251.070068,57863.92969,21818.5,151.8372299,166.5480452,153.2693409,161.3577559,148.4485512,161.452948,135.4441544,57.0482846,-0.009295922,-1.951517044,1.942221122,5.90813991,138.4034531,10147266000,98.77418909,97.08082379,23.87000084,Expect Amazon to Report Its Largest Quarterly Loss in History in April -- Here's Why,Amazon's Q1 net loss could blow its previous largest quarterly loss of $545 million out of the water.,https://www.fool.com/investing/2022/03/18/amazon-to-report-largest-quarterly-loss-in-history/,fool.com,7,amazon q net loss could blow previous largest quarterly loss million water,-0.4404,-0.30828,0.007411428571,-0.315691429,Negative Impact
21/03/2022,161.121,163.08,159.55,161.49,161.49,66538000,-0.27,-314.4290963,1.192,0,14.33339876,0.959429757,-0.018638346,0.2,287.504,13838.45996,16606.66992,7442.399902,6582.330078,3253.689941,57292.48828,22009.09961,151.80198,166.5539477,153.5917786,161.3590867,148.8930511,163.0516493,134.734453,59.88405491,0.8844420864,-1.384325218,2.268767305,5.86592647,140.7225072,10213804000,94.60380359,97.43112432,23.53000069,Will Amazon Make Streaming Shoppable?,"The Netflix series ÃÂÃÂEmily in Paris,ÃÂÃÂ which debuted in May of 2021, didn't exactly start off on the right foot. Panned by critics and viewers, its Rotten Tomatoes average audience score of 47 seemed to reflect the social media banter over the ÃÂÃÂinfuriatingÃÂÃÂ naivete of the main character and uninspiring plot.",https://www.pymnts.com/amazon/2022/amazons-next-big-thing-make-streaming-shoppable/,pymnts.com,5,netflix series emily paris debuted may didnt exactly start right foot panned critic viewer rotten tomato average audience score seemed reflect social medium banter infuriating naivete main character uninspiring plot,-0.8316,-0.4158,0.1034525,-0.5192525,Negative Impact
22/03/2022,161.8055,166.17,161.70,164.89,164.89,64086000,-0.27,-314.4290963,1.192,0,14.33339876,0.959429757,-0.018638346,0.2,287.504,14108.82031,16735.48047,7476.700195,6659.410156,3259.860107,57989.30078,22074.40039,151.8486801,166.5788902,154.0348072,161.3942103,149.6276268,165.4927826,133.762471,61.70326605,1.845611237,-0.738337927,2.583949164,5.896355765,143.4058863,10277890000,96.07909503,96.4856959,22.94000053,Amazon Stock Is a Long-Term Buy and a Short-Term Sell,AMZN stock is primed for a pullback before it gets to new highs post split. Patience will pay with a lower entry price.,https://investorplace.com/2022/03/amzn-stock-amazon-is-a-long-term-buy-and-a-short-term-sell/,investorplace.com,6,amzn stock primed pullback get new high post split patience pay lower entry price,-0.3818,-0.22908,0.19409,-0.42317,Negative Impact
23/03/2022,163.705,166.37,162.69,163.41,163.41,55812000,-0.27,-314.4290963,1.192,0,14.33339876,0.959429757,-0.018638346,0.2,287.504,13922.59961,16558.5293,7460.600098,6581.430176,3271.030029,57684.82031,21932.19922,151.8871204,166.5799027,154.4023835,161.414248,150.5566772,167.3851,133.7282545,64.86480953,2.45948871,-0.0987726,2.55826131,5.654212952,146.5924433,10222078000,90.96885341,93.88391735,23.56999969,eero Introduces Its Fastest Mesh Wifi SystemsÃÂÃÂeero Pro 6E and eero 6+,"SEATTLE--(BUSINESS WIRE)--eero, an Amazon (NASDAQ: AMZN) company, today introduced eero Pro 6E and eero 6+ÃÂÃÂthe newest additions to the eero 6 series of mesh wifi systems. eero Pro 6E, the first Wi-Fi 6E-enabled eero mesh wifi system, supports network speeds up to 2.3 Gbps, provides coverage for over 100 devices simultaneously, and offers access to the newly-authorized 6 GHz band, all of which ensures more devices can get gigabit+ speeds across your home. eero 6+ is the most affordable gigabit-capable eero system, with access to 160 MHz radio channels for fast connectivity for activities like AR, VR, and 8K streaming; plus, it supports over 75 simultaneously-connected devices. For customers looking for Wi-Fi 6 performance at an affordable price, eero 6 is now available at a starting price of $89. ÃÂÃÂSince eeroÃÂÃÂs beginning a little over eight years ago, we have had a vision to provide every home around the world with wifi that just works,ÃÂÃÂ said Nick Weaver, Co-Founder and CEO of eero. ÃÂÃÂWifi has changed a lot since then, and weÃÂÃÂve worked hard to expand our portfolio and make our easy-to-use, fast, secure, and reliable whole-home wifi systems more accessible and affordable for everyone. With the introduction of eero Pro 6E and eero 6+ alongside our existing eero 6 series devices, weÃÂÃÂre taking a big step in delivering our highest performing and most affordable wifi systems for everyone.ÃÂÃÂ eero 6 Series Delivers Wifi for a Variety of Homes and Technology Uses With the launch of eero Pro 6E and eero 6+, and the availability of eero 6 at a new low price, there is now an eero 6 system for every kind of home and technology need: eero Pro 6E. The first Wi-Fi 6E-enabled eero mesh wifi system and newest tri-band offering, eero Pro 6E sets a new standard for top-of-the-line eero performance with support for over 100 devices simultaneously. Capable of supporting network speeds up to 2.3 Gbps (a gigabit wired and 1.3 Gbps wireless), eero Pro 6E supports gigabit+ wifi speeds across your home and leverages the newly-authorized 6 GHz band to provide access to a new, spacious wifi ÃÂÃÂtraffic laneÃÂÃÂ to enable faster speeds and less congestion across your home network. With 1 x 2.5 GbE and 1 x 1.0 GbE Ethernet ports on each device, eero Pro 6E can support multigigabit internet plans. And with the additional wifi bandwidth of 160 MHz radio channels, eero Pro 6E supports fast connectivity for activities like AR, VR, and 8K streaming. A single eero Pro 6E covers up to 2,000 square feet; a 2-pack covers up to 4,000 square feet; and a 3-pack covers up to 6,000 square feet. eero 6+. The most affordable eero gigabit system ever, eero 6+ enables premium wifi performance without a premium price tag. The latest dual-band offering from eero is ideal for internet service plans up to a gigabit and offers coverage for over 75 devices simultaneously. Each device has 2 x 1.0 GbE ports for gigabit wired connectivity and also provides access to the 160 MHz radio channel for faster wireless connectivity than prior eero dual-band offerings. A single eero 6+ covers up to 1,500 square feet; a 2-pack covers up to 3,000 square feet; and a 3-pack covers up to 4,500 square feet. eero 6 at a new low price. Now, starting at $89, eero 6 gives you Wi-Fi 6 speeds at an affordable price. The award-winning eero 6 mesh system is perfect for homes with internet connections up to 500 Mbps and provides coverage for over 75 devices simultaneously. A single eero 6 is a dual-band mesh Wi-Fi 6 router with two Ethernet ports and covers up to 1,500 square feet. A 2-pack covers up to 3,000 square feet and includes an eero 6 mesh router and eero 6 mesh wifi extender. A 3-pack covers up to 4,500 square feet, and includes an eero 6 and two eero 6 mesh wifi extenders. Additional eero 6 Series Features and Benefits All eero 6 series devices work with your existing internet service and offer several features to unlock your wifiÃÂÃÂs potential, including: Easy to set up. Setting up your new eero takes just minutes with in-app instructions. Simply unplug your old router and connect your eero router to your modem. Sign in to the app, and youÃÂÃÂre ready to goÃÂÃÂno expertise required. Backward compatible. eero 6 series devices are backward compatible with previous generation eero devices, and you can easily expand your network by adding more eero devices when your wifi needs change. You can also swap your existing eero gateway with a newer eero router without tearing down your existing network. TrueMesh. All eero devices use patented eero TrueMesh networking technology to intelligently route network traffic to reduce congestion, buffering, and drop-offs, so you can stream in 4K, play games, and video conference with ease. Easy to manage your network. You can use the eero app to manage your network, pause the internet, share your network with friends or guests, and moreÃÂÃÂwhether youÃÂÃÂre at home or on the go. With the eero skill for Alexa, you can use an Alexa-enabled device or the Alexa app to manage eero features with your voice. For example, simply say, ÃÂÃÂAlexa, ask eero to pause TommyÃÂÃÂs profileÃÂÃÂ to pause internet access on all devices in TommyÃÂÃÂs profile. Frustration-Free Setup. After linking your eero account with your Amazon account, enabled devices instantly join the network and stay connected when you change your network name or password. Seamlessly manage your smart home. Featuring a built-in Zigbee smart home hub, all eero 6 series devices can connect compatible smart home devices on your network with Alexa, so you donÃÂÃÂt need a separate Zigbee hub. eero 6 devices can also act as a Thread border router to provide interoperability with Matter-certified devices. Safe and secure wifi. eero is constantly working to help keep your network safe and secure. Automatic software updates provide the latest security patches, bug fixes, and feature upgrades. With eero Secure+, you can add advanced online security features and parental controls, along with three top-rated security apps: 1Password for password management, Malwarebytes for malware protection, and Encrypt.me for VPN. Free customer support. Our expert wifi troubleshooters are ready to help by phone or email seven days per week for the life of your eero devices. Pricing and Availability eero 6 series devices are available at eero.com, Amazon.com, and leading retailers. eero Pro 6E is now available for $499 (2-pack) and $699 (3-pack). The eero Pro 6E one-pack is available for pre-order for $299. eero 6+ is now available for $239 (2-pack) and $299 (3-pack). The eero 6+ 1-pack is available for pre-order for $139. eero 6 is now available at new low prices including $89 (1-pack), $139 (2-pack), and $199 (3-pack). For advanced online security, eero Secure+ is available for $9.99 per month. The new eero 6 series devices will also be available to customers through participating internet service providers, custom installation professionals, and homebuilders. About eero The first mesh home wifi system, eero blankets any home in reliable and secure wifi. eero offers advanced online security tools, eero Secure and eero Secure+, to help protect personal data, devices, and networks from online threats. Available through participating retailers and internet service providers in various countries around the world, eero is simple to set up, even easier to manage, and improves over time with regular, automatic software updates. Founded in 2014 by Amos Schallich, Nate Hardison, and Nick Weaver, eero is an Amazon company. For more information, visit eero.com. About Amazon Amazon is guided by four principles: customer obsession rather than competitor focus, passion for invention, commitment to operational excellence, and long-term thinking. Amazon strives to be EarthÃÂÃÂs Most Customer-Centric Company, EarthÃÂÃÂs Best Employer, and EarthÃÂÃÂs Safest Place to Work. Customer reviews, 1-Click shopping, personalized recommendations, Prime, Fulfillment by Amazon, AWS, Kindle Direct Publishing, Kindle, Career Choice, Fire tablets, Fire TV, Amazon Echo, Alexa, Just Walk Out technology, Amazon Studios, and The Climate Pledge are some of the things pioneered by Amazon. For more information, visit amazon.com/about and follow @AmazonNews.",https://www.businesswire.com/news/home/20220323005362/en/eero-Introduces-Its-Fastest-Mesh-Wifi-Systems%E2%80%94eero-Pro-6E-and-eero-6,businesswire.com,5,seattlebusiness wireeero amazon nasdaq amzn company today introduced eero pro e eero newest addition eero series mesh wifi system eero pro e first wifi eenabled eero mesh wifi system support network speed gbps provides coverage device simultaneously offer access newlyauthorized ghz band ensures device get gigabit speed across home eero affordable gigabitcapable eero system access mhz radio channel fast connectivity activity like ar vr k streaming plus support simultaneouslyconnected device customer looking wifi performance affordable price eero available starting price since eeros beginning little eight year ago vision provide every home around world wifi work said nick weaver cofounder ceo eero wifi changed lot since weve worked hard expand portfolio make easytouse fast secure reliable wholehome wifi system accessible affordable everyone introduction eero pro e eero alongside existing eero series device taking big step delivering highest performing affordable wifi system everyone eero series delivers wifi variety home technology us launch eero pro e eero availability eero new low price eero system every kind home technology need eero pro e first wifi eenabled eero mesh wifi system newest triband offering eero pro e set new standard topoftheline eero performance support device simultaneously capable supporting network speed gbps gigabit wired gbps wireless eero pro e support gigabit wifi speed across home leverage newlyauthorized ghz band provide access new spacious wifi traffic lane enable faster speed less congestion across home network x gbe x gbe ethernet port device eero pro e support multigigabit internet plan additional wifi bandwidth mhz radio channel eero pro e support fast connectivity activity like ar vr k streaming single eero pro e cover square foot pack cover square foot pack cover square foot eero affordable eero gigabit system ever eero enables premium wifi performance without premium price tag latest dualband offering eero ideal internet service plan gigabit offer coverage device simultaneously device x gbe port gigabit wired connectivity also provides access mhz radio channel faster wireless connectivity prior eero dualband offering single eero cover square foot pack cover square foot pack cover square foot eero new low price starting eero give wifi speed affordable price awardwinning eero mesh system perfect home internet connection mbps provides coverage device simultaneously single eero dualband mesh wifi router two ethernet port cover square foot pack cover square foot includes eero mesh router eero mesh wifi extender pack cover square foot includes eero two eero mesh wifi extenders additional eero series feature benefit eero series device work existing internet service offer several feature unlock wifi potential including easy set setting new eero take minute inapp instruction simply unplug old router connect eero router modem sign app youre ready gono expertise required backward compatible eero series device backward compatible previous generation eero device easily expand network adding eero device wifi need change also swap existing eero gateway newer eero router without tearing existing network truemesh eero device use patented eero truemesh networking technology intelligently route network traffic reduce congestion buffering dropoffs stream k play game video conference ease easy manage network use eero app manage network pause internet share network friend guest morewhether youre home go eero skill alexa use alexaenabled device alexa app manage eero feature voice example simply say alexa ask eero pause tommys profile pause internet access device tommys profile frustrationfree setup linking eero account amazon account enabled device instantly join network stay connected change network name password seamlessly manage smart home featuring builtin zigbee smart home hub eero series device connect compatible smart home device network alexa dont need separate zigbee hub eero device also act thread border router provide interoperability mattercertified device safe secure wifi eero constantly working help keep network safe secure automatic software update provide latest security patch bug fix feature upgrade eero secure add advanced online security feature parental control along three toprated security apps password password management malwarebytes malware protection encryptme vpn free customer support expert wifi troubleshooter ready help phone email seven day per week life eero device pricing availability eero series device available eerocom amazoncom leading retailer eero pro e available pack pack eero pro e onepack available preorder eero available pack pack eero pack available preorder eero available new low price including pack pack pack advanced online security eero secure available per month new eero series device also available customer participating internet service provider custom installation professional homebuilder eero first mesh home wifi system eero blanket home reliable secure wifi eero offer advanced online security tool eero secure eero secure help protect personal data device network online threat available participating retailer internet service provider various country around world eero simple set even easier manage improves time regular automatic software update founded amos schallich nate hardison nick weaver eero amazon company information visit eerocom amazon amazon guided four principle customer obsession rather competitor focus passion invention commitment operational excellence longterm thinking amazon strives earth customercentric company earth best employer earth safest place work customer review click shopping personalized recommendation prime fulfillment amazon aws kindle direct publishing kindle career choice fire tablet fire tv amazon echo alexa walk technology amazon studio climate pledge thing pioneered amazon information visit amazoncomabout follow amazonnews,0.9993,0.49965,0.148145,0.351505,Positive Impact
24/03/2022,163.7495,164.12,160.05,163.65,163.65,56798000,-0.27,-314.4290963,1.192,0,14.33339876,0.959429757,-0.018638346,0.2,287.504,14191.83984,16701.82031,7467.399902,6555.77002,3250.26001,57595.67969,21937.90039,151.8528705,166.5778628,154.7650158,161.4364894,151.1712524,168.9914426,133.3510623,67.95372516,2.931683508,0.5073186219,2.424364886,5.652570452,149.7568516,10278876000,91.70519262,92.91771369,21.67000008,Why Amazon Stock Didn't Deliver on Thursday,A Morgan Stanley analyst cuts a pair of EBITDA estimates for the monster retailer.,https://www.fool.com/investing/2022/03/24/why-amazon-stock-didnt-deliver-on-thursday/,fool.com,7,morgan stanley analyst cut pair ebitda estimate monster retailer,-0.2732,-0.19124,0.31231,-0.50355,Negative Impact
25/03/2022,164,165.37,162.25,164.77,164.77,49032000,-0.27,-314.4290963,1.192,0,14.33339876,0.959429757,-0.018638346,0.2,287.504,14169.2998,16792.80078,7483.399902,6553.680176,3212.23999,57362.19922,22005.90039,151.8442004,166.5643178,155.1575053,161.4696934,151.7205025,170.5300393,132.9109656,81.70274625,3.357890451,1.077432988,2.280457464,5.255463736,152.4149545,10327908000,95.13226145,92.60210249,20.80999947,Amazon Stock Is Marching Higher. 4 Reasons the Shares Can Keep Rising.,"From its investments to distribution capacity to the opportunities in grocery delivery, investors should be bullish on Amazon, said a team at Evercore ISI.",https://www.barrons.com/articles/amazon-stock-is-marching-higher-4-reasons-the-shares-can-keep-rising-51648214286,barrons.com,9,investment distribution capacity opportunity grocery delivery investor bullish amazon said team evercore isi,0.5423,0.48807,0.17423125,0.31383875,Positive Impact
28/03/2022,164.975,169.04,164.90,168.99,168.99,59854000,-0.27,-314.4290963,1.192,0,14.33339876,0.959429757,-0.018638346,0.2,287.504,14354.90039,16798.7207,7473.100098,6589.109863,3214.5,57593.48828,21977.80078,151.9997302,166.5725627,155.6999754,161.5445273,152.491877,172.8233466,132.1604073,85.94739551,3.989945193,1.659935429,2.330009764,5.050964355,154.647761,10387762000,99.85404205,95.56383204,19.62999916,Is This Metaverse Stock Poised for a Comeback?,Investors may find some value in Matterport as the stock has fallen from its highs in November 2021.,https://www.fool.com/investing/2022/03/28/is-this-metaverse-stock-poised-for-a-comeback/,fool.com,7,investor may find value matterport stock fallen high november,-0.0258,-0.01806,0.3962,-0.41426,Negative Impact
29/03/2022,170.384,170.83,167.87,169.32,169.32,66154000,-0.27,-314.4290963,1.192,0,14.33339876,0.959429757,-0.018638346,0.2,287.504,14619.63965,17014.75977,7537.299805,6792.160156,3203.939941,57943.64844,22087.19922,152.1432703,166.5731702,156.2338981,161.6218454,153.4005272,175.0590425,131.7420119,84.9849552,4.465562047,2.221060753,2.244501295,4.960071019,157.2379151,10453916000,94.93615484,96.64081945,18.89999962,Bonds Are Screaming ÃÂÃÂRecession.ÃÂÃÂ That's Great News For One Top Sector.,The 10-2 year treasury yield spread is close to zero. Here's what you should do about this warning sign of a coming recession.,https://investorplace.com/2022/03/bonds-are-screaming-recession-thats-great-news-for-one-top-sector/,investorplace.com,6,year treasury yield spread close zero here warning sign coming recession,-0.5267,-0.31602,0.1755313333,-0.491551333,Negative Impact
30/03/2022,168.5095,168.95,165.50,166.30,166.30,56168000,-0.27,-314.4290963,1.192,0,14.33339876,0.959429757,-0.018638346,0.2,287.504,14442.26953,16932.75977,7578.799805,6741.589844,3266.600098,58683.98828,22076,152.2909402,166.5588927,156.6286862,161.6684041,154.1129517,176.5095563,131.716347,75.36745832,4.546873087,2.686223219,1.860649867,4.561464582,159.9566315,10397748000,84.87184857,93.22068182,19.32999992,Byron Deeter: 2022 is the ÃÂÃÂamazon moment' for the cloud industry,"The BVP Nasdaq Emerging Cloud Index down 35% from its high in early November 2021 is the ÃÂÃÂactionable momentÃÂÃÂ for investors, says Bessemer Venture Partners' Byron Deeter. Deeter's remarks on CNBC's ÃÂÃÂTechCheck' Deeter attributes the weakness in cloud stocks to macroeconomic factors, including inflation, rate hikes, and the ongoing war in Ukraine.",https://invezz.com/news/2022/03/30/byron-deeter-2022-is-the-amazon-moment-for-the-cloud-industry/,invezz.com,5,bvp nasdaq emerging cloud index high early november actionable moment investor say bessemer venture partner byron deeter deeters remark cnbcs techcheck deeter attribute weakness cloud stock macroeconomic factor including inflation rate hike ongoing war ukraine,-0.7717,-0.38585,0.2111925,-0.5970425,Negative Impact
31/03/2022,166.445,166.50,162.95,163.00,163.00,59966000,-0.27,-314.4290963,1.192,0,14.33339876,0.959429757,-0.018638346,0.2,287.504,14220.51953,16670.91016,7515.700195,6659.870117,3252.199951,58568.51172,21890.19922,152.4249103,166.5200677,156.8784435,161.681629,154.8679016,177.400004,132.3357993,71.61802041,4.295235248,3.008025625,1.287209623,4.506856646,162.1316047,10337782000,73.84088465,84.54962935,20.55999947,Global energy crunch stirs hope of oil reboot in Peru's Amazon,Peru's government wants to ramp up oil production in some of its dormant Amazonian fields as global crude prices soar on supply fears linked to Russia's invasion of Ukraine.,https://www.reuters.com/world/americas/global-energy-crunch-stirs-hope-oil-reboot-perus-amazon-2022-03-31/,reuters.com,10,peru government want ramp oil production dormant amazonian field global crude price soar supply fear linked russia invasion ukraine,-0.765,-0.765,0.1045869231,-0.869586923,Negative Impact
01/04/2022,164.1495,165.83,162.32,163.56,163.56,57090000,-0.27,-314.4290963,1.192,0,14.33339876,0.959429757,-0.018638346,0.33,289.109,14261.5,16787.75,7537.899902,6684.310059,3282.719971,59276.69141,21953,152.6627603,166.4655577,157.1404652,161.7003192,155.7638512,178.1758625,133.3518398,79.09472356,4.094006341,3.225221768,0.8687845725,4.288392203,170.8314972,10394872000,74.77932004,77.83068442,19.62999916,"Factbox-Recent U.S. union wins at Amazon, Starbucks and more","The COVID-19 pandemic, labor shortage, Black Lives Matter movement and other social and economic forces have contributed to an uptick in high-profile union organizing across the United States, with a win at Amazon on Friday garnering national attention.",https://www.reuters.com/business/recent-us-union-wins-amazon-starbucks-more-2022-04-01/,reuters.com,10,covid pandemic labor shortage black life matter movement social economic force contributed uptick highprofile union organizing across united state win amazon friday garnering national attention,0.7506,0.7506,0.1990322222,0.5515677778,Positive Impact
04/04/2022,164.125,168.39,163.21,168.35,168.35,49882000,-0.27,-314.4290963,1.192,0,14.33339876,0.959429757,-0.018638346,0.33,289.109,14532.5498,16829.75,7558.899902,6731.370117,3282.719971,60611.73828,22085.59961,153.1768301,166.4355652,157.5799174,161.7664503,157.3085258,178.6391665,135.9778852,78.6792101,4.271522004,3.434481815,0.8370401883,4.221034459,170.6612573,10444754000,89.41561911,79.3452746,18.56999969,Amazon considered creating app for its workers and blocking words like 'union' -The Intercept,"Amazon.com Inc staff included the words ""union,"" ""grievance,"" and ""living wage"" on a preliminary list of terms to block from an internal messaging app it was considering creating to boost worker morale, The Intercept reported on Monday.",https://www.reuters.com/business/amazon-considered-creating-app-its-workers-blocking-words-like-union-the-2022-04-04/,reuters.com,10,amazoncom inc staff included word union grievance living wage preliminary list term block internal messaging app considering creating boost worker morale intercept reported monday,-0.2732,-0.2732,0.3006461538,-0.573846154,Negative Impact
05/04/2022,167.7415,168.11,163.27,164.06,164.05,53728000,-0.27,-314.4290963,1.192,0,14.33339876,0.959429757,-0.018638346,0.33,289.109,14204.16992,16645.05078,7613.700195,6645.509766,3282.719971,60176.5,21930.80078,153.5670499,166.3923502,157.8338419,161.7892219,158.7105507,177.7063825,139.7147189,65.58592844,4.019580722,3.551501597,0.4680791249,4.169891357,170.4944223,10391026000,63.74552437,75.9801545,21.03000069,"Amazon sichert sich bis zu 83 Starts von Arianespace, Blue Origin und United Launch Alliance fÃÂÃÂ¼r Project Kuiper","SEATTLE--(BUSINESS WIRE)--Amazon (NASDAQ: AMZN) gab heute Vereinbarungen mit Arianespace, Blue Origin und United Launch Alliance (ULA) bekannt, um Schwerlast-Startdienste fÃÂÃÂ¼r Project Kuiper bereitzustellen, Amazons Initiative zur Verbesserung des globalen Breitbandzugangs mithilfe einer Konstellation von Satelliten im erdnahen Orbit (LEO). Die VertrÃÂÃÂ¤ge belaufen sich auf bis zu 83 Starts ÃÂÃÂ¼ber einen Zeitraum von fÃÂÃÂ¼nf Jahren und bieten Amazon die KapazitÃÂÃÂ¤t, den GroÃÂÃÂteil seiner Konstellation mit 3.236 Satelliten bereitzustellen. Es ist die grÃÂÃÂ¶ÃÂÃÂte kommerzielle Beschaffung von TrÃÂÃÂ¤gerraketen in der Geschichte. ÃÂÃÂProject Kuiper wird Millionen von Kunden in unversorgten und unterversorgten Gemeinden auf der ganzen Welt schnelles, erschwingliches Breitband zur VerfÃÂÃÂ¼gung stellenÃÂÃÂ, sagte Dave Limp, Senior Vice President fÃÂÃÂ¼r Amazon Devices & Services. ÃÂÃÂWir haben noch viel Arbeit vor uns, aber das Team hat weiterhin einen Meilenstein nach dem anderen in allen Aspekten unseres Satellitensystems erreicht. Diese Startvereinbarungen spiegeln unser unglaubliches Engagement und unseren Glauben an das Projekt Kuiper wider, und wir sind stolz darauf, mit einer so beeindruckenden Reihe von Partnern zusammenzuarbeiten, um unsere Mission zu erfÃÂÃÂ¼llen.ÃÂÃÂ Project Kuiper zielt darauf ab, Hochgeschwindigkeits-Breitband mit geringer Latenz fÃÂÃÂ¼r eine breite Palette von Kunden bereitzustellen, darunter einzelne Haushalte, Schulen, KrankenhÃÂÃÂ¤user, Unternehmen, RegierungsbehÃÂÃÂ¶rden, Katastrophenhilfe, Mobilfunkbetreiber und andere Organisationen, die an Orten ohne zuverlÃÂÃÂ¤ssige Internetverbindung arbeiten. Amazon entwirft und entwickelt das gesamte System intern und kombiniert eine Konstellation fortschrittlicher LEO-Satelliten mit kleinen, erschwinglichen Kundenterminals und einem sicheren, robusten bodengestÃÂÃÂ¼tzten Kommunikationsnetz. Project Kuiper wird die globale Logistik- und BetriebsprÃÂÃÂ¤senz von Amazon sowie das Netzwerk und die Infrastruktur von Amazon Web Services (AWS) nutzen, um einen vielfÃÂÃÂ¤ltigen, globalen Kundenstamm zu bedienen. Project Kuiper wird auch die Erfahrung von Amazon bei der Herstellung kostengÃÂÃÂ¼nstiger GerÃÂÃÂ¤te und Dienste wie Echo und Kindle nutzen, um den Kunden einen Service zu einem erschwinglichen, zugÃÂÃÂ¤nglichen Preis anzubieten. ÃÂÃÂDie Sicherung der StartkapazitÃÂÃÂ¤t von mehreren Anbietern war vom ersten Tag an ein wichtiger Bestandteil unserer StrategieÃÂÃÂ, sagte Rajeev Badyal, Vice President of Technology fÃÂÃÂ¼r Project Kuiper bei Amazon. ÃÂÃÂDieser Ansatz reduziert das Risiko im Zusammenhang mit dem Stillstand von TrÃÂÃÂ¤gerraketen und unterstÃÂÃÂ¼tzt eine wettbewerbsfÃÂÃÂ¤hige langfristige Preisgestaltung fÃÂÃÂ¼r Amazon, was zu Kosteneinsparungen fÃÂÃÂ¼hrt, die wir an unsere Kunden weitergeben kÃÂÃÂ¶nnen. Diese groÃÂÃÂen Schwerlastraketen bedeuten auch, dass wir mehr unserer Konstellation mit weniger Starts einsetzen kÃÂÃÂ¶nnen, was dazu beitrÃÂÃÂ¤gt, unseren Start- und Einsatzplan zu vereinfachen. Wir freuen uns, der Vernetzung von Privat-, GeschÃÂÃÂ¤fts- und Regierungskunden auf der ganzen Welt einen Schritt nÃÂÃÂ¤her zu kommen.ÃÂÃÂ Der Umfang dieser VertrÃÂÃÂ¤ge wird auch die breitere Branche der Startdienste ankurbeln und Innovationen und die Schaffung von ArbeitsplÃÂÃÂ¤tzen in den Vereinigten Staaten und Europa vorantreiben. Lieferanten aus 49 US-Bundesstaaten helfen bei der Entwicklung und Herstellung der Schwerlast-TrÃÂÃÂ¤gerraketen der nÃÂÃÂ¤chsten Generation von Blue Origin und ULA, wÃÂÃÂ¤hrend Arianespace sich bei der Produktion seiner Ariane-6-Rakete auf das Lieferantennetzwerk der ArianeGroup aus 13 europÃÂÃÂ¤ischen LÃÂÃÂ¤ndern verlÃÂÃÂ¤sst. DarÃÂÃÂ¼ber hinaus arbeitet Amazon mit Beyond Gravity (ehemals RUAG Space), einem in der Schweiz ansÃÂÃÂ¤ssigen Anbieter von Weltraumtechnologie, zusammen, um kostengÃÂÃÂ¼nstige, skalierbare Satellitendispenser zu bauen, die den Einsatz der Project Kuiper-Konstellation unterstÃÂÃÂ¼tzen werden. Beyond Gravity erÃÂÃÂ¶ffnet als Ergebnis der Partnerschaft eine vÃÂÃÂ¶llig neue ProduktionsstÃÂÃÂ¤tte, verdoppelt seine ProduktionskapazitÃÂÃÂ¤t und schafft Dutzende von ArbeitsplÃÂÃÂ¤tzen in LinkÃÂÃÂ¶ping, Schweden. Arianespace Arianespace, die europÃÂÃÂ¤ische Raumfahrtgesellschaft, hat sich als fÃÂÃÂ¼hrendes Unternehmen in der globalen Startdienstbranche etabliert und im vergangenen Jahr 15 erfolgreiche Starts durchgefÃÂÃÂ¼hrt, darunter den Start des James-Webb-Weltraumteleskops Ende Dezember. Arianespace ist auf dem Weg, seine Schwerlast-TrÃÂÃÂ¤gerrakete der nÃÂÃÂ¤chsten Generation, die Ariane 6, in Betrieb zu nehmen, die bis Ende dieses Jahres zum ersten Mal starten soll. Amazon hat sich im Rahmen dieser ersten Vereinbarung 18 Ariane-6-Raketen gesichert. ÃÂÃÂDieser Vertrag, der grÃÂÃÂ¶ÃÂÃÂte, den wir je unterzeichnet haben, ist ein groÃÂÃÂer Moment in der Geschichte von Arianespace. Wir fÃÂÃÂ¼hlen uns geehrt, eine bedeutende Rolle bei der EinfÃÂÃÂ¼hrung von Amazons Project Kuiper zu spielen, das darauf abzielt, zig Millionen Menschen mit dem Internet zu verbindenÃÂÃÂ, sagte StÃÂÃÂ©phane IsraÃÂÃÂ«l, CEO von Arianespace. ÃÂÃÂEs wird auf dem europÃÂÃÂ¤ischen Innovationsgeist, der industriellen StÃÂÃÂ¤rke und der jahrelangen Erfahrung aufbauen und ist ein groÃÂÃÂer Gewinn fÃÂÃÂ¼r die europÃÂÃÂ¤ische TrÃÂÃÂ¤gerraketenindustrie. Dass Amazon sich fÃÂÃÂ¼r die Ariane 6 entschieden hat, erfÃÂÃÂ¼llt uns mit groÃÂÃÂem Stolz und ist ein groÃÂÃÂer Vertrauensbeweis fÃÂÃÂ¼r unsere neue TrÃÂÃÂ¤gerrakete.ÃÂÃÂ Blue Origin Amazon hat eine Vereinbarung mit Blue Origin unterzeichnet, um 12 Starts mit New Glenn zu sichern, mit Optionen fÃÂÃÂ¼r bis zu 15 zusÃÂÃÂ¤tzliche Starts. New Glenn wird von sieben BE-4-Triebwerken angetrieben und seine wiederverwendbare erste Stufe ist fÃÂÃÂ¼r mindestens 25 Missionen ausgelegt. ÃÂÃÂWir fÃÂÃÂ¼hlen uns geehrt, die ehrgeizige Mission von Amazon zu unterstÃÂÃÂ¼tzen, unversorgte und unterversorgte Gemeinden auf der ganzen Welt durch New Glenn und unsere BE-4-Engines mit zuverlÃÂÃÂ¤ssigem, erschwinglichem Breitband zu versorgenÃÂÃÂ, sagte Jarrett Jones, Senior Vice President, New Glenn, Blue Origin. ÃÂÃÂDie sieben Meter lange Verkleidung von New Glenn bietet beispiellose Massen- und VolumenfÃÂÃÂ¤higkeiten und bietet Project Kuiper maximale StartflexibilitÃÂÃÂ¤t. Wir gratulieren auch unserem Partner United Launch Alliance. Wir sind stolz darauf, Motoren aus amerikanischer Produktion fÃÂÃÂ¼r den Vulcan Centaur von ULA zu bauen.ÃÂÃÂ United Launch Alliance Die Vereinbarung von Amazon mit ULA umfasst 38 Starts mit Vulcan Centaur, der neuesten Schwerlast-TrÃÂÃÂ¤gerrakete von ULA. Dieser Startdienstleistungsvertrag umfasst auch die Produktions- und Startinfrastruktur zur UnterstÃÂÃÂ¼tzung einer hÃÂÃÂ¶heren Kadenz von Starts auf der Cape Canaveral Space Force Station, einschlieÃÂÃÂlich einer neuen, dedizierten Version der Vulcan Launch Platform (VLP). ULA tÃÂÃÂ¤tigt zusÃÂÃÂ¤tzliche Investitionen in sein Spaceflight Processing & Operations Center (SPOC), um eine zweite ULA-Einrichtung bereitzustellen, die zur vollstÃÂÃÂ¤ndigen Fahrzeugverarbeitung in der Lage ist, und verwandelt den Startplatz in zwei parallele ÃÂÃÂStartspurenÃÂÃÂ fÃÂÃÂ¼r Operationen mit hoher Kadenz. Die Vereinbarung ergÃÂÃÂ¤nzt den bestehenden Vertrag von Project Kuiper zur Sicherung von neun Atlas-V-Fahrzeugen von ULA. ÃÂÃÂDiese Vereinbarung markiert den Beginn einer aufregenden neuen ÃÂÃÂra fÃÂÃÂ¼r ULA und fÃÂÃÂ¼r die gesamte US-TrÃÂÃÂ¤gerraketenindustrie. Mit insgesamt 47 Starts zwischen unseren Atlas- und Vulcan-Fahrzeugen sind wir stolz darauf, den GroÃÂÃÂteil dieser wichtigen Konstellation zu startenÃÂÃÂ, sagte Tory Bruno, President und CEO von ULA. ÃÂÃÂDies wird Hunderte von ArbeitsplÃÂÃÂ¤tzen unterstÃÂÃÂ¼tzen, insbesondere an Orten wie Alabama, Colorado und Florida, und die Investitionen von Amazon in die Startinfrastruktur und die Upgrades von FÃÂÃÂ¤higkeiten werden sowohl gewerblichen als auch staatlichen Kunden zugutekommen.ÃÂÃÂ Das Projekt Kuiper plant, noch in diesem Jahr zwei Prototyp-Missionen mit der RS1-Rakete von ABL Space Systems zu starten. Mittlerweile arbeiten mehr als 1.000 Mitarbeiter bei Amazon an Project Kuiper. Und das Team macht weitere Fortschritte, wÃÂÃÂ¤hrend es sich einer vollstÃÂÃÂ¤ndigen, produktionsbereiten Bereitstellung nÃÂÃÂ¤hert ÃÂÃÂ die Fertigstellung seines Hochleistungssatellitendesigns, die Herstellung eines kompakten, erschwinglichen Kundenterminals und die Bereitstellung eines sicheren, zuverlÃÂÃÂ¤ssigen Kommunikationsnetzwerks, das Satelliten mit Kunden und Infrastruktur am Boden verbindet. Nach der Bereitstellung wird das Kuiper-System in der Lage sein, zig Millionen Privat-, GeschÃÂÃÂ¤fts- und Regierungskunden an Orten ohne zuverlÃÂÃÂ¤ssiges Breitband zu versorgen. In Zukunft wird Amazon weiterhin mit Unternehmen zusammenarbeiten, die sein Engagement teilen, die globale digitale Kluft zu schlieÃÂÃÂen und neue MÃÂÃÂ¶glichkeiten fÃÂÃÂ¼r Innovation zu schaffen. Um mehr ÃÂÃÂ¼ber Project Kuiper zu erfahren, sehen Sie sich unser ÃÂÃÂbersichtsvideo an. ÃÂÃÂber Amazon Amazon orientiert sich an vier GrundsÃÂÃÂ¤tzen: Orientierung am Kunden statt an der Konkurrenz, Leidenschaft fÃÂÃÂ¼r Neuerungen, Einsatz fÃÂÃÂ¼r betriebliche Optimierung sowie langfristiges Denken. Amazon strebt danach, das kundenorientierteste Unternehmen der Welt, der beste Arbeitgeber der Welt und der sicherste Arbeitsplatz der Welt zu sein. Kundenrezensionen, 1-Klick-EinkÃÂÃÂ¤ufe, personalisierte Empfehlungen, Prime, Versand durch Amazon, AWS, Kindle Direct Publishing, Kindle, Career Choice, Fire-Tablets, Fire TV, Amazon Echo, Alexa, ÃÂÃÂJust Walk OutÃÂÃÂ-Technologie, Amazon Studios und The Climate Pledge sind einige der Pionierleistungen von Amazon. FÃÂÃÂ¼r weitere Informationen besuchen Sie amazon.com/about und folgen Sie @AmazonNews. Zukunftsgerichtete Aussagen Diese Pressemitteilung enthÃÂÃÂ¤lt zukunftsgerichtete Aussagen im Sinne des Private Securities Litigation Reform Act von 1995. Alle Aussagen in dieser Pressemitteilung, mit Ausnahme von Aussagen ÃÂÃÂ¼ber historische Tatsachen, einschlieÃÂÃÂlich Aussagen zu erwarteten GeschÃÂÃÂ¤ftsaktivitÃÂÃÂ¤ten, sind zukunftsgerichtet. Wir verwenden WÃÂÃÂ¶rter wie zielen, antizipieren, glauben, erwarten, Zukunft, beabsichtigen, werden und ÃÂÃÂ¤hnliche AusdrÃÂÃÂ¼cke, um zukunftsgerichtete Aussagen zu kennzeichnen. Zukunftsgerichtete Aussagen spiegeln die aktuellen Erwartungen des Managements wider und sind von Natur aus ungewiss. Die tatsÃÂÃÂ¤chlichen Ergebnisse kÃÂÃÂ¶nnen aus einer Vielzahl von GrÃÂÃÂ¼nden erheblich abweichen, darunter unter anderem ÃÂÃÂnderungen unserer LiquiditÃÂÃÂ¤t, unserer Finanzlage oder unserer Kapitalallokations- und Finanzierungsstrategien oder der Fremd- und AktienmÃÂÃÂ¤rkte, einschlieÃÂÃÂlich infolge von Wechselkursschwankungen, ÃÂÃÂnderungen der globalen Wirtschaftsbedingungen und Kundenausgaben, Weltereignisse, die Wachstumsrate des Internets, des Online-Handels und der Cloud-Dienste, der Betrag, den Amazon.com in neue GeschÃÂÃÂ¤ftsmÃÂÃÂ¶glichkeiten investiert, und der Zeitpunkt dieser Investitionen, der Produktmix und an Kunden verkaufte Dienstleistungen, die Mischung aus NettoumsÃÂÃÂ¤tzen aus Produkten im Vergleich zu Dienstleistungen, das AusmaÃÂÃÂ, in dem wir Einkommens- oder andere Steuern schulden, Wettbewerb, Wachstumsmanagement, potenzielle Schwankungen der Betriebsergebnisse, internationales Wachstum und Expansion, die Ergebnisse von AnsprÃÂÃÂ¼che, Rechtsstreitigkeiten, behÃÂÃÂ¶rdliche Ermittlungen und andere Verfahren, ErfÃÂÃÂ¼llung, Sortierung, Lieferung und Rechenzentrumsoptimierung, Erfindungsrisiken Auftragsmanagement, Nachfrageschwankungen, das AusmaÃÂÃÂ, in dem wir Handelsvereinbarungen eingehen, aufrechterhalten und weiterentwickeln, geplante und abgeschlossene Akquisitionen und strategische Transaktionen, Zahlungsrisiken und Risiken des ErfÃÂÃÂ¼llungsdurchsatzes und der ProduktivitÃÂÃÂ¤t. DarÃÂÃÂ¼ber hinaus verstÃÂÃÂ¤rken das globale Wirtschaftsklima und zusÃÂÃÂ¤tzliche oder unvorhergesehene Auswirkungen der globalen Pandemie viele dieser Risiken. Diese Risiken und Ungewissheiten sowie andere Risiken und Ungewissheiten, die dazu fÃÂÃÂ¼hren kÃÂÃÂ¶nnten, dass unsere tatsÃÂÃÂ¤chlichen Ergebnisse erheblich von den Erwartungen des Managements abweichen, werden in den von Amazon.com bei der Securities and Exchange Commission (ÃÂÃÂSECÃÂÃÂ) eingereichten Unterlagen, einschlieÃÂÃÂlich des jÃÂÃÂ¼ngsten Jahresberichts auf Formular 10-K und spÃÂÃÂ¤teren Einreichungen, ausfÃÂÃÂ¼hrlicher beschrieben. Obwohl wir uns nicht verpflichten, zukunftsgerichtete Aussagen zu ÃÂÃÂ¼berarbeiten oder zu aktualisieren, sei es aufgrund neuer Informationen, zukÃÂÃÂ¼nftiger Ereignisse oder aus anderen GrÃÂÃÂ¼nden, es sei denn, dies ist gesetzlich vorgeschrieben, empfehlen wir Ihnen, alle zusÃÂÃÂ¤tzlichen Offenlegungen zu konsultieren, die wir in unseren bei der SEC eingereichten Jahresberichten auf Formular 10-K, Quartalsberichten auf Formular 10-Q und aktuellen Berichten auf Formular 8-K machen. Die Ausgangssprache, in der der Originaltext verÃÂÃÂ¶ffentlicht wird, ist die offizielle und autorisierte Version. ÃÂÃÂbersetzungen werden zur besseren VerstÃÂÃÂ¤ndigung mitgeliefert. Nur die Sprachversion, die im Original verÃÂÃÂ¶ffentlicht wurde, ist rechtsgÃÂÃÂ¼ltig. Gleichen Sie deshalb ÃÂÃÂbersetzungen mit der originalen Sprachversion der VerÃÂÃÂ¶ffentlichung ab.",https://www.businesswire.com/news/home/20220405005520/de/,businesswire.com,5,seattlebusiness wireamazon nasdaq amzn gab heute vereinbarungen mit arianespace blue origin und united launch alliance ula bekannt um schwerlaststartdienste fr project kuiper bereitzustellen amazon initiative zur verbesserung de globalen breitbandzugangs mithilfe einer konstellation von satelliten im erdnahen orbit leo die vertrge belaufen sich auf bi zu start ber einen zeitraum von fnf jahren und bieten amazon die kapazitt den groteil seiner konstellation mit satelliten bereitzustellen e ist die grte kommerzielle beschaffung von trgerraketen der geschichte project kuiper wird millionen von kunden unversorgten und unterversorgten gemeinden auf der ganzen welt schnelles erschwingliches breitband zur verfgung stellen sagte dave limp senior vice president fr amazon device service wir haben noch viel arbeit vor un aber da team hat weiterhin einen meilenstein nach dem anderen allen aspekten unseres satellitensystems erreicht diese startvereinbarungen spiegeln unser unglaubliches engagement und unseren glauben da projekt kuiper wider und wir sind stolz darauf mit einer beeindruckenden reihe von partnern zusammenzuarbeiten um unsere mission zu erfllen project kuiper zielt darauf ab hochgeschwindigkeitsbreitband mit geringer latenz fr eine breite palette von kunden bereitzustellen darunter einzelne haushalte schulen krankenhuser unternehmen regierungsbehrden katastrophenhilfe mobilfunkbetreiber und andere organisationen die orten ohne zuverlssige internetverbindung arbeiten amazon entwirft und entwickelt da gesamte system intern und kombiniert eine konstellation fortschrittlicher leosatelliten mit kleinen erschwinglichen kundenterminals und einem sicheren robusten bodengesttzten kommunikationsnetz project kuiper wird die globale logistik und betriebsprsenz von amazon sowie da netzwerk und die infrastruktur von amazon web service aws nutzen um einen vielfltigen globalen kundenstamm zu bedienen project kuiper wird auch die erfahrung von amazon bei der herstellung kostengnstiger gerte und dienste wie echo und kindle nutzen um den kunden einen service zu einem erschwinglichen zugnglichen preis anzubieten die sicherung der startkapazitt von mehreren anbietern war vom ersten tag ein wichtiger bestandteil unserer strategie sagte rajeev badyal vice president technology fr project kuiper bei amazon dieser ansatz reduziert da risiko im zusammenhang mit dem stillstand von trgerraketen und untersttzt eine wettbewerbsfhige langfristige preisgestaltung fr amazon zu kosteneinsparungen fhrt die wir unsere kunden weitergeben knnen diese groen schwerlastraketen bedeuten auch das wir mehr unserer konstellation mit weniger start einsetzen knnen dazu beitrgt unseren start und einsatzplan zu vereinfachen wir freuen un der vernetzung von privat geschfts und regierungskunden auf der ganzen welt einen schritt nher zu kommen der umfang dieser vertrge wird auch die breitere branche der startdienste ankurbeln und innovationen und die schaffung von arbeitspltzen den vereinigten staaten und europa vorantreiben lieferanten au usbundesstaaten helfen bei der entwicklung und herstellung der schwerlasttrgerraketen der nchsten generation von blue origin und ula whrend arianespace sich bei der produktion seiner arianerakete auf da lieferantennetzwerk der arianegroup au europischen lndern verlsst darber hinaus arbeitet amazon mit beyond gravity ehemals ruag space einem der schweiz ansssigen anbieter von weltraumtechnologie zusammen um kostengnstige skalierbare satellitendispenser zu bauen die den einsatz der project kuiperkonstellation untersttzen werden beyond gravity erffnet al ergebnis der partnerschaft eine vllig neue produktionssttte verdoppelt seine produktionskapazitt und schafft dutzende von arbeitspltzen linkping schweden arianespace arianespace die europische raumfahrtgesellschaft hat sich al fhrendes unternehmen der globalen startdienstbranche etabliert und im vergangenen jahr erfolgreiche start durchgefhrt darunter den start de jameswebbweltraumteleskops ende dezember arianespace ist auf dem weg seine schwerlasttrgerrakete der nchsten generation die ariane betrieb zu nehmen die bi ende diesis jahres zum ersten mal starten soll amazon hat sich im rahmen dieser ersten vereinbarung arianeraketen gesichert dieser vertrag der grte den wir je unterzeichnet haben ist ein groer moment der geschichte von arianespace wir fhlen un geehrt eine bedeutende rolle bei der einfhrung von amazon project kuiper zu spielen da darauf abzielt zig millionen menschen mit dem internet zu verbinden sagte stphane isral ceo von arianespace e wird auf dem europischen innovationsgeist der industriellen strke und der jahrelangen erfahrung aufbauen und ist ein groer gewinn fr die europische trgerraketenindustrie das amazon sich fr die ariane entschieden hat erfllt un mit groem stolz und ist ein groer vertrauensbeweis fr unsere neue trgerrakete blue origin amazon hat eine vereinbarung mit blue origin unterzeichnet um start mit new glenn zu sichern mit optionen fr bi zu zustzliche start new glenn wird von sieben betriebwerken angetrieben und seine wiederverwendbare erste stufe ist fr mindestens missionen ausgelegt wir fhlen un geehrt die ehrgeizige mission von amazon zu untersttzen unversorgte und unterversorgte gemeinden auf der ganzen welt durch new glenn und unsere beengines mit zuverlssigem erschwinglichem breitband zu versorgen sagte jarrett jones senior vice president new glenn blue origin die sieben meter lange verkleidung von new glenn bietet beispiellose massen und volumenfhigkeiten und bietet project kuiper maximale startflexibilitt wir gratulieren auch unserem partner united launch alliance wir sind stolz darauf motoren au amerikanischer produktion fr den vulcan centaur von ula zu bauen united launch alliance die vereinbarung von amazon mit ula umfasst start mit vulcan centaur der neuesten schwerlasttrgerrakete von ula dieser startdienstleistungsvertrag umfasst auch die produktions und startinfrastruktur zur untersttzung einer hheren kadenz von start auf der cape canaveral space force station einschlielich einer neuen dedizierten version der vulcan launch platform vlp ula ttigt zustzliche investitionen sein spaceflight processing operation center spoc um eine zweite ulaeinrichtung bereitzustellen die zur vollstndigen fahrzeugverarbeitung der lage ist und verwandelt den startplatz zwei parallele startspuren fr operationen mit hoher kadenz die vereinbarung ergnzt den bestehenden vertrag von project kuiper zur sicherung von neun atlasvfahrzeugen von ula diese vereinbarung markiert den beginn einer aufregenden neuen ra fr ula und fr die gesamte ustrgerraketenindustrie mit insgesamt start zwischen unseren atlas und vulcanfahrzeugen sind wir stolz darauf den groteil dieser wichtigen konstellation zu starten sagte tory bruno president und ceo von ula dy wird hunderte von arbeitspltzen untersttzen insbesondere orten wie alabama colorado und florida und die investitionen von amazon die startinfrastruktur und die upgrade von fhigkeiten werden sowohl gewerblichen al auch staatlichen kunden zugutekommen da projekt kuiper plant noch diesem jahr zwei prototypmissionen mit der rsrakete von abl space system zu starten mittlerweile arbeiten mehr al mitarbeiter bei amazon project kuiper und da team macht weitere fortschritte whrend e sich einer vollstndigen produktionsbereiten bereitstellung nhert die fertigstellung seine hochleistungssatellitendesigns die herstellung eines kompakten erschwinglichen kundenterminals und die bereitstellung eines sicheren zuverlssigen kommunikationsnetzwerks da satelliten mit kunden und infrastruktur boden verbindet nach der bereitstellung wird da kuipersystem der lage sein zig millionen privat geschfts und regierungskunden orten ohne zuverlssiges breitband zu versorgen zukunft wird amazon weiterhin mit unternehmen zusammenarbeiten die sein engagement teilen die globale digitale kluft zu schlieen und neue mglichkeiten fr innovation zu schaffen um mehr ber project kuiper zu erfahren sehen sie sich unser bersichtsvideo ber amazon amazon orientiert sich vier grundstzen orientierung kunden statt der konkurrenz leidenschaft fr neuerungen einsatz fr betriebliche optimierung sowie langfristiges denken amazon strebt danach da kundenorientierteste unternehmen der welt der beste arbeitgeber der welt und der sicherste arbeitsplatz der welt zu sein kundenrezensionen klickeinkufe personalisierte empfehlungen prime versand durch amazon aws kindle direct publishing kindle career choice firetablets fire tv amazon echo alexa walk outtechnologie amazon studio und climate pledge sind einige der pionierleistungen von amazon fr weitere informationen besuchen sie amazoncomabout und folgen sie amazonnews zukunftsgerichtete aussagen diese pressemitteilung enthlt zukunftsgerichtete aussagen im sinne de private security litigation reform act von alle aussagen dieser pressemitteilung mit ausnahme von aussagen ber historische tatsachen einschlielich aussagen zu erwarteten geschftsaktivitten sind zukunftsgerichtet wir verwenden wrter wie zielen antizipieren glauben erwarten zukunft beabsichtigen werden und hnliche ausdrcke um zukunftsgerichtete aussagen zu kennzeichnen zukunftsgerichtete aussagen spiegeln die aktuellen erwartungen de management wider und sind von natur au ungewiss die tatschlichen ergebnisse knnen au einer vielzahl von grnden erheblich abweichen darunter unter anderem nderungen unserer liquiditt unserer finanzlage oder unserer kapitalallokations und finanzierungsstrategien oder der fremd und aktienmrkte einschlielich infolge von wechselkursschwankungen nderungen der globalen wirtschaftsbedingungen und kundenausgaben weltereignisse die wachstumsrate de internet de onlinehandels und der clouddienste der betrag den amazoncom neue geschftsmglichkeiten investiert und der zeitpunkt dieser investitionen der produktmix und kunden verkaufte dienstleistungen die mischung au nettoumstzen au produkten im vergleich zu dienstleistungen da ausma dem wir einkommens oder andere steuern schulden wettbewerb wachstumsmanagement potenzielle schwankungen der betriebsergebnisse internationale wachstum und expansion die ergebnisse von ansprche rechtsstreitigkeiten behrdliche ermittlungen und andere verfahren erfllung sortierung lieferung und rechenzentrumsoptimierung erfindungsrisiken auftragsmanagement nachfrageschwankungen da ausma dem wir handelsvereinbarungen eingehen aufrechterhalten und weiterentwickeln geplante und abgeschlossene akquisitionen und strategische transaktionen zahlungsrisiken und risiken de erfllungsdurchsatzes und der produktivitt darber hinaus verstrken da globale wirtschaftsklima und zustzliche oder unvorhergesehene auswirkungen der globalen pandemie viele dieser risiken diese risiken und ungewissheiten sowie andere risiken und ungewissheiten die dazu fhren knnten das unsere tatschlichen ergebnisse erheblich von den erwartungen de management abweichen werden den von amazoncom bei der security exchange commission sec eingereichten unterlagen einschlielich de jngsten jahresberichts auf formular k und spteren einreichungen ausfhrlicher beschrieben obwohl wir un nicht verpflichten zukunftsgerichtete aussagen zu berarbeiten oder zu aktualisieren sei e aufgrund neuer informationen zuknftiger ereignisse oder au anderen grnden e sei denn dy ist gesetzlich vorgeschrieben empfehlen wir ihnen alle zustzlichen offenlegungen zu konsultieren die wir unseren bei der sec eingereichten jahresberichten auf formular k quartalsberichten auf formular q und aktuellen berichten auf formular k machen die ausgangssprache der der originaltext verffentlicht wird ist die offizielle und autorisierte version bersetzungen werden zur besseren verstndigung mitgeliefert nur die sprachversion die im original verffentlicht wurde ist rechtsgltig gleichen sie deshalb bersetzungen mit der originalen sprachversion der verffentlichung ab,-0.9992,-0.4996,0.2529141176,-0.752514118,Negative Impact
06/04/2022,161.6505,162.20,157.25,158.76,158.76,79056000,-0.27,-314.4290963,1.192,0,14.33339876,0.959429757,-0.018638346,0.33,289.109,13888.82031,16587.09961,7587.700195,6498.830078,3283.429932,59610.41016,21788.59961,153.94245,166.3097701,157.8700049,161.7590405,159.6844002,176.3384482,143.0303522,52.08981641,3.353671711,3.51193562,-0.158263909,4.272890363,170.3309239,10311970000,18.52161487,57.22758611,22.10000038,LinkedIn says Amazon the top U.S. company to work for if you want career growth,It's the second year in a row Amazon has held the top spot on LinkedIn's 50 best workplaces to grow your career,https://www.cnbc.com/2022/04/06/linkedin-amazon-top-us-company-to-work-for-if-you-want-career-growth.html,cnbc.com,9,second year row amazon held top spot linkedins best workplace grow career,0.7717,0.69453,0.3143174074,0.3802125926,Positive Impact
07/04/2022,158.4,160.08,154.51,157.78,157.78,68136000,-0.27,-314.4290963,1.192,0,14.33339876,0.959429757,-0.018638346,0.33,289.109,13897.2998,16631.44922,7551.799805,6461.680176,3236.699951,59034.94922,21834.90039,154.32069,166.2227377,157.8666517,161.7194929,160.2327499,175.7890052,144.6764947,44.7887492,2.716231343,3.352794764,-0.636563421,4.271783011,169.807867,10243834000,20.05512614,34.10742179,21.54999924,"Amazon verzekert zich van 83 lanceringen van Arianespace, Blue Origin en United Launch Alliance voor Project Kuiper","SEATTLE--(BUSINESS WIRE)--Amazon (NASDAQ: AMZN) heeft vandaag overeenkomsten bekendgemaakt met Arianespace, Blue Origin en United Launch Alliance (ULA) om Project Kuiper, het initiatief van Amazon om de wereldwijde toegang tot breedband uit te breiden met gebruikmaking van een constellatie van satellieten in de lage omloopbaan rond de aarde (low Earth orbit, LEO). Er zijn in totaal contracten voor 83 lanceringen gedurende een periode van vijf jaar, waarmee aan Amazon capaciteit wordt geboden om het merendeel van haar constellatie van 3236 satellieten in te zetten. Het is de grootste aankoop van draagraketten in de geschiedenis. ÃÂÃÂProject Kuiper zal snel betaalbare breedband bieden voor tientallen miljoenen klanten in nog niet bediende en onderbediende gemeenschappen over de hele wereld,ÃÂÃÂ zei Dave Limp, Senior Vice President voor Amazon Devices & Services. ÃÂÃÂWe hebben nog heel veel werk te doen, maar het team heeft mijlpaal na mijlpaal geslagen in ieder aspect van ons satellietsysteem. Deze lanceringsovereenkomsten weerspiegelen onze ongelooflijke inzet voor en geloof in Project Kuiper en we zijn er trots op om met zo'n indrukwekkende lijst van partners te werken om aan onze missie te voldoen.ÃÂÃÂ Project Kuiper heeft als doel hogesnelheidsbreedband met lage vertraging te bieden aan een breed scala van klanten, waaronder individuele huishoudens, scholen, ziekenhuizen, bedrijven, overheidsagentschappen, rampbestrijdingsactiviteiten, mobiele operators en andere organisaties die werken op plaatsen zonder betrouwbare internetconnectiviteit. Amazon ontwerpt en ontwikkelt het gehele systeem intern, waarbij zij een constellatie van geavanceerde LEO-satellieten combineren met kleine, betaalbare klantterminals en een veilig, veerkrachtig communicatienetwerk op de grond. Project Kuiper zal Amazons mondiale logistiek en activiteitenvoetafdruk, alsmede Amazon Web ServicesÃÂÃÂ (AWS)-networking en infrastructuur op een hoger plan brengen om een divers, mondiaal klantenbestand van dienst te zijn. Project Kuiper maakt ook gebruik van de ervaring van Amazon voor het produceren van voordelige apparaten en diensten als Echo en Kindle om service te verlenen tegen een voor klanten betaalbare, toegankelijke prijs. ÃÂÃÂHet zorgen voor lanceringscapaciteit van meerdere providers is vanaf dag ÃÂÃÂ©ÃÂÃÂ©n een cruciaal onderdeel van onze strategie,ÃÂÃÂ aldus Rajeev Badyal, Vice President van Technology voor Project Kuiper bij Amazon. ÃÂÃÂDeze benadering verlaagt het risico dat samenhangt met het terugtrekken van draagraketten en ondersteunt concurrerende prijsbepaling voor de lange termijn voor Amazon, waardoor kosten worden bespaard die we kunnen doorgeven aan onze klanten. Deze grote raketten voor zware lading betekenen ook dat we meer van onze constellatie kunnen inzetten met minder lanceringen, wat helpt ons lancerings- en inzetschema te vereenvoudigen. We zijn enthousiast ÃÂÃÂ©ÃÂÃÂ©n stap dichterbij te komen bij het verbinden van particulieren, bedrijfs- en overheidsklanten over de gehele wereld.ÃÂÃÂ De schaal van deze contracten zal ook de bredere lanceringsindustrie een boost geven, waarmee innovatie en het creÃÂÃÂ«ren van banen in de Verenigde Staten en Europa worden gestimuleerd. Leveranciers van 49 Amerikaanse staten helpen de volgende-generatie draagraketten voor zware lading van Blue Origin en ULA ontwikkelen en produceren, terwijl Arianespace vertrouwt op het netwerk van leveranciers van ArianeGroup vanuit 13 Europese landen om hun Ariane 6-raket te produceren. Daarnaast werkt Amazon met Beyond Gravity (voorheen RUAG Space), een ruimtetechnologieprovider met hoofdkantoor in Zwitserland voor het bouwen van voordelige, schaalbare satellietdistributeurs die helpen bij het inzetten van de constellatie voor het Project Kuiper. Beyond Gravity opent een geheel nieuwe productiefaciliteit als resultaat van het partnerschap, waarmee haar productiecapaciteit wordt verdubbeld en tientalen banen worden gecreÃÂÃÂ«erd in LinkÃÂÃÂ¶ping, Zweden. Arianespace Arianespace, de Europese ruimtelijn, heeft zichzelf gevestigd als leider in de mondiale lanceringsdienstenindustrie door vorig jaar 15 lanceringen met succes te voltooien, waaronder de lancering van de James Webb-ruimtetelescoop afgelopen december. Arianespace is op weg met het starten van de activiteiten voor haar draagraket voor zware hefcapaciteit van de volgende generatie, Ariane 6, welke voor de eerste keer is gepland tegen het einde van dit jaar. Amazon heeft zich verzekerd van 18 Ariane 6-raketten als onderdeel van deze eerste overeenkomst. ÃÂÃÂDit contract, het grootste dat ooit is afgesloten, is een geweldig moment in de geschiedenis van Arianespace. We zijn zeer vereerd dat we een belangrijke rol hebben gekregen bij de inzet van Amazons Project Kuiper, dat erop is gericht tientallen miljoenen mensen te verbinden met het internet,ÃÂÃÂ aldus StÃÂÃÂ©phane IsraÃÂÃÂ«l, CEO van Arianespace. ÃÂÃÂHet zal voortbouwen op de Europese innovatieve spirit, industriÃÂÃÂ«le sterkte en jaren ervaring, en het is een zeer belangrijke overwinning voor de Europese lanceringsindustrie. Dat Amazon de Ariane 6 heeft gekozen om de taak uit te voeren is een aangelegenheid die ons met enorme trots vervult en een geweldige blijk van vertrouwen in onze nieuwe draagraket.ÃÂÃÂ Blue Origin Amazon heeft een overeenkomst getekend met Blue Origin om 12 lanceringen zeker te stellen met gebruikmaking van New Glenn, met opties voor tot 15 extra lanceringen. New Glenn wordt van energie voorzien door zeven BE-4-machines en haar herbruikbare eerste platform is gebouwd voor minimaal 25 missies. ÃÂÃÂHet is voor ons een eer om Amazons ambitieuze missie voor het bieden van betrouwbare, betaalbare breedband aan nog niet bediende en onderbediende gemeenschappen overal in de wereld via New Glenn en onze BE-4-machines te ondersteunen,ÃÂÃÂ aldus Jarrett Jones, Senior Vice President, New Glenn, Blue Origin. ÃÂÃÂNew Glenn's zeven meter lange stroomlijnkap biedt niet eerder vertoonde massa- en volumemogelijkheden, waarmee Project Kuiper maximale lanceringsflexibiliteit wordt geboden. We feliciteren ook onze partner, United Launch Alliance. We zijn er trots op in Amerika vervaardigde machines te bouwen voor ULAÃÂÃÂs Vulcan Centaur.ÃÂÃÂ United Launch Alliance Amazons overeenkomst met ULA omvat 38 lanceringen op Vulcan Centaur, ULAÃÂÃÂs nieuwste draagraket voor zware lading. Dit lanceringsservicescontract omvat ook productie en infrastructuur voor de ondersteuning van een hogere stapfrequentie van lanceringen bij het Cape Canaveral ruimtestation, waaronder een nieuwe specifieke versie van het Vulcan Launch Platform (VLP). ULA investeert extra in hun Spaceflight Processing & Operations Center (SPOC) om een tweede ULA-faciliteit te leveren die in staat is tot volledige voertuigverwerking, het transformeren van de lanceringssite om twee parallelle ÃÂÃÂlanceringsbanenÃÂÃÂ te hebben voor activiteiten met een hoge stapfrequentie. De overeenkomst is een aanvulling op de bestaande deal van Project Kuiper om zich zeker te stellen van negen Atlas V-voertuigen van ULA. ÃÂÃÂDeze overeenkomst markeert de start van een opwindend nieuw tijdperk voor ULA en voor de gehele Amerikaanse lanceringsindustrie. Met totaal 47 lanceringen van onze Atlas- en Vulcan-voertuigen samen, zijn we er trots op dat we de meerderheid van deze belangrijke constellatie lanceren,ÃÂÃÂ aldus Tory Bruno, ULAÃÂÃÂs president en CEO. ÃÂÃÂHet zal zorgen voor honderden banen, met name in plaatsen als Alabama, Colorado en Florida, en Amazons investeringen in lanceringsinfrastructuur en upgrades van mogelijkheden zal een voordeel zijn voor zowel commerciÃÂÃÂ«le als overheidsklanten.ÃÂÃÂ Project Kuiper plant de lancering van twee prototypemissies later dit jaar op de RS1-raket van ABL Space Systems. Er werken bij Amazon nu meer dan 1000 mensen aan Project Kuiper, en het team blijft vorderingen maken terwijl het een volledig productieklare inzet nadertÃÂÃÂhaar zeer goed presterend satellietontwerp aan het afronden is, een betaalbare klantenterminal, en een veilig, betrouwbaar communicatiesnetwerk dat satellieten met klanten en infrastructuur op de grond verbindt. Eenmaal in gebruik zal het Kuiper-systeem een capaciteit hebben die miljoenen particuliere, zakelijke en overheidsklanten bedient in plaatsen zonder betrouwbaar breedband. Verder vooruit zal Amazon blijven samenwerken met bedrijven die haar commitment delen om de mondiale digitale scheidslijn te dichten en nieuwe kansen voor innovatie creÃÂÃÂ«ren. Bekijk onze overzichtsvideo om meer te weten te komen over Project Kuiper. Over Amazon Amazon laat zich leiden door vier principes: een obsessie voor de klant in plaats van een focus op concurrenten, een passie voor vindingrijkheid, toewijding aan operationele uitmuntendheid en langetermijndenken. Amazon streeft ernaar het meest klantgerichte bedrijf op aarde, de beste werkgever op aarde en de veiligste werkplek op aarde te zijn. Klantbeoordelingen, winkelen met ÃÂÃÂ©ÃÂÃÂ©n klik, gepersonaliseerde aanbevelingen, Prime, Fulfillment by Amazon, AWS, Kindle Direct Publishing, Kindle, Career Choice, Fire-tablets, Fire-tv, Amazon Echo, Alexa, Just Walk Out technology, Amazon Studios en de klimaatbelofte zijn enkele door Amazon geÃÂÃÂ¯ntroduceerde producten en diensten. Ga voor meer informatie naar amazon.com/about en volg @AmazonNews. Toekomstgerichte uitspraken Dit persbericht bevat op de toekomst gerichte uitspraken (forward-looking statements), volgens de betekenis van de Private Securities Litigation Reform Act van 1995. Alle uitspraken in dit persbericht, waaronder uitspraken betreffende verwachte bedrijfsactiviteiten, behalve die historische feiten betreffen, zijn op de toekomst gericht. We gebruiken woorden als richt zich op, anticipeert, is van mening, verwacht, toekomstig, van plan zijn, zullen en soortgelijke uitdrukkingen om toekomstgerichte uitspraken te identificeren. Toekomstgerichte uitspraken weerspiegelen de huidige verwachtingen van het management en zijn inherent onzeker. Actuele resultaten en uitkomsten kunnen om verschillende redenen wezenlijk verschillen, waaronder onder meer, veranderingen in onze liquiditeit, financiÃÂÃÂ«le toestand of kapitaaltoewijzing en financiÃÂÃÂ«le strategieÃÂÃÂ«n of in de schulden- en aandelenmarkt, waaronder als gevolg van fluctuaties in vreemde-valutawisselkoersen, veranderingen in mondiale economische condities en bestedingen van klanten, wereldgebeurtenissen, de mate van groei van het internet, onlinehandelsverkeer en clouddiensten, het bedrag dat Amazon.com investeert in nieuwe zakelijke kansen en de timing van die investeringen, de mix van producten en diensten die verkocht zijn aan klanten, de mix van nettoverkopen afgeleid van producten vergeleken met diensten, de omvang van verplichtingen met betrekking tot inkomsten of andere belastingen, concurrentie, groeimanagement, potentiÃÂÃÂ«le fluctuaties in bedrijfsresultaten, internationale groei en uitbreiding, de uitkomsten van claims, procesvoering, overheidsonderzoeken en andere procedures, fulfillment, sortering, leveren en datacentrumoptimalisering, risico's van voorraadbeheer, variabiliteit in vraag, de mate waarin we commerciÃÂÃÂ«le overeenkomsten aangaan, handhaven en ontwikkelen, voorgenomen en voltooide acquisities en strategische transacties, betalingsrisico's en risico's van fulfillmentsnelheid en productiviteit. Daarnaast, het mondiale economische klimaat en extra of onvoorziene effecten van de mondiale pandemie die veel van deze risico's versterken. Deze risico's en onzekerheden, alsmede andere risico's en onzekerheden die er de oorzaak van kunnen zijn dat onze actuele resultaten aanmerkelijk verschillen van de verwachtingen van het management zijn in meer detail beschreven in de deponeringen van Amazon.com bij de Securities and Exchange Commission (ÃÂÃÂSECÃÂÃÂ), waaronder haar meest recente jaarverslag op formulier 10-K en daarop volgende deponeringen. Hoewel we geen verplichting op ons nemen om toekomstgerichte uitspraken te reviseren of te updaten, of het nu gaat om het gevolg van nieuwe informatie, toekomstige gebeurtenissen of anderszins, behalve indien wettelijk vereist, raden wij u aan eventuele bekendmakingen te raadplegen die we doen in onze jaarverslagen op Formulier 10-K, kwartaalrapporten op Formulier 10-Q en actuele verslagen op Formulier 8-K die bij de SEC zijn gedeponeerd. Deze bekendmaking is officieel geldend in de originele brontaal. Vertalingen zijn slechts als leeshulp bedoeld en moeten worden vergeleken met de tekst in de brontaal, die als enige rechtsgeldig is.",https://www.businesswire.com/news/home/20220405005523/nl/,businesswire.com,5,seattlebusiness wireamazon nasdaq amzn heeft vandaag overeenkomsten bekendgemaakt met arianespace blue origin en united launch alliance ula om project kuiper het initiatief van amazon om de wereldwijde toegang tot breedband uit te breiden met gebruikmaking van een constellatie van satellieten de lage omloopbaan rond de aarde low earth orbit leo er zijn totaal contracten voor lanceringen gedurende een periode van vijf jaar waarmee aan amazon capaciteit wordt geboden om het merendeel van haar constellatie van satellieten te zetten het de grootste aankoop van draagraketten de geschiedenis project kuiper zal snel betaalbare breedband bieden voor tientallen miljoenen klanten nog niet bediende en onderbediende gemeenschappen de hele wereld zei dave limp senior vice president voor amazon device service hebben nog heel veel werk te doen maar het team heeft mijlpaal na mijlpaal geslagen ieder aspect van ons satellietsysteem deze lanceringsovereenkomsten weerspiegelen onze ongelooflijke inzet voor en geloof project kuiper en zijn er trot op om met zon indrukwekkende lijst van partner te werken om aan onze missie te voldoen project kuiper heeft al doel hogesnelheidsbreedband met lage vertraging te bieden aan een breed scala van klanten waaronder individuele huishoudens scholen ziekenhuizen bedrijven overheidsagentschappen rampbestrijdingsactiviteiten mobiele operator en andere organisaties die werken op plaatsen zonder betrouwbare internetconnectiviteit amazon ontwerpt en ontwikkelt het gehele systeem intern waarbij zij een constellatie van geavanceerde leosatellieten combineren met kleine betaalbare klantterminals en een veilig veerkrachtig communicatienetwerk op de grond project kuiper zal amazon mondiale logistiek en activiteitenvoetafdruk alsmede amazon web service awsnetworking en infrastructuur op een hoger plan brengen om een diver mondiaal klantenbestand van dienst te zijn project kuiper maakt ook gebruik van de ervaring van amazon voor het produceren van voordelige apparaten en diensten al echo en kindle om service te verlenen tegen een voor klanten betaalbare toegankelijke prijs het zorgen voor lanceringscapaciteit van meerdere provider vanaf dag n een cruciaal onderdeel van onze strategie aldus rajeev badyal vice president van technology voor project kuiper bij amazon deze benadering verlaagt het risico dat samenhangt met het terugtrekken van draagraketten en ondersteunt concurrerende prijsbepaling voor de lange termijn voor amazon waardoor kosten worden bespaard die kunnen doorgeven aan onze klanten deze grote raketten voor zware lading betekenen ook dat meer van onze constellatie kunnen inzetten met minder lanceringen wat helpt ons lancerings en inzetschema te vereenvoudigen zijn enthousiast n stap dichterbij te komen bij het verbinden van particulieren bedrijfs en overheidsklanten de gehele wereld de schaal van deze contracten zal ook de bredere lanceringsindustrie een boost geven waarmee innovatie en het creren van banen de verenigde staten en europa worden gestimuleerd leveranciers van amerikaanse staten helpen de volgendegeneratie draagraketten voor zware lading van blue origin en ula ontwikkelen en produceren terwijl arianespace vertrouwt op het netwerk van leveranciers van arianegroup vanuit europese landen om hun ariane raket te produceren daarnaast werkt amazon met beyond gravity voorheen ruag space een ruimtetechnologieprovider met hoofdkantoor zwitserland voor het bouwen van voordelige schaalbare satellietdistributeurs die helpen bij het inzetten van de constellatie voor het project kuiper beyond gravity opent een geheel nieuwe productiefaciliteit al resultaat van het partnerschap waarmee haar productiecapaciteit wordt verdubbeld en tientalen banen worden gecreerd linkping zweden arianespace arianespace de europese ruimtelijn heeft zichzelf gevestigd al leider de mondiale lanceringsdienstenindustrie door vorig jaar lanceringen met succes te voltooien waaronder de lancering van de james webbruimtetelescoop afgelopen december arianespace op weg met het starten van de activiteiten voor haar draagraket voor zware hefcapaciteit van de volgende generatie ariane welke voor de eerste keer gepland tegen het einde van dit jaar amazon heeft zich verzekerd van ariane raketten al onderdeel van deze eerste overeenkomst dit contract het grootste dat ooit afgesloten een geweldig moment de geschiedenis van arianespace zijn zeer vereerd dat een belangrijke rol hebben gekregen bij de inzet van amazon project kuiper dat erop gericht tientallen miljoenen mensen te verbinden met het internet aldus stphane isral ceo van arianespace het zal voortbouwen op de europese innovatieve spirit industrile sterkte en jaren ervaring en het een zeer belangrijke overwinning voor de europese lanceringsindustrie dat amazon de ariane heeft gekozen om de taak uit te voeren een aangelegenheid die ons met enorme trot vervult en een geweldige blijk van vertrouwen onze nieuwe draagraket blue origin amazon heeft een overeenkomst getekend met blue origin om lanceringen zeker te stellen met gebruikmaking van new glenn met opties voor tot extra lanceringen new glenn wordt van energie voorzien door zeven bemachines en haar herbruikbare eerste platform gebouwd voor minimaal missy het voor ons een eer om amazon ambitieuze missie voor het bieden van betrouwbare betaalbare breedband aan nog niet bediende en onderbediende gemeenschappen overal de wereld via new glenn en onze bemachines te ondersteunen aldus jarrett jones senior vice president new glenn blue origin new glenn zeven meter lange stroomlijnkap biedt niet eerder vertoonde massa en volumemogelijkheden waarmee project kuiper maximale lanceringsflexibiliteit wordt geboden feliciteren ook onze partner united launch alliance zijn er trot op amerika vervaardigde machine te bouwen voor ulas vulcan centaur united launch alliance amazon overeenkomst met ula omvat lanceringen op vulcan centaur ulas nieuwste draagraket voor zware lading dit lanceringsservicescontract omvat ook productie en infrastructuur voor de ondersteuning van een hogere stapfrequentie van lanceringen bij het cape canaveral ruimtestation waaronder een nieuwe specifieke versie van het vulcan launch platform vlp ula investeert extra hun spaceflight processing operation center spoc om een tweede ulafaciliteit te leveren die staat tot volledige voertuigverwerking het transformeren van de lanceringssite om twee parallelle lanceringsbanen te hebben voor activiteiten met een hoge stapfrequentie de overeenkomst een aanvulling op de bestaande deal van project kuiper om zich zeker te stellen van negen atlas vvoertuigen van ula deze overeenkomst markeert de start van een opwindend nieuw tijdperk voor ula en voor de gehele amerikaanse lanceringsindustrie met totaal lanceringen van onze atlas en vulcanvoertuigen saman zijn er trot op dat de meerderheid van deze belangrijke constellatie lanceren aldus tory bruno ulas president en ceo het zal zorgen voor honderden banen met name plaatsen al alabama colorado en florida en amazon investeringen lanceringsinfrastructuur en upgrade van mogelijkheden zal een voordeel zijn voor zowel commercile al overheidsklanten project kuiper plant de lancering van twee prototypemissies later dit jaar op de rsraket van abl space system er werken bij amazon nu meer dan mensen aan project kuiper en het team blijft vorderingen maken terwijl het een volledig productieklare inzet naderthaar zeer goed presterend satellietontwerp aan het afronden een betaalbare klantenterminal en een veilig betrouwbaar communicatiesnetwerk dat satellieten met klanten en infrastructuur op de grond verbindt eenmaal gebruik zal het kuipersysteem een capaciteit hebben die miljoenen particuliere zakelijke en overheidsklanten bedient plaatsen zonder betrouwbaar breedband verder vooruit zal amazon blijven samenwerken met bedrijven die haar commitment delen om de mondiale digitale scheidslijn te dichten en nieuwe kansen voor innovatie creren bekijk onze overzichtsvideo om meer te weten te komen project kuiper amazon amazon laat zich leiden door vier principe een obsessie voor de klant plaats van een focus op concurrenten een passie voor vindingrijkheid toewijding aan operationele uitmuntendheid en langetermijndenken amazon streeft ernaar het meest klantgerichte bedrijf op aarde de beste werkgever op aarde en de veiligste werkplek op aarde te zijn klantbeoordelingen winkelen met n klik gepersonaliseerde aanbevelingen prime fulfillment amazon aws kindle direct publishing kindle career choice firetablets firetv amazon echo alexa walk technology amazon studio en de klimaatbelofte zijn enkele door amazon gentroduceerde producten en diensten ga voor meer informatie naar amazoncomabout en volg amazonnews toekomstgerichte uitspraken dit persbericht bevat op de toekomst gerichte uitspraken forwardlooking statement volgens de betekenis van de private security litigation reform act van alle uitspraken dit persbericht waaronder uitspraken betreffende verwachte bedrijfsactiviteiten behalve die historische feiten betreffen zijn op de toekomst gericht gebruiken woorden al richt zich op anticipeert van mening verwacht toekomstig van plan zijn zullen en soortgelijke uitdrukkingen om toekomstgerichte uitspraken te identificeren toekomstgerichte uitspraken weerspiegelen de huidige verwachtingen van het management en zijn inherent onzeker actuele resultaten en uitkomsten kunnen om verschillende redenen wezenlijk verschillen waaronder onder meer veranderingen onze liquiditeit financile toestand kapitaaltoewijzing en financile strategien de schulden en aandelenmarkt waaronder al gevolg van fluctuaties vreemdevalutawisselkoersen veranderingen mondiale economische condities en bestedingen van klanten wereldgebeurtenissen de mate van groei van het internet onlinehandelsverkeer en clouddiensten het bedrag dat amazoncom investeert nieuwe zakelijke kansen en de timing van die investeringen de mix van producten en diensten die verkocht zijn aan klanten de mix van nettoverkopen afgeleid van producten vergeleken met diensten de omvang van verplichtingen met betrekking tot inkomsten andere belastingen concurrentie groeimanagement potentile fluctuaties bedrijfsresultaten internationale groei en uitbreiding de uitkomsten van claim procesvoering overheidsonderzoeken en andere procedure fulfillment sortering leveren en datacentrumoptimalisering risicos van voorraadbeheer variabiliteit vraag de mate waarin commercile overeenkomsten aangaan handhaven en ontwikkelen voorgenomen en voltooide acquisities en strategische transacties betalingsrisicos en risicos van fulfillmentsnelheid en productiviteit daarnaast het mondiale economische klimaat en extra onvoorziene effecten van de mondiale pandemie die veel van deze risicos versterken deze risicos en onzekerheden alsmede andere risicos en onzekerheden die er de oorzaak van kunnen zijn dat onze actuele resultaten aanmerkelijk verschillen van de verwachtingen van het management zijn meer detail beschreven de deponeringen van amazoncom bij de security exchange commission sec waaronder haar meest recente jaarverslag op formulier k en daarop volgende deponeringen hoewel geen verplichting op ons nemen om toekomstgerichte uitspraken te reviseren te updaten het nu gaat om het gevolg van nieuwe informatie toekomstige gebeurtenissen anderszins behalve indien wettelijk vereist raden wij u aan eventuele bekendmakingen te raadplegen die doen onze jaarverslagen op formulier k kwartaalrapporten op formulier q en actuele verslagen op formulier k die bij de sec zijn gedeponeerd deze bekendmaking officieel geldend de originele brontaal vertalingen zijn slechts al leeshulp bedoeld en moeten worden vergeleken met de tekst de brontaal die al enige rechtsgeldig,-0.9682,-0.4841,0.1110916,-0.5951916,Negative Impact
08/04/2022,156.75,157.37,154.23,154.46,154.46,46002000,-0.27,-314.4290963,1.192,0,14.33339876,0.959429757,-0.018638346,0.33,289.109,13711,16689.94922,7669.600098,6548.220215,3251.850098,59447.17969,21874.40039,154.61715,166.1327702,157.733077,161.647264,160.6795494,174.9142735,146.4448253,40.32554983,1.920695246,3.066374861,-1.145679614,4.273389544,168.8900853,10197832000,1.382441885,13.31972763,21.15999985,Missed Out On Tesla? My Best Stock-Split Stock to Buy And Hold,"Tesla has posted incredible stock gains since its last split, but this monster growth stock looks like a better buy.",https://www.fool.com/investing/2022/04/08/missed-out-on-timely-stocktopic-my-best-sector-sto/,fool.com,7,tesla posted incredible stock gain since last split monster growth stock look like better buy,0.886,0.6202,0.1280177778,0.4921822222,Positive Impact
11/04/2022,152.713,154.14,150.53,151.12,151.12,52112000,-0.27,-314.4290963,1.192,0,14.33339876,0.959429757,-0.018638346,0.33,289.109,13411.95996,16534.19922,7618.299805,6555.810059,3167.129883,58964.57031,21790.5,154.7600299,166.0380151,157.4738188,161.542535,161.1429993,173.2399068,149.0460917,31.02619848,1.009204548,2.654940798,-1.64573625,4.219852992,167.7173587,10145720000,2.894486778,8.110684935,24.37000084,Beyond HP: 3 Other Top Warren Buffett Tech Stocks to Buy in April,"Berkshire Hathaway's big investment in HP is the talk of the town, but it would be a mistake to miss out on these tech stocks.",https://www.fool.com/investing/2022/04/11/beyond-hp-3-other-top-warren-buffett-tech-stocks-t/,fool.com,7,berkshire hathaway big investment hp talk town would mistake miss tech stock,-0.4588,-0.32116,0.1498825,-0.4710425,Negative Impact
12/04/2022,153.6925,155.10,150.38,150.79,150.79,55178000,-0.27,-314.4290963,1.192,0,14.33339876,0.959429757,-0.018638346,0.33,289.109,13371.57031,16465.99023,7576.700195,6537.410156,3213.330078,58576.37109,21715.40039,154.78431,165.9309801,157.2116105,161.4355198,161.3140495,172.664461,149.9636381,32.03870845,0.2568899564,2.17533063,-1.918440673,4.293639047,165.9990728,10090542000,1.978191391,2.085040018,24.26000023,"Amazon warehouse workers suffer serious injuries at twice the rate of rivals, study finds","Amazon warehouse workers in the U.S. suffered serious injuries at twice the rate of rival companies, according to a new study.",https://www.cnbc.com/2022/04/12/study-amazon-workers-suffer-serious-injuries-at-twice-rate-of-rivals.html,cnbc.com,9,amazon warehouse worker u suffered serious injury twice rate rival company according new study,-0.6808,-0.61272,0.16065875,-0.77337875,Negative Impact
13/04/2022,150.0185,156.03,149.60,155.54,155.54,53390000,-0.27,-314.4290963,1.192,0,14.33339876,0.959429757,-0.018638346,0.33,289.109,13643.58984,16614.78906,7580.799805,6542.140137,3186.820068,58338.92969,21838,154.8712601,165.8466502,157.1460964,161.3768678,161.4358994,172.4629239,150.4088748,39.7734765,0.04373829469,1.749012163,-1.705273868,4.461959839,164.1251436,10143932000,27.98199259,10.95155692,21.81999969,Amazon and Starbucks union votes are small wins ÃÂÃÂ but important ones ÃÂÃÂ for US labor,Labor unions haven't had this much success in decades.,https://www.cnn.com/2022/04/13/business/amazon-starbucks-union-votes/index.html,cnn.com,5,labor union havent much success decade,-0.4585,-0.22925,0.2331724,-0.4624224,Negative Impact
14/04/2022,155.39,155.90,151.47,151.71,151.71,51598000,-0.27,-314.4290963,1.192,0,14.33339876,0.959429757,-0.018638346,0.33,289.109,13351.08008,16511.50977,7616.399902,6589.350098,3225.639893,58338.92969,21855.69922,154.89314,165.7451427,156.9327787,161.2806452,161.1592743,172.885039,149.4335096,34.57442727,-0.429645606,1.313280609,-1.742926215,4.555281503,162.0916243,10092334000,9.921540979,13.29390832,22.70000076,"As Amazon shareholders call for audit of warehouse working conditions, report finds more than double the rate of injuries than at other warehouses","A new report shows that Amazon accounted for about half of the serious injuries suffered by U.S. warehouse workers last year, which could bolster the argument for a shareholder resolution that will be brought to an investor vote next month.",https://www.marketwatch.com/story/as-amazon-shareholders-call-for-audit-of-warehouse-working-conditions-report-finds-more-than-double-the-rate-of-injuries-than-at-other-warehouses-11649946966,marketwatch.com,8,new report show amazon accounted half serious injury suffered u warehouse worker last year could bolster argument shareholder resolution brought investor vote next month,-0.7964,-0.63712,0.06398347826,-0.701103478,Negative Impact
18/04/2022,151.5235,154.04,150.25,152.79,152.79,46514000,-0.27,-314.4290963,1.192,0,14.33339876,0.959429757,-0.018638346,0.33,289.109,13332.36035,16466.21094,7616.399902,6589.350098,3195.52002,57166.73828,21878.40039,155.1719299,165.6508252,156.7701209,161.1961115,160.7359993,173.0445864,148.4274122,29.3384325,-0.709599477,0.9087045918,-1.618304069,4.521352495,160.3427978,10138848000,15.00129004,17.6349412,22.17000008,Amazon workers in small New Jersey facility file for union election,"Amazon.com Inc workers at a small facility in New Jersey have shown enough interest to hold a vote on unionizing, the U.S. National Labor Relations Board (NLRB) said on Monday.",https://www.reuters.com/technology/amazon-workers-small-new-jersey-facility-file-union-election-2022-04-18/,reuters.com,10,amazoncom inc worker small facility new jersey shown enough interest hold vote unionizing u national labor relation board nlrb said monday,0.4588,0.4588,0.095498,0.363302,Positive Impact
19/04/2022,152.0295,158.65,151.55,158.12,158.12,54926000,-0.27,-314.4290963,1.192,0,14.33339876,0.959429757,-0.018638346,0.33,289.109,13619.66016,16658.90039,7601.299805,6534.790039,3194.030029,56463.14844,22018.80078,155.1814499,165.5636577,156.8228806,161.1654586,160.5671989,172.9246612,148.2097367,37.33731516,-0.49562567,0.6278385394,-1.12346421,4.816745213,158.8388069,10193774000,44.00656387,22.97646496,21.37000084,Amazon Remains a Tricky Bet Ahead of Earnings,Amazon's next quarterly report looms large. Here are three high odds trades using AMZN stock options to consider.,https://investorplace.com/2022/04/amzn-stock-remains-a-tricky-bet-ahead-of-earnings/,investorplace.com,6,amazon next quarterly report loom large three high odds trade using amzn stock option consider,-0.0516,-0.03096,0.25709,-0.28805,Negative Impact
20/04/2022,157.6025,157.60,153.60,154.00,154.00,59630000,-0.27,-314.4290963,1.192,0,14.33339876,0.959429757,-0.018638346,0.33,289.109,13453.07031,16761.34961,7629.200195,6624.910156,3151.050049,57037.5,21998.40039,155.1026999,165.4147127,156.712101,161.0941406,160.0226486,172.5370889,147.5082083,36.42831822,-0.650795173,0.372111797,-1.02290697,4.866530282,149.6000061,10134144000,23.40044296,27.46943229,20.31999969,"Facebook, Apple, Amazon, Netflix And Google: What The Price Charts Tell Us","Whatever it is, the reason the NASDAQ -100 remains well below its November, 2021 price peak is the failure of major components Facebook (now Meta), Apple, Amazon, Netflix and Google (now Alphabet) to rally.",https://www.forbes.com/sites/johnnavin/2022/04/20/facebook-apple-amazon-netflix-and-google-what-the-price-charts-tell-us/,forbes.com,8,whatever reason nasdaq remains well november price peak failure major component facebook meta apple amazon netflix google alphabet rally,-0.128,-0.1024,0.299384,-0.401784,Negative Impact
21/04/2022,154.714,156.74,147.59,148.30,148.30,63970000,-0.27,-314.4290963,1.192,0,14.33339876,0.959429757,-0.018638346,0.33,289.109,13174.65039,16499.33008,7628,6715.100098,3079.810059,57911.67969,21650.40039,154.84035,165.2320477,156.3820581,160.966796,159.2670486,172.7111879,145.8229094,34.5975328,-1.219810318,0.05372737392,-1.273537692,5.267032078,157.6024933,10070174000,3.395876865,23.60096123,22.68000031,This Is Why Matterport Stock Should Be in All Portfolios,"MTTR stock could have massive exposure to a potential $829 billion metaverse market by 2028, and to a $48.2 billion digital twin market. The post This Is Why Matterport Stock Should Be in All Portfolios appeared first on InvestorPlace.",https://investorplace.com/2022/04/this-is-why-matterport-mttr-stock-should-be-in-all-portfolios/,investorplace.com,6,mttr stock could massive exposure potential billion metaverse market billion digital twin market post matterport stock portfolio appeared first investorplace,0,0,0.3711611111,-0.371161111,Negative Impact
22/04/2022,148.25,149.62,143.70,144.35,144.35,73078000,-0.27,-314.4290963,1.192,0,14.33339876,0.959429757,-0.018638346,0.33,289.109,12839.29004,16056.87012,7521.700195,6581.419922,3086.919922,57197.14844,21186.40039,154.5035602,165.0209453,155.9102129,160.8014548,158.3020737,173.1218817,143.4822657,31.20646251,-1.966499492,-0.350317999,-1.616181493,5.439176287,157.6024933,9997096000,2.642067588,9.812795804,28.20999908,"Got $1,000? 5 Buffett Stocks to Buy and Hold Forever",These industry leaders have Buffett's stamp of approval and are on track for more big wins.,https://www.fool.com/investing/2022/04/22/got-1000-5-buffett-stocks-to-buy-and-hold-forever/,fool.com,7,industry leader buffetts stamp approval track big win,0.7845,0.54915,-0.023175,0.572325,Positive Impact
25/04/2022,144.023,146.22,142.31,146.07,146.07,61874000,-0.27,-314.4290963,1.192,0,14.33339876,0.959429757,-0.018638346,0.33,289.109,13004.84961,16054.75977,7380.5,6449.379883,2928.51001,56579.89063,21011.90039,154.2449704,164.8214803,155.5244792,160.654913,157.367099,172.8140516,141.9201464,26.82144549,-2.391575139,-0.758569427,-1.633005712,5.348176139,157.0462933,10058970000,14.60045616,6.879466869,27.02000046,"Ongoing Investigation Notice: The Schall Law Firm Encourages Investors in Amazon.com, Inc. with Losses of $100,000 to Contact the Firm","Los Angeles, California--(Newsfile Corp. - April 25, 2022) - The Schall Law Firm, a national shareholder rights litigation firm, announces that it is investigating claims on behalf of investors of Amazon.com, Inc. (""Amazon"" or ""the Company"") (NASDAQ: AMZN) for violations of the securities laws.The investigation focuses on whether the Company issued false and/or misleading statements and/or failed to disclose information pertinent to investors. Amazon is the subject of a report published by The Wall Street...",https://www.newsfilecorp.com/release/121515/Ongoing-Investigation-Notice-The-Schall-Law-Firm-Encourages-Investors-in-Amazon.com-Inc.-with-Losses-of-100000-to-Contact-the-Firm?utm_source=snapi,newsfilecorp.com,5,los angeles californianewsfile corp april schall law firm national shareholder right litigation firm announces investigating claim behalf investor amazoncom inc amazon company nasdaq amzn violation security lawsthe investigation focus whether company issued false andor misleading statement andor failed disclose information pertinent investor amazon subject report published wall street,-0.7351,-0.36755,0.227985,-0.595535,Negative Impact
26/04/2022,144.8,144.86,138.93,139.39,139.39,77530000,-0.27,-314.4290963,1.192,0,14.33339876,0.959429757,-0.018638346,0.33,289.109,12490.74023,15694.24023,7386.200195,6414.569824,2886.429932,57356.60938,20690.80078,153.9669205,164.5887978,154.891794,160.4433318,155.8871246,172.2875082,139.4867411,25.54969282,-3.230473899,-1.252950322,-1.977523577,5.495605469,156.1619059,9981440000,1.983207163,6.408576969,33.52000046,Amazon won't face OSHA penalties after warehouse collapse,"In December, a tornado hit an Amazon warehouse in Edwardsville, Illinois, killing six workers, most of whom were contracted delivery drivers.",https://www.cnbc.com/2022/04/26/amazon-warehouse-collapse-osha-orders-safety-review-no-fines.html,cnbc.com,9,december tornado hit amazon warehouse edwardsville illinois killing six worker contracted delivery driver,-0.5719,-0.51471,0.0784825,-0.5931925,Negative Impact
27/04/2022,140.1915,141.95,135.78,138.17,138.17,71336000,-0.27,-314.4290963,1.192,0,14.33339876,0.959429757,-0.018638346,0.33,289.109,12488.92969,15741.82031,7425.600098,6445.259766,2958.280029,56819.39063,20744.19922,153.6269205,164.3602929,154.2359201,160.2216769,154.3297249,171.268031,137.3914187,27.79538951,-3.948557193,-1.792071696,-2.156485497,5.450213841,154.7833138,9910104000,9.810517325,8.798060214,31.60000038,"Investigation Reminder: The Schall Law Firm Encourages Investors in Amazon.com, Inc. with Losses of $100,000 to Contact the Firm","Los Angeles, California--(Newsfile Corp. - April 27, 2022) - The Schall Law Firm, a national shareholder rights litigation firm, announces that it is investigating claims on behalf of investors of Amazon.com, Inc. (""Amazon"" or ""the Company"") (NASDAQ: AMZN) for violations of the securities laws.The investigation focuses on whether the Company issued false and/or misleading statements and/or failed to disclose information pertinent to investors. Amazon is the subject of a report published by The Wall Street...",https://www.newsfilecorp.com/release/121850/Investigation-Reminder-The-Schall-Law-Firm-Encourages-Investors-in-Amazon.com-Inc.-with-Losses-of-100000-to-Contact-the-Firm?utm_source=snapi,newsfilecorp.com,5,los angeles californianewsfile corp april schall law firm national shareholder right litigation firm announces investigating claim behalf investor amazoncom inc amazon company nasdaq amzn violation security lawsthe investigation focus whether company issued false andor misleading statement andor failed disclose information pertinent investor amazon subject report published wall street,-0.7351,-0.36755,0.1582585714,-0.525808571,Negative Impact
28/04/2022,142.178,145.94,140.30,144.60,144.60,117316000,-0.27,-314.4290963,1.192,0,14.33339876,0.959429757,-0.018638346,0.33,289.109,12871.53027,16032.67969,7509.200195,6508.140137,2975.47998,57521.05859,21121.09961,153.3886404,164.1628554,153.8579034,160.0662024,153.2445,169.7284615,136.7605385,37.27517047,-3.953266541,-2.224310665,-1.728955876,5.607571193,152.8833317,10027420000,38.54278305,16.77883585,29.98999977,"Amazon's cloud business grows 36%, slightly slower from last quarter","Amazon's overall business lost money in the first quarter, but the loss would have been even steeper were it not for the fast-growing cloud segment.",https://www.cnbc.com/2022/04/28/aws-earnings-q1-2022.html,cnbc.com,9,amazon overall business lost money first quarter loss would even steeper fastgrowing cloud segment,-0.4404,-0.39636,0.110430938,-0.506790938,Negative Impact
29/04/2022,129.849,130.76,121.63,124.28,124.28,272662000,-0.27,-314.4290963,1.192,0,14.33339876,0.959429757,-0.018638346,0.33,289.109,12334.63965,15615.25,7544.600098,6533.77002,3047.060059,57060.87109,20762,152.7122606,163.8764629,152.6980446,159.7101357,151.3087002,171.6192501,130.9981503,28.07108267,-5.532474117,-2.885943355,-2.646530762,6.994571141,151.1733479,9754758000,7.175080005,18.50946013,33.40000153,Victoria's Secret is taking its beauty business to Amazon in its first-ever wholesale test,"Victoria's Secret is taking its beauty business to Amazon, marking the lingerie company's first major tie-up with another retailer to sell its goods.",https://www.cnbc.com/2022/04/29/victorias-secret-takes-beauty-business-to-amazon-in-wholesale-test.html,cnbc.com,9,victoria secret taking beauty business amazon marking lingerie company first major tieup another retailer sell good,0.8126,0.73134,0.001255714286,0.7300842857,Positive Impact
02/05/2022,122.401,124.67,118.38,124.50,124.50,148788000,-0.27,-314.4290963,1.192,0,14.33339876,0.959429757,-0.018638346,0.77,292.296,12536.01953,15609.28027,7544.600098,6425.609863,3047.060059,56975.98828,20692.19922,152.1092107,163.6055554,151.5922389,159.3597861,149.3557003,172.0749966,126.636404,29.73693893,-6.689266814,-3.646608047,-3.042658767,7.163642883,147.6275461,9903546000,15.2083222,20.30872842,32.34000015,Woman says Amazon.com fired her because she got 'long COVID' - lawsuit,"A former Amazon.com Inc employee sued the online retailer on Monday, saying it wrongly fired her and demanded she repay wages after she contracted ""long COVID.""",https://www.reuters.com/article/amazon-com-lawsuit-long-covid/woman-says-amazon-com-fired-her-because-she-got-long-covid-lawsuit-idUSKCN2MO1JY,reuters.com,10,former amazoncom inc employee sued online retailer monday saying wrongly fired demanded repay wage contracted long covid,-0.6705,-0.6705,0.1472713889,-0.817771389,Negative Impact
03/05/2022,124.0535,126.22,122.83,124.25,124.25,79134000,-0.27,-314.4290963,1.192,0,14.33339876,0.959429757,-0.018638346,0.77,292.296,12563.75977,15729.53027,7561.299805,6476.180176,3047.060059,56975.98828,20905.30078,151.5422507,163.3394254,150.5201316,159.0104699,147.1510506,170.6549178,123.6471833,29.77682353,-7.539018584,-4.425090154,-3.11392843,7.069321224,143.5321897,9824412000,14.59626953,12.32655725,29.25,Amazon France unions reject wage increase proposal on last day of talks,"Most unions at the French unit of U.S. e-commerce giant Amazon.com Inc rejected a company proposal for 2022 pay, with the exception of one management union, but no immediate protest actions are planned, union representatives said on Tuesday.",https://www.reuters.com/business/amazon-france-unions-reject-wage-increase-proposal-last-day-talks-2022-05-03/,reuters.com,10,union french unit u ecommerce giant amazoncom inc rejected company proposal pay exception one management union immediate protest action planned union representative said tuesday,-0.6908,-0.6908,0.216456087,-0.907256087,Negative Impact
04/05/2022,123.6,126.00,119.18,125.93,125.93,110746000,-0.27,-314.4290963,1.192,0,14.33339876,0.959429757,-0.018638346,0.77,292.296,12964.86035,16119.61035,7493.5,6395.680176,3047.060059,55669.03125,21185,151.0568707,163.0757703,149.5557537,158.681296,145.2447258,169.1569467,121.3325049,26.31926519,-7.985245908,-5.137121305,-2.848124603,7.097322192,140.0101831,9935158000,18.75526872,16.18662015,25.42000008,EBay and Etsy drop on weak guidance as e-commerce crunch continues,"Both of the companies gave disappointing guidance for the current quarter, sending their stocks sharply lower in extended trading.",https://www.cnbc.com/2022/05/04/ebay-etsy-earnings-q1-2022-reflect-e-commerce-crunch.html,cnbc.com,9,company gave disappointing guidance current quarter sending stock sharply lower extended trading,-0.6597,-0.59373,0.1070985714,-0.700828571,Negative Impact
05/05/2022,123,123.50,115.07,116.41,116.41,144392000,-0.27,-314.4290963,1.192,0,14.33339876,0.959429757,-0.018638346,0.77,292.296,12317.69043,15652.61035,7503.299805,6368.399902,3067.76001,55702.23047,20696.19922,150.4884708,162.7615054,148.2558025,158.2606562,143.1272758,169.3867551,116.8677966,24.12494805,-9.003404085,-5.910377861,-3.093026224,7.556678772,136.9812575,9790766000,3.062420218,12.13798616,31.20000076,3 Reasons Investors Shouldn't Lose Sleep Over Microsoft's Pullback,"Technology stocks have suffered in 2022. They felt unstoppable over the last few years, rolling over any doubters and paving the way for investors to reap a multitude of gains.",https://www.zacks.com/commentary/1917199/3-reasons-investors-shouldn-t-lose-sleep-over-microsoft-s-pullback,zacks.com,8,technology stock suffered felt unstoppable last year rolling doubter paving way investor reap multitude gain,-0.4939,-0.39512,0.1550229412,-0.550142941,Negative Impact
06/05/2022,114.85,119.05,113.08,114.77,114.77,124260000,-0.27,-314.4290963,1.192,0,14.33339876,0.959429757,-0.018638346,0.77,292.296,12144.66016,15566.55957,7387.899902,6258.359863,3001.560059,54835.57813,20633.30078,149.7567607,162.4258603,146.9427318,157.8279383,140.9766758,169.1568059,112.7965457,22.36155663,-9.828890818,-6.694080453,-3.134810365,7.712393079,133.4758566,9666506000,3.710981974,8.509556971,30.19000053,"Amazon's captive staff meetings on unions illegal, U.S. labor director finds","A U.S. labor board official determined Amazon.com Inc violated federal law during mandatory staff meetings it held in New York to discourage unionization, a board spokesperson said Friday, in what could lead to a new legal precedent.",https://www.reuters.com/article/amazon-com-labor/amazons-captive-staff-meetings-on-unions-illegal-u-s-labor-director-finds-idUSKCN2MS1YG,reuters.com,10,u labor board official determined amazoncom inc violated federal law mandatory staff meeting held new york discourage unionization board spokesperson said friday could lead new legal precedent,-0.4588,-0.4588,0.1456844444,-0.604484444,Negative Impact
09/05/2022,111.3125,114.00,107.96,108.79,108.79,128124000,-0.27,-314.4290963,1.192,0,14.33339876,0.959429757,-0.018638346,0.77,292.296,11623.25,15057.87012,7216.600098,6086.02002,3004.139893,54470.67188,19999.69922,148.8567708,162.0556453,145.4465071,157.3399886,138.6931011,169.5476238,107.8385784,14.47265316,-10.84094558,-7.523453478,-3.317492102,7.692178999,129.8048719,9538382000,1.67588373,2.816428641,34.75,Apple and Amazon Have Fallen for Six Straight Weeks. There Could Be More Pain Ahead.,"While Apple and Amazon have fallen sharply over the past six weeks, so has the tech-heavy Nasdaq Composite, which has put in its worst six-week performance since April 2020.",https://www.barrons.com/articles/apple-aapl-amazon-amzn-losing-streaks-51652112126,barrons.com,9,apple amazon fallen sharply past six week techheavy nasdaq composite put worst sixweek performance since april,-0.7096,-0.63864,0.05561913043,-0.69425913,Negative Impact
10/05/2022,111.25,112.64,107.17,108.86,108.86,105434000,-0.27,-314.4290963,1.192,0,14.33339876,0.959429757,-0.018638346,0.77,292.296,11737.66992,15025.74023,7243.200195,6116.910156,3035.840088,54364.85156,19890.09961,147.9626907,161.6749854,144.0117029,156.8575907,136.5799515,169.5657397,103.5941632,15.47578854,-11.50473842,-8.319710466,-3.185027951,7.760715485,125.4352977,9643816000,3.405498082,2.930787929,32.99000168,"Tech Stocks GOOGL, TSLA, AMZN, MSFT Look to Rebound After Monday Selloff",Tech stocks have faced pressure amid rate hikes and recession fears. Today proves they have what it takes to survive.,https://investorplace.com/2022/05/tech-stocks-googl-tsla-amzn-msft-look-to-rebound-after-monday-selloff/,investorplace.com,6,tech stock faced pressure amid rate hike recession fear today prof take survive,-0.802,-0.4812,0.1461369565,-0.627336957,Negative Impact
11/05/2022,108.1035,110.16,104.43,105.37,105.37,109704000,-0.27,-314.4290963,1.192,0,14.33339876,0.959429757,-0.018638346,0.77,292.296,11364.24023,14902.13965,7347.700195,6269.72998,3058.699951,54088.39063,19837.30078,147.0472908,161.2952478,142.4964205,156.3452963,134.3091763,169.3647673,99.25358523,16.01853582,-12.1718611,-9.090140593,-3.08172051,7.516357422,121.7824377,9534112000,2.088022225,2.389801346,32.56000137,Amazon: Trying To Find A Bottom,Shares hit a new 52-week low this week. Rising gas prices and the US dollar will further hurt results.,https://seekingalpha.com/article/4510099-amazon-trying-to-find-a-bottom,seekingalpha.com,6,share hit new week low week rising gas price u dollar hurt result,-0.5106,-0.30636,0.1533576471,-0.459717647,Negative Impact
12/05/2022,102.75,110.78,102.41,106.93,106.93,132026000,-0.27,-314.4290963,1.192,0,14.33339876,0.959429757,-0.018638346,0.77,292.296,11370.95996,14931.09961,7233.299805,6206.259766,3054.98999,52930.30859,19699.09961,146.1448506,160.9223203,141.1016784,155.8536068,131.878651,167.4725636,96.28473848,19.21241946,-12.43150055,-9.758412585,-2.673087967,7.691892351,118.3116496,9666138000,10.32726513,5.273595146,31.77000046,Amazon: Don't Fire Until You See The Whites Of Their Eyes,"""Don't fire until you see the whites of their eyes"" is a famous quote from the Revolutionary War. The command was given by Col. William Prescott at the battle of Bunker Hill on 17 June 1775 to reserve fire because powder was scarce.",https://seekingalpha.com/article/4510335-amazon-dont-fire-until-you-see-the-whites-of-their-eyes,seekingalpha.com,6,dont fire see white eye famous quote revolutionary war command given col william prescott battle bunker hill june reserve fire powder scarce,-0.5312,-0.31872,0.04726076923,-0.365980769,Negative Impact
13/05/2022,109.069,113.18,107.80,113.06,113.06,93684000,-0.27,-314.4290963,1.192,0,14.33339876,0.959429757,-0.018638346,0.77,292.296,11805,15257.36035,7418.200195,6362.680176,3084.280029,52793.62109,20099.80078,145.4479807,160.5876153,140.0018087,155.42775,129.9460762,165.2027018,94.68945058,24.66739693,-12.00468782,-10.20766763,-1.797020189,7.85892868,115.1304201,9759822000,24.46360965,12.29296567,28.87000084,"Amazon stock bounces, but is still headed for the longest weekly losing streak in 14 years","Shares of Amazon.com Inc. AMZN, +3.78% rallied 3.9% in afternoon trading Friday, amid a broad rally in technology names, but was still on track for the longest weekly losing streak in 14 years. The rally in the ecommerce giant's stock comes after it rose 1.5% on Thursday, which followed a 3.2% drop on Wednesday to its lowest close since April 2020.",https://www.marketwatch.com/story/amazon-stock-bounces-but-is-still-headed-for-the-longest-weekly-losing-streak-in-14-years-2022-05-13,marketwatch.com,8,share amazoncom inc amzn rallied afternoon trading friday amid broad rally technology name still track longest weekly losing streak year rally ecommerce giant stock come rose thursday followed drop wednesday lowest close since april,-0.6249,-0.49992,0.05603363636,-0.555953636,Negative Impact
16/05/2022,113.1,113.99,110.35,110.81,110.81,74566000,-0.27,-314.4290963,1.192,0,14.33339876,0.959429757,-0.018638346,0.77,292.296,11662.79004,15259.82031,7464.799805,6347.77002,3073.75,52973.83984,20206.40039,144.7513705,160.3097703,138.8570515,154.9837973,127.8473511,162.3692023,93.3254998,26.47015964,-11.71253319,-10.50864074,-1.203892449,7.608500344,102.4055023,9685256000,19.30763399,18.03283626,27.46999931,The Wall Street Journal: Rivian warns price dispute with seat supplier could impact Amazon van order,"Electric-vehicle startup Rivian Automotive Inc. is suing a key supplier of seats, warning that a pricing dispute could impact production of an electric van ordered by Amazon.com Inc.",https://www.marketwatch.com/story/rivian-warns-price-dispute-with-seat-supplier-could-impact-amazon-van-order-11652737531,marketwatch.com,8,electricvehicle startup rivian automotive inc suing key supplier seat warning pricing dispute could impact production electric van ordered amazoncom inc,-0.7351,-0.58808,0.007562857143,-0.595642857,Negative Impact
17/05/2022,113.275,115.80,111.28,115.37,115.37,76448000,-0.27,-314.4290963,1.192,0,14.33339876,0.959429757,-0.018638346,0.77,292.296,11984.51953,15541.91016,7518.399902,6430.189941,3093.699951,54318.46875,20491,144.3096805,160.0537428,137.9359318,154.5896152,125.7100014,157.5287232,93.89127959,32.20714466,-10.98655992,-10.60422458,-0.382335343,7.524535588,102.6372423,9761704000,29.77808997,24.51644454,26.10000038,12 Growth Blue-Chip Bargains I'm Buying Hand Over Fist,"The 2nd-worst start to the year in market history has generated the worst investor sentiment in 30 years. Hedge Funds have been selling stocks in the tens of billions of dollars, while Warren Buffett bought $41 billion of net stock in Q1.",https://seekingalpha.com/article/4512524-12-growth-blue-chip-bargains-im-buying-hand-over-fist,seekingalpha.com,6,ndworst start year market history generated worst investor sentiment year hedge fund selling stock ten billion dollar warren buffett bought billion net stock q,-0.6249,-0.37494,0.100875,-0.475815,Negative Impact
18/05/2022,111.4395,112.85,106.25,107.11,107.11,108380000,-0.27,-314.4290963,1.192,0,14.33339876,0.959429757,-0.018638346,0.77,292.296,11418.15039,15044.51953,7438.100098,6352.939941,3085.97998,54208.53125,20101.40039,143.7316406,159.7477453,136.7271699,154.1172061,123.3657265,153.2595422,93.47191076,21.55691209,-10.95117251,-10.67361417,-0.277558345,7.620893206,103.1637527,9653324000,16.59995717,21.89522704,30.95999908,"Amazon Stock Plunges in Wake of Target, Walmart Debacles. This Is Why.","The trends highlighted by Target's and Walmart's disappointing results bode poorly for Amazon. Investors reacted with shock, sending shares down sharply.",https://www.barrons.com/articles/amazon-stock-plunges-in-wake-of-target-walmart-debacles-this-is-why-51652901840,barrons.com,9,trend highlighted target walmarts disappointing result bode poorly amazon investor reacted shock sending share sharply,-0.4404,-0.39636,0.05895647059,-0.455316471,Negative Impact
19/05/2022,106.2805,110.03,106.19,107.32,107.32,88142000,-0.27,-314.4290963,1.192,0,14.33339876,0.959429757,-0.018638346,0.77,292.296,11388.5,15035.87012,7302.700195,6272.709961,3096.959961,52792.23047,20181.90039,143.0924405,159.4456603,135.5739084,153.6515523,121.3168762,149.5892876,93.04446486,31.47570689,-10.78217493,-10.69532632,-0.086848615,6.254428864,103.6692027,9741466000,20.63195043,22.33666586,29.35000038,Amazon And Netflix: Dot.Com Bubble 2.0?,The one question we're all asking now is if the market has bottomed or not. My answer is unfortunately no. The current market situation resembles the 2000 dot.com bubble in wicked ways - history always rhymes.,https://seekingalpha.com/article/4513210-amazon-and-netflix-dotcom-bubble-2-0,seekingalpha.com,6,one question asking market bottomed answer unfortunately current market situation resembles dotcom bubble wicked way history always rhyme,-0.7003,-0.42018,-0.043061429,-0.377118571,Negative Impact
20/05/2022,109.5685,109.90,105.01,107.59,107.59,99500000,-0.27,-314.4290963,1.192,0,14.33339876,0.959429757,-0.018638346,0.77,292.296,11354.62012,15080.98047,7390,6285.240234,3146.570068,54326.39063,20197.59961,142.3079105,159.1396178,134.4765395,153.1932384,119.4789261,146.1824729,92.77537928,31.5556927,-10.50519738,-10.65730053,0.1521031531,6.154107775,104.1544347,9840966000,21.77410132,19.66866964,29.43000031,7 Blue-Chip Stocks to Buy at Fire Sale Prices,"Although the market has been a disaster recently, bold contrarians could use this time to grab discounts on blue-chip stocks to buy. The post 7 Blue-Chip Stocks to Buy at Fire Sale Prices appeared first on InvestorPlace.",https://investorplace.com/2022/05/7-blue-chip-stocks-to-buy-at-fire-sale-prices/,investorplace.com,6,although market disaster recently bold contrarian could use time grab discount bluechip stock buy post bluechip stock buy fire sale price appeared first investorplace,-0.5994,-0.35964,0.1786590909,-0.538299091,Negative Impact
23/05/2022,108.461,108.82,103.95,107.56,107.56,107798000,-0.27,-314.4290963,1.192,0,14.33339876,0.959429757,-0.018638346,0.77,292.296,11535.26953,15342.95996,7513.399902,6358.740234,3146.860107,54288.60938,20197.59961,141.5485603,158.8411679,133.4208713,152.7391465,117.5530758,141.6047015,93.50145003,31.70265863,-10.17118741,-10.56007791,0.3888904987,6.259357997,115.8000031,9733168000,21.83346709,21.41317295,28.47999954,AWS Announces General Availability of Amazon EC2 C7g Instances Powered by AWS-designed Graviton3 Processors,"SEATTLE--(BUSINESS WIRE)--Amazon Web Services, Inc. (AWS), an Amazon.com, Inc. company (NASDAQ: AMZN), today announced the general availability of Amazon Elastic Compute Cloud (Amazon EC2) C7g instances, the next generation of compute-optimized instances powered by AWS-designed Graviton3 processors. New C7g instances use AWS Graviton3 processors to provide up to 25% better compute performance for compute-intensive applications than current generation C6g instances powered by AWS Graviton2 processors. The higher performance of C7g instances makes it possible for customers to run more efficiently a wide range of compute-intensive workloadsÃÂÃÂfrom web servers, load balancers, and batch processing to electronic design automation (EDA), high performance computing (HPC), gaming, video encoding, scientific modeling, distributed analytics, machine learning inference, and ad serving. There are no minimum commitments or upfront fees to use C7g instances, and customers pay only for the amount of compute used. To get started with C7g instances, visit aws.amazon.com/ec2/instance-types/c7g. Since launching in 2020, Amazon EC2 instances powered by AWS-designed Graviton2 processors have provided customers with significant performance improvements and cost savings for a broad range of applications. Today, 48 of the top 50 Amazon EC2 customers use AWS Graviton2-based instances to deliver superior price performance to their customers. Customers like DirecTV, Discovery, Epic Games, Formula 1, Honeycomb.io, Intuit, Lyft, Mercardo Libre, NextRoll, Nielsen, SmugMug, Snap, Splunk, and Sprinklr have seen significant performance gains, with reduced costs, running AWS Graviton2-based instances in production. The AWS Graviton-based instance portfolio offers 13 different instances that include general purpose, compute optimized, memory optimized, storage optimized, burstable, and accelerated computing instances, so customers have the deepest and broadest choice of high-performance, cost-effective, and power-efficient compute in the cloud for all sorts of applications. As customers bring more compute-intensive workloads to the cloud to transform their organizations and fuel new opportunities, they want even better price performance and greater energy efficiency when running these demanding workloads. To provide even better price performance for a wide variety of customer applications, new C7g instances powered by next generation AWS Graviton3 processors provide up to 25% better performance for compute-intensive applications over current generation C6g instances. Compared to previous generation AWS Graviton2 processors, AWS Graviton3 processors deliver up to 2x faster performance for cryptographic workloads, up to 3x faster performance for machine learning inference, and nearly 2x higher floating point performance for scientific, machine learning, and media encoding workloads. AWS Graviton3 processors are also more energy efficient, using up to 60% less energy for the same performance than comparable EC2 instances. C7g instances are the first in the cloud to feature the latest DDR5 memory, which provides 50% higher memory bandwidth than AWS Graviton2-based instances to improve the performance of memory-intensive scientific applications like computational fluid dynamics, geoscientific simulations, and seismic processing. C7g instances also deliver 20% higher networking bandwidth than C6g instances for network intensive applications like network load balancing and data analytics. ÃÂÃÂCustomers of all sizes are seeing significant performance gains and cost savings using AWS Graviton-based instances,ÃÂÃÂ said David Brown, Vice President of Amazon EC2 at AWS. ÃÂÃÂSince we own the end-to-end chip development process, weÃÂÃÂre able to innovate and deliver new instances to customers faster. With up to 25% better performance than current generation Graviton instances, new C7g instances powered by AWS Graviton3 processors make it easy for organizations to get the most value from running their infrastructure on AWS.ÃÂÃÂ New C7g instances are built on the AWS Nitro System, a collection of AWS-designed hardware and software innovations that streamline the delivery of isolated multi-tenancy, private networking, and fast local storage. The AWS Nitro System offloads the CPU virtualization, storage, and networking functions to dedicated hardware and software, delivering performance that is nearly indistinguishable from bare metal. For customers looking to enhance the performance of applications that require parallel processing like HPC and video encoding, C7g instances in the coming weeks will include support for Elastic Fabric Adapter (EFA), which allows applications to communicate directly with network interface cards, providing lower and more consistent latency. C7g instances are available for purchase as On-Demand Instances, with Savings Plans, as Reserved Instances, or as Spot Instances. C7g instances are available today in US East (N. Virginia) and US West (Oregon), with availability in additional AWS Regions coming later this year. Snap Inc. is a camera company focused on empowering people to express themselves, live in the moment, learn about the world, and have fun together. ÃÂÃÂWe trialed the new AWS Graviton3-based Amazon EC2 C7g instances and found that they provide significant performance improvements on real workloads compared to previous generation C6g instances,ÃÂÃÂ said Aaron Sheldon, Software Engineer at Snap. ÃÂÃÂWe are excited to migrate our Graviton2-based workloads to Graviton3, including the messaging, storage and the friend graph workloads.ÃÂÃÂ Sprinklr helps the world's biggest companies make their customers happier across 30+ digital channelsÃÂÃÂusing the most advanced, sophisticated AI engine built for the enterprise to create insight-driven strategies and better customer experiences. ÃÂÃÂWe run a wide variety of workloads on AWS Graviton-based instances for their significant price performance benefits,ÃÂÃÂ said Jamal Mazhar, Vice President of Infrastructure and DevOps at Sprinklr. ÃÂÃÂAfter the announcement of AWS Graviton3, we benchmarked our workloads on the new Amazon EC2 C7g instances and observed 27% better performance compared to the previous generation instances. Based on these results, we are looking forward to adopting AWS Graviton3-based instances in production.ÃÂÃÂ NextRoll, Inc. is a marketing and data technology company with a mission to accelerate growth for companies, big and small. Powered by machine learning, NextRollÃÂÃÂs technology gathers data, delivers reliable insights, and provides business with approachable tools to target buyers in strategic ways ÃÂÃÂ all on one platform. ÃÂÃÂWe have found that AWS Graviton3-based C7g instances are ideal for bidders, ad servers, and ElastiCache clusters,ÃÂÃÂ said Valentino Volonghi, CTO at NextRoll. ÃÂÃÂWe are seeing about 15% more requests handled by C7g instances compared to AWS Graviton2-based C6g instances. With C7g instances, we also observed up to 40% better latency. Based on these findings, we are looking forward to adopting AWS Graviton3-based C7g instances in production.ÃÂÃÂ Ansys is a global leader in engineering simulation. ÃÂÃÂAs engineers and designers face increasingly complex problems, cloud computing helps lower the barrier of access to high-performance computing, allowing users to solve problems faster,ÃÂÃÂ said Prith Banerjee, Chief Technology Officer at Ansys. ÃÂÃÂAnsys has also been focusing on green computing initiatives with the goal of improving energy efficiency and reducing costs to customers. With the support of LS-DYNA on the AWS Graviton3 processor powered by AWS, Ansys customers will get the best of both worlds ÃÂÃÂ access to a world-class multiphysics solver without compromising on speed, and lower energy and costs.ÃÂÃÂ Beamr is a leading provider of image and video optimization solutions that enable professional photographers to improve their workflows, photo sharing services to improve user experience (UX) and reduce churn, and video service providers to reduce storage and delivery costs. ÃÂÃÂBeamr's JPEGmini software, written in C/C++, optimizes JPEG image files by reducing their file size without compromising quality. The application is compute-intensive and includes functions for image decoding, image encoding, and a quality measure algorithm that analyzes various image attributes,ÃÂÃÂ said Dan Julius, Vice President of R&D at Beamr. ÃÂÃÂSince the mobile version of this software runs on Arm processors, we decided to test its performance on AWS Graviton3-based Amazon EC2 C7g instances. Rebuilding our software to run on C7g instances took us one working day, and the results were promising. When running on C7g instances, we saw 30% improved performance over comparable x86-based instances. Based on these results, we plan to recommend to our customers to run the Beamr JPEGmini software on Graviton3-based instances once those become GA, and we plan to benchmark BeamrÃÂÃÂs H.264 and HEVC video encoders on Graviton instances as well.ÃÂÃÂ About Amazon Web Services For over 15 years, Amazon Web Services has been the worldÃÂÃÂs most comprehensive and broadly adopted cloud offering. AWS has been continually expanding its services to support virtually any cloud workload, and it now has more than 200 fully featured services for compute, storage, databases, networking, analytics, machine learning and artificial intelligence (AI), Internet of Things (IoT), mobile, security, hybrid, virtual and augmented reality (VR and AR), media, and application development, deployment, and management from 84 Availability Zones within 26 geographic regions, with announced plans for 24 more Availability Zones and eight more AWS Regions in Australia, Canada, India, Israel, New Zealand, Spain, Switzerland, and the United Arab Emirates. Millions of customersÃÂÃÂincluding the fastest-growing startups, largest enterprises, and leading government agenciesÃÂÃÂtrust AWS to power their infrastructure, become more agile, and lower costs. To learn more about AWS, visit aws.amazon.com. About Amazon Amazon is guided by four principles: customer obsession rather than competitor focus, passion for invention, commitment to operational excellence, and long-term thinking. Amazon strives to be EarthÃÂÃÂs Most Customer-Centric Company, EarthÃÂÃÂs Best Employer, and EarthÃÂÃÂs Safest Place to Work. Customer reviews, 1-Click shopping, personalized recommendations, Prime, Fulfillment by Amazon, AWS, Kindle Direct Publishing, Kindle, Career Choice, Fire tablets, Fire TV, Amazon Echo, Alexa, Just Walk Out technology, Amazon Studios, and The Climate Pledge are some of the things pioneered by Amazon. For more information, visit amazon.com/about and follow @AmazonNews.",https://www.businesswire.com/news/home/20220523005894/en/AWS-Announces-General-Availability-of-Amazon-EC2-C7g-Instances-Powered-by-AWS-designed-Graviton3-Processors,businesswire.com,5,seattlebusiness wireamazon web service inc aws amazoncom inc company nasdaq amzn today announced general availability amazon elastic compute cloud amazon ec cg instance next generation computeoptimized instance powered awsdesigned graviton processor new cg instance use aws graviton processor provide better compute performance computeintensive application current generation cg instance powered aws graviton processor higher performance cg instance make possible customer run efficiently wide range computeintensive workloadsfrom web server load balancer batch processing electronic design automation eda high performance computing hpc gaming video encoding scientific modeling distributed analytics machine learning inference ad serving minimum commitment upfront fee use cg instance customer pay amount compute used get started cg instance visit awsamazoncomecinstancetypescg since launching amazon ec instance powered awsdesigned graviton processor provided customer significant performance improvement cost saving broad range application today top amazon ec customer use aws gravitonbased instance deliver superior price performance customer customer like directv discovery epic game formula honeycombio intuit lyft mercardo libre nextroll nielsen smugmug snap splunk sprinklr seen significant performance gain reduced cost running aws gravitonbased instance production aws gravitonbased instance portfolio offer different instance include general purpose compute optimized memory optimized storage optimized burstable accelerated computing instance customer deepest broadest choice highperformance costeffective powerefficient compute cloud sort application customer bring computeintensive workload cloud transform organization fuel new opportunity want even better price performance greater energy efficiency running demanding workload provide even better price performance wide variety customer application new cg instance powered next generation aws graviton processor provide better performance computeintensive application current generation cg instance compared previous generation aws graviton processor aws graviton processor deliver x faster performance cryptographic workload x faster performance machine learning inference nearly x higher floating point performance scientific machine learning medium encoding workload aws graviton processor also energy efficient using less energy performance comparable ec instance cg instance first cloud feature latest ddr memory provides higher memory bandwidth aws gravitonbased instance improve performance memoryintensive scientific application like computational fluid dynamic geoscientific simulation seismic processing cg instance also deliver higher networking bandwidth cg instance network intensive application like network load balancing data analytics customer size seeing significant performance gain cost saving using aws gravitonbased instance said david brown vice president amazon ec aws since endtoend chip development process able innovate deliver new instance customer faster better performance current generation graviton instance new cg instance powered aws graviton processor make easy organization get value running infrastructure aws new cg instance built aws nitro system collection awsdesigned hardware software innovation streamline delivery isolated multitenancy private networking fast local storage aws nitro system offloads cpu virtualization storage networking function dedicated hardware software delivering performance nearly indistinguishable bare metal customer looking enhance performance application require parallel processing like hpc video encoding cg instance coming week include support elastic fabric adapter efa allows application communicate directly network interface card providing lower consistent latency cg instance available purchase ondemand instance saving plan reserved instance spot instance cg instance available today u east n virginia u west oregon availability additional aws region coming later year snap inc camera company focused empowering people express live moment learn world fun together trialed new aws gravitonbased amazon ec cg instance found provide significant performance improvement real workload compared previous generation cg instance said aaron sheldon software engineer snap excited migrate gravitonbased workload graviton including messaging storage friend graph workload sprinklr help world biggest company make customer happier across digital channelsusing advanced sophisticated ai engine built enterprise create insightdriven strategy better customer experience run wide variety workload aws gravitonbased instance significant price performance benefit said jamal mazhar vice president infrastructure devops sprinklr announcement aws graviton benchmarked workload new amazon ec cg instance observed better performance compared previous generation instance based result looking forward adopting aws gravitonbased instance production nextroll inc marketing data technology company mission accelerate growth company big small powered machine learning nextrolls technology gather data delivers reliable insight provides business approachable tool target buyer strategic way one platform found aws gravitonbased cg instance ideal bidder ad server elasticache cluster said valentino volonghi cto nextroll seeing request handled cg instance compared aws gravitonbased cg instance cg instance also observed better latency based finding looking forward adopting aws gravitonbased cg instance production ansys global leader engineering simulation engineer designer face increasingly complex problem cloud computing help lower barrier access highperformance computing allowing user solve problem faster said prith banerjee chief technology officer ansys ansys also focusing green computing initiative goal improving energy efficiency reducing cost customer support lsdyna aws graviton processor powered aws ansys customer get best world access worldclass multiphysics solver without compromising speed lower energy cost beamr leading provider image video optimization solution enable professional photographer improve workflow photo sharing service improve user experience ux reduce churn video service provider reduce storage delivery cost beamrs jpegmini software written cc optimizes jpeg image file reducing file size without compromising quality application computeintensive includes function image decoding image encoding quality measure algorithm analyzes various image attribute said dan julius vice president rd beamr since mobile version software run arm processor decided test performance aws gravitonbased amazon ec cg instance rebuilding software run cg instance took u one working day result promising running cg instance saw improved performance comparable xbased instance based result plan recommend customer run beamr jpegmini software gravitonbased instance become ga plan benchmark beamrs h hevc video encoders graviton instance well amazon web service year amazon web service world comprehensive broadly adopted cloud offering aws continually expanding service support virtually cloud workload fully featured service compute storage database networking analytics machine learning artificial intelligence ai internet thing iot mobile security hybrid virtual augmented reality vr ar medium application development deployment management availability zone within geographic region announced plan availability zone eight aws region australia canada india israel new zealand spain switzerland united arab emirate million customersincluding fastestgrowing startup largest enterprise leading government agenciestrust aws power infrastructure become agile lower cost learn aws visit awsamazoncom amazon amazon guided four principle customer obsession rather competitor focus passion invention commitment operational excellence longterm thinking amazon strives earth customercentric company earth best employer earth safest place work customer review click shopping personalized recommendation prime fulfillment amazon aws kindle direct publishing kindle career choice fire tablet fire tv amazon echo alexa walk technology amazon studio climate pledge thing pioneered amazon information visit amazoncomabout follow amazonnews,0.9996,0.4998,0.1746228571,0.3251771429,Positive Impact
24/05/2022,104.025,105.40,101.26,104.10,104.10,102934000,-0.27,-314.4290963,1.192,0,14.33339876,0.959429757,-0.018638346,0.77,292.296,11264.4502,15290.37988,7484.399902,6253.140137,3070.929932,54052.60938,20286.19922,140.7935004,158.5262003,132.2710331,152.2551749,115.7885254,138.2178325,93.35921823,26.97779698,-10.06935986,-10.4619343,0.392574441,6.222214835,115.5630029,9630234000,12.77034282,18.79263708,29.45000076,"Is Amazon's Stock Price Near The Bottom, Or Will It Continue To Drop?","The last time I wrote on Amazon, I described it as being stuck in a technical box. Unfortunately, the resolution was to the downside, and hence, the catastrophic drop in price. Bears point to Amazon's flattening growth and high P/E multiple to suggest more downside in this rising interest rate environment.",https://seekingalpha.com/article/4513875-is-amazon-stock-price-near-bottom-or-will-it-continue-drop,seekingalpha.com,6,last time wrote amazon described stuck technical box unfortunately resolution downside hence catastrophic drop price bear point amazon flattening growth high pe multiple suggest downside rising interest rate environment,-0.5719,-0.34314,0.1272845,-0.4704245,Negative Impact
25/05/2022,103.6555,108.18,103.65,106.78,106.78,93120000,-0.27,-314.4290963,1.192,0,14.33339876,0.959429757,-0.018638346,0.77,292.296,11434.74023,15412.19043,7522.799805,6298.640137,3107.459961,53749.26172,20383.80078,139.9816704,158.2299054,131.2711888,151.8026358,114.2189251,134.3279694,94.10988081,38.12652934,-9.661439338,-10.30183531,0.6403959672,5.770001003,114.9908829,9723354000,30.99969295,21.86783429,28.37000084,Amazon Shareholders Vote Down Warehouse Safety Proposals at Annual Meeting,The shareholders rejected proposals with the potential to analyze and change Amazon's quota system.,https://www.cnet.com/tech/services-and-software/amazon-shareholders-vote-down-warehouse-safety-proposals-at-annual-meeting/,cnet.com,5,shareholder rejected proposal potential analyze change amazon quota system,-0.3818,-0.1909,0.1597533333,-0.350653333,Negative Impact
26/05/2022,107.97,112.67,107.45,111.08,111.08,93002000,-0.27,-314.4290963,1.192,0,14.33339876,0.959429757,-0.018638346,0.77,292.296,11740.65039,15664,7564.899902,6410.580078,3123.110107,54252.53125,20532.19922,139.1411403,157.9622654,130.4792794,151.3974106,112.5429752,126.6975389,98.38841159,45.72624857,-8.888522415,-10.01917273,1.130650312,5.764393398,114.4416477,9816356000,67.5206096,37.09688179,27.5,Amazon Stock Rallied Today -- Here's Why Now Might Be the Time to Buy,Could this be the start of the rebound investors have been waiting for?,https://www.fool.com/investing/2022/05/26/amazon-stock-up-today-why-now-might-be-time-to-buy/,fool.com,7,could start rebound investor waiting,0,0,0.17523,-0.17523,Negative Impact
27/05/2022,113.55,115.19,112.63,115.15,115.15,93660000,-0.27,-314.4290963,1.192,0,14.33339876,0.959429757,-0.018638346,0.77,292.296,12131.12988,15942.62012,7585.5,6515.75,3130.23999,54884.66016,20748.59961,138.2992903,157.7121228,129.8779939,151.036705,112.0862251,125.1969549,98.97549539,57.69402793,-7.857074408,-9.586753063,1.729678655,5.571107592,101.2600021,9910016000,95.50547884,64.67526046,25.71999931,"Walgreens, Amazon and Wawa find success with the most-overlooked unemployed worker","Neurodiverse adults with conditions including autism, ADHD, dyspraxia, dyslexia are finding jobs at businesses large and small, and are an untapped labor pool.",https://www.cnbc.com/2022/05/27/walgreens-amazon-wawa-find-success-with-most-often-unemployed-worker.html,cnbc.com,9,neurodiverse adult condition including autism adhd dyspraxia dyslexia finding job business large small untapped labor pool,0,0,0.22546,-0.22546,Negative Impact
31/05/2022,116.28,121.99,115.68,120.21,120.21,144634000,-0.27,-314.4290963,1.192,0,14.33339876,0.959429757,-0.018638346,0.77,292.296,12081.38965,15827.0498,7607.700195,6468.799805,3186.429932,55566.41016,20729.30078,137.4784703,157.4896778,129.4988374,150.7299667,111.8717003,124.2469624,99.49643817,62.2555756,-6.555534241,-8.980509299,2.424975058,5.669428689,101.538542,10054650000,91.39117758,84.80575534,26.19000053,Why Amazon Is Surging Higher Today,Investors may be betting on a split-induced bump later this week.,https://www.fool.com/investing/2022/05/31/why-amazon-is-surging-higher-today/,fool.com,7,investor may betting splitinduced bump later week,0,0,0.2821671429,-0.282167143,Negative Impact
01/06/2022,122.256,125.18,120.62,121.68,121.68,127528000,-0.27,-314.4290963,1.192,0,14.33339876,0.959429757,-0.018638346,1.21,296.311,11994.45996,15709.61035,7533,6418.890137,3182.159912,55381.17188,20713.69922,136.6823203,157.2733504,129.1923731,150.4409521,111.7432251,123.6205883,99.86586189,68.41291019,-5.343478569,-8.253103153,2.909624584,5.615285601,102.3567803,10182178000,85.38817286,90.76160976,25.69000053,Amazon Stock Is Likely to Recover From Its 2022 Decline Long Term,AMZN stock has suffered through the tech wreck and the more recent retail wreck. There's still plenty of room for optimism.,https://investorplace.com/2022/06/amazon-stock-is-likely-to-recover-from-its-2022-decline-long-term/,investorplace.com,6,amzn stock suffered tech wreck recent retail wreck there still plenty room optimism,-0.6705,-0.4023,0.1984404545,-0.600740455,Negative Impact
02/06/2022,121.684,125.61,120.05,125.51,125.51,100560000,-0.27,-314.4290963,1.192,0,14.33339876,0.959429757,-0.018638346,1.21,296.311,12316.90039,15960.53027,7533,6500.439941,3195.459961,55818.10938,21031.80078,135.8947601,157.0904153,129.0480056,150.1928929,111.7223503,123.4957534,99.94894718,69.951789,-4.027679932,-7.408018509,3.380338577,5.41457149,103.7261135,10282738000,99.59343314,92.12426119,24.71999931,"Amazon is 'obstructing' probe into deadly warehouse collapse, House committee says","Amazon has failed to cooperate with an investigation into its handling of a deadly warehouse collapse, the House Oversight Committee said Thursday.",https://www.cnbc.com/2022/06/02/amazon-obstructing-probe-into-warehouse-collapse-house-committee.html,cnbc.com,9,amazon failed cooperate investigation handling deadly warehouse collapse house oversight committee said thursday,-0.7003,-0.63027,0.06469857143,-0.694968571,Negative Impact
03/06/2022,124.2,124.40,121.05,122.35,122.35,97604000,-0.27,-314.4290963,1.192,0,14.33339876,0.959429757,-0.018638346,1.21,296.311,12012.73047,15797.16992,7533,6485.299805,3195.459961,55769.23047,20790.69922,135.0736,156.9018603,128.7853387,149.9158491,112.0195004,124.5653898,99.47361092,60.65940008,-3.20304387,-6.567023581,3.363979711,5.286785671,105.4768245,10185134000,86.61190004,90.53116868,24.79000092,"Why Nvidia, Amazon, and Apple Stocks Slumped Friday",Fear of a pending recession was just one factor dragging these tech titans lower.,https://www.fool.com/investing/2022/06/03/why-nvidia-amazon-and-apple-stocks-slumped-friday/,fool.com,7,fear pending recession one factor dragging tech titan lower,-0.802,-0.5614,0.08422076923,-0.645620769,Negative Impact
06/06/2022,125.25,128.99,123.81,124.79,124.79,135269000,-0.27,-314.4290963,1.192,0,14.33339876,0.959429757,-0.018638346,1.21,296.311,12061.37012,15848.4502,7608.200195,6548.779785,3236.370117,55675.32031,20819.09961,134.2964099,156.7288728,128.6286587,149.6658407,112.5203754,126.271058,98.76969287,65.95996944,-2.325815491,-5.718781963,3.392966472,5.501178741,107.0874786,10320403000,84.85393412,90.3530891,25.06999969,"Buy AWS, Get Amazon Retail For Free","As previously detailed beforehand, Amazon's 1st quarter would be the worst in its history. Sure enough, it was, and the stock plunged 16% the following day. While revenue came in as expected, the market was spooked by lower operating income, margins and tepid guidance.",https://seekingalpha.com/article/4516679-buy-aws-get-amazon-retail-for-free,seekingalpha.com,6,previously detailed beforehand amazon st quarter would worst history sure enough stock plunged following day revenue came expected market spooked lower operating income margin tepid guidance,-0.5106,-0.30636,0.1396556,-0.4460156,Negative Impact
07/06/2022,122.01,124.10,120.63,123.00,123.00,85156700,-0.27,-314.4290963,1.192,0,14.33339876,0.959429757,-0.018638346,1.21,296.311,12175.23047,16019.55957,7598.899902,6500.350098,3241.76001,55107.33984,20928.19922,133.4609399,156.5438853,128.407927,149.4005089,113.2309254,127.6234512,98.83839958,59.30046687,-1.754815376,-4.925988646,3.17117327,5.441928864,109.2777313,10235246300,78.39882882,83.28822099,24.02000046,Should You Sell Amazon After Its Stock Split?,Are investors overlooking some major risks?,https://www.fool.com/investing/2022/06/07/should-you-sell-amazon-after-its-stock-split/,fool.com,7,investor overlooking major risk,-0.2732,-0.19124,0.1951163636,-0.386356364,Negative Impact
08/06/2022,122.61,123.75,120.75,121.18,121.18,64926600,-0.27,-314.4290963,1.192,0,14.33339876,0.959429757,-0.018638346,1.21,296.311,12086.26953,15843.83008,7593,6448.629883,3263.790039,54892.48828,20792.40039,132.5047301,156.3333178,128.1244789,149.1197079,113.8469753,128.5039048,99.19004585,70.33373997,-1.432637878,-4.227318492,2.794680614,5.004821777,111.2489587,10170319700,71.83554186,78.36276827,23.95999908,Amazon says it prevented 4 billion bad listings in 2021,"Amazon, which has been under increasing pressure to tackle counterfeit products, said in its second-annual report that it prevented 4 billion bad listings from making it onto its site and got rid of more than 3 million phony products last year.",https://techxplore.com/news/2022-06-amazon-billion-bad.html,techxplore.com,5,amazon increasing pressure tackle counterfeit product said secondannual report prevented billion bad listing making onto site got rid million phony product last year,-0.5994,-0.2997,0.2335095238,-0.533209524,Negative Impact
09/06/2022,119.99,121.30,116.10,116.15,116.15,67029800,-0.27,-314.4290963,1.192,0,14.33339876,0.959429757,-0.018638346,1.21,296.311,11754.23047,15472.45996,7476.200195,6358.459961,3238.949951,55320.28125,20563.90039,131.4414301,156.0876228,127.6548916,148.7916511,114.3858753,128.5138021,100.2579485,61.20258488,-1.565146717,-3.694884137,2.12973742,5.101893834,113.0230634,10103289900,53.69634903,67.97690657,26.09000015,"The long awaited U.S. data-privacy bill appears to be on track, again","A new national privacy bill, an essential legislative building block that has proved elusive for years, appears to suddenly be on a fast track in Congress despite years of gridlock for tech regulation.",https://www.marketwatch.com/story/the-long-awaited-u-s-data-privacy-bill-appears-to-be-on-track-again-11654785622,marketwatch.com,8,new national privacy bill essential legislative building block proved elusive year appears suddenly fast track congress despite year gridlock tech regulation,-0.4404,-0.35232,0.2073242857,-0.559644286,Negative Impact
10/06/2022,113.42,114.50,109.05,109.65,109.65,87266000,-0.27,-314.4290963,1.192,0,14.33339876,0.959429757,-0.018638346,1.21,296.311,11340.01953,15096.69043,7317.5,6187.22998,3284.830078,54303.44141,20274.80078,130.3084102,155.8110778,126.9488175,148.4021819,114.5218506,128.397752,100.6459492,52.25554578,-2.169646272,-3.389836564,1.220190292,5.259857723,128.9900055,10016023900,30.25603453,51.92930847,27.75,Exclusive-Former Amazon India seller says antitrust raid illegally detained employees,"A former top seller for Amazon in India, Cloudtail, has accused India's antitrust agency of illegally detaining its employees during a raid over suspected competition law violations, court documents seen by Reuters show.",https://www.reuters.com/world/india/exclusive-former-amazon-india-seller-says-antitrust-raid-illegally-detained-2022-06-10/,reuters.com,10,former top seller amazon india cloudtail accused india antitrust agency illegally detaining employee raid suspected competition law violation court document seen reuters show,-0.5859,-0.5859,0.06122,-0.64712,Negative Impact
13/06/2022,104.19,106.54,101.86,103.67,103.67,99277700,-0.27,-314.4290963,1.192,0,14.33339876,0.959429757,-0.018638346,1.21,296.311,10809.23047,14527.90039,7205.799805,6022.319824,3255.550049,52846.69922,19742.59961,129.1218602,155.5004278,126.0359226,147.9570856,114.0526005,128.7479286,99.35727236,46.23272391,-3.095569026,-3.330983056,0.2354140308,5.46850041,128.5912054,9916746200,8.690933072,30.88110554,34.02000046,What's Going On With Amazon Shares Nosediving Today?,"Amazon.com, Inc (NASDAQ: AMZN) shares are experiencing marked weakness during Monday's trading session, trading lower by 5.03% to $104.13. Shares of companies in the broader consumer discretionary space are trading lower amid overall market weakness following worse-than-expected May CPI data.",https://www.benzinga.com/trading-ideas/movers/22/06/27681557/whats-going-on-with-amazon-shares-nosediving-today,benzinga.com,5,amazoncom inc nasdaq amzn share experiencing marked weakness monday trading session trading lower share company broader consumer discretionary space trading lower amid overall market weakness following worsethanexpected may cpi data,-0.6808,-0.3404,0.08888857143,-0.429288571,Negative Impact
14/06/2022,104.19,104.88,101.43,102.31,102.31,69728800,-0.27,-314.4290963,1.192,0,14.33339876,0.959429757,-0.018638346,1.21,296.311,10828.34961,14444.63965,7187.5,5949.839844,3288.909912,52693.57031,19548.5,127.8968602,155.1745703,125.1054941,147.5028857,113.6275753,129.1841935,98.07095706,48.19162644,-3.894220018,-3.443630449,-0.450589569,5.265143258,127.5219573,9847017400,3.193022815,14.04666347,32.68999863,"AMZN LAWSUIT: The Law Offices of Vincent Wong Notify Investors of a Class Action Lawsuit Involving Amazon.com, Inc","New York, New York--(Newsfile Corp. - June 14, 2022) - The Law Offices of Vincent Wong announce that a class action lawsuit has commenced in the on behalf of investors who purchased Amazon.com, Inc. (""Amazon"") (NASDAQ: AMZN) between February 1, 2019 and April 5, 2022.If you suffered a loss, contact us at the link below. There is no cost or obligation to you.https://www.wongesq.com/pslra-1/amazon-com-inc-loss-submission-form?prid=28578&wire=5",https://www.newsfilecorp.com/release/127751/AMZN-LAWSUIT-The-Law-Offices-of-Vincent-Wong-Notify-Investors-of-a-Class-Action-Lawsuit-Involving-Amazon.com-Inc?utm_source=snapi,newsfilecorp.com,5,new york new yorknewsfile corp june law office vincent wong announce class action lawsuit commenced behalf investor purchased amazoncom inc amazon nasdaq amzn february april suffered loss contact u link cost obligation,-0.6908,-0.3454,0.2609941667,-0.606394167,Negative Impact
15/06/2022,103.86,109.06,103.53,107.67,107.67,85011100,-0.27,-314.4290963,1.192,0,14.33339876,0.959429757,-0.018638346,1.21,296.311,11099.15039,14595.23047,7273.399902,6030.129883,3305.409912,52541.39063,19611.59961,126.6833302,154.8575277,124.4217492,147.1065386,113.2426502,128.9976048,97.48769563,50.85765421,-4.047986757,-3.56450171,-0.483485047,5.424071721,125.9564398,9932028500,22.64149742,11.50848444,29.62000084,"Crushing week for stocks: AMZN -16.8%, NVDA -16.3%, AAPL -10.7%, META -16.3%; What's next?","The mood of market players continues to be pessimistic in the wake of a brutal week for the equities, which.",https://finbold.com/crushing-week-for-stocks-amzn-16-8-nvda-16-3-aapl-10-7-meta-16-3-whats-next/?SNAPI,finbold.com,5,mood market player continues pessimistic wake brutal week equity,-0.765,-0.3825,0.2242544444,-0.606754444,Negative Impact
16/06/2022,104.47,104.58,102.01,103.66,103.66,82186300,-0.27,-314.4290963,1.192,0,14.33339876,0.959429757,-0.018638346,1.21,296.311,10646.09961,14142.19043,7045,5886.240234,3285.379883,51495.78906,19004.09961,125.4754305,154.5081302,123.6075631,146.6742347,113.0700253,129.1794586,96.96059195,42.85191643,-4.442213973,-3.740044163,-0.70216981,5.407607487,124.4848535,9849842200,8.091447522,11.30865592,32.95000076,"Tech Stocks NFLX, AAPL, GOOGL, AMZN, META, TSLA Fall as Recession Fears Grow","Tech stocks are down today as recession fears prompt a selloff. However, others may see this as a buy-the-dip opportunity.",https://investorplace.com/2022/06/tech-stocks-nflx-aapl-googl-amzn-meta-tsla-fall-as-recession-fears-grow/,investorplace.com,6,tech stock today recession fear prompt selloff however others may see buythedip opportunity,-0.4939,-0.29634,0.26045625,-0.55679625,Negative Impact
17/06/2022,102.8,106.98,102.51,106.22,106.22,99772100,-0.27,-314.4290963,1.192,0,14.33339876,0.959429757,-0.018638346,1.21,296.311,10798.34961,14097.0498,7016.299805,5882.649902,3316.790039,51360.42188,18930.5,124.4247105,154.1694802,122.9256979,146.271705,113.0150753,129.2143534,96.81579723,41.14004051,-4.496241599,-3.89128365,-0.604957949,5.433357784,123.1015623,9949614300,17.3802613,16.03773541,31.12999916,Amazon ÃÂÃÂcould run out of people to hire in US by 2024': report,"Amazon is sounding the alarm over an internal memo which estimates that the retail giant could run out of people to hire and man their US-based warehouses within the next 18 months, according to a report. An internal research paper that was viewed by executives at the Seattle-based company warned that failure to replenish the.",https://nypost.com/2022/06/17/amazon-could-run-out-of-people-to-hire-in-us-by-2024-report/,nypost.com,5,amazon sounding alarm internal memo estimate retail giant could run people hire man usbased warehouse within next month according report internal research paper viewed executive seattlebased company warned failure replenish,-0.7269,-0.36345,0.198716,-0.562166,Negative Impact
21/06/2022,108.2,111.63,103.56,108.68,108.68,70901200,-0.27,-314.4290963,1.192,0,14.33339876,0.959429757,-0.018638346,1.21,296.311,11069.2998,14414.25,7152.100098,5964.660156,3306.719971,52532.07031,19257.30078,123.4426205,153.8471002,122.3670431,145.8976582,113.0695251,129.1992096,96.93984071,37.93290796,-4.291092472,-3.971245414,-0.319847057,5.520643507,121.8012686,10020515500,26.30623598,17.25931493,30.19000053,Two top Black executives leave Amazon amid changes in leadership,"Two Black executives at Amazon are leaving the company, the e-commerce juggernaut confirmed Tuesday, hours after CEO Andy Jassy named a new head for the company's troubled retail business.",https://www.marketwatch.com/story/two-top-black-executives-leave-amazon-amid-changes-in-leadership-01655851689,marketwatch.com,8,two black executive amazon leaving company ecommerce juggernaut confirmed tuesday hour ceo andy jassy named new head company troubled retail business,-0.3182,-0.25456,0.2537241176,-0.508284118,Negative Impact
22/06/2022,107.43,112.13,107.02,108.95,108.95,60040100,-0.27,-314.4290963,1.192,0,14.33339876,0.959429757,-0.018638346,1.21,296.311,11053.08008,14352.78027,7089.200195,5916.629883,3267.199951,51822.53125,19004,122.5324106,153.5223377,121.8408845,145.5300198,113.139175,129.180421,97.09792906,36.32752003,-4.059923566,-3.988981045,-0.070942521,5.53067943,120.5789925,10080555600,27.28590431,23.65746719,28.95000076,Here's what's new on Amazon's Prime Video in July 2022,Amazon's Prime Video has a smattering of originals in July 2022 to go along with a huge slate of movie favorites.,https://www.marketwatch.com/story/heres-whats-new-on-amazons-prime-video-in-july-2022-11655940518,marketwatch.com,8,amazon prime video smattering original july go along huge slate movie favorite,0.8074,0.64592,0.2303504348,0.4155695652,Positive Impact
23/06/2022,110.39,113.00,107.93,112.44,112.44,64345300,-0.27,-314.4290963,1.192,0,14.33339876,0.959429757,-0.018638346,1.21,296.311,11232.19043,14402.12012,7020.5,5883.330078,3320.149902,52265.71875,18717.09961,121.7587708,153.2072153,121.4722224,145.2007659,113.5561752,129.031669,98.08068143,35.8633835,-3.554136395,-3.902012115,0.3478757199,5.495322091,119.4300529,10144900900,39.94920197,31.18044742,29.04999924,Cool or creepy? Amazon's Alexa could soon replicate voices of dead people,Amazon's Alexa might soon replicate the voice of family members ÃÂÃÂ even if they're dead.,https://www.marketwatch.com/story/cool-or-creepy-amazons-alexa-could-soon-replicate-voices-of-dead-people-01656017311,marketwatch.com,8,amazon alexa might soon replicate voice family member even theyre dead,-0.5574,-0.44592,0.166269,-0.612189,Negative Impact
24/06/2022,112.38,116.71,111.43,116.46,116.46,69867600,-0.27,-314.4290963,1.192,0,14.33339876,0.959429757,-0.018638346,1.21,296.311,11607.62012,14811.5498,7208.799805,6073.350098,3349.75,52727.98047,19062.90039,121.0722206,152.9081403,121.2756646,144.9147881,114.0404251,129.2258734,98.85497687,43.74601842,-2.796677923,-3.680945276,0.8842673535,5.553571974,118.3500498,10214768500,54.53554409,40.59021679,27.22999954,Amazon Promotes Alexa to Companion From Simple Servant's Role,"Seeing eventual limitations to simply giving Alexa commands ÃÂÃÂ ÃÂÃÂAlexa, buy milk,ÃÂÃÂ ÃÂÃÂAlexa, turn the AC down,ÃÂÃÂ ÃÂÃÂ Amazon's engineers believe the voice recognition AI needs to think for itself. At Amazon's re:MARS event that wraps up Friday (June 24) in Las Vegas after four days of buzz around artificial intelligence (AI), machine learning and robotics, [ÃÂÃÂ]",https://www.pymnts.com/amazon/2022/amazon-promotes-alexa-to-companion-from-simple-servants-role/,pymnts.com,5,seeing eventual limitation simply giving alexa command alexa buy milk alexa turn ac amazon engineer believe voice recognition ai need think amazon remars event wrap friday june la vega four day buzz around artificial intelligence ai machine learning robotics,0.6908,0.3454,0.1150457143,0.2303542857,Positive Impact
27/06/2022,117.09,117.98,112.70,113.22,113.22,62133200,-0.27,-314.4290963,1.192,0,14.33339876,0.959429757,-0.018638346,1.21,296.311,11524.5498,14835.2998,7258.299805,6047.310059,3379.189941,53161.28125,19258.30078,120.2258006,152.6032003,120.9597563,144.5994171,114.1475502,129.2751088,99.01999164,37.92023211,-2.429817948,-3.430719811,1.000901863,5.456429073,101.4300003,10152635300,52.00706602,48.83060403,26.95000076,Why Amazon Stock Slid Today,Worries about a potential recession likely drove Amazon lower today.,https://www.fool.com/investing/2022/06/27/why-amazon-stock-slid-today/,fool.com,7,worry potential recession likely drove amazon lower today,-0.7351,-0.51457,0.117261875,-0.631831875,Negative Impact
28/06/2022,113.5,114.85,107.04,107.40,107.40,74942900,-0.27,-314.4290963,1.192,0,14.33339876,0.959429757,-0.018638346,1.21,296.311,11181.54004,14667.32031,7323.399902,6086.02002,3409.209961,53177.44922,19222.69922,119.3396707,152.2729128,120.4280012,144.2292737,113.7602253,129.1740638,98.34638678,34.97688625,-2.578975288,-3.260370906,0.6813956181,5.717142923,101.7610004,10077692400,26.74731766,44.42997592,28.36000061,Amazon stock falls again after price target cut by 20% at UBS,"Shares of Amazon.com Inc. AMZN, -4.93% slumped 4.8% in afternoon trading Tuesday, adding to Monday's 2.8% drop, after UBS analyst Lloyd Walmsley cut his stock price target to $167 from $209, citing ""some risks"" to the ecommerce and cloud giant's financial outlook depending no the macroeconomic environment. Walmsley lowered his revenue estimate for 2022 to $523.2 billion from $526.7 billion and for 2023 to $598.7 billion from $615.9 billion.",https://www.marketwatch.com/story/amazon-stock-falls-again-after-price-target-cut-by-20-at-ubs-2022-06-28,marketwatch.com,8,share amazoncom inc amzn slumped afternoon trading tuesday adding monday drop ubs analyst lloyd walmsley cut stock price target citing risk ecommerce cloud giant financial outlook depending macroeconomic environment walmsley lowered revenue estimate billion billion billion billion,-0.5574,-0.44592,0.2063173684,-0.652237368,Negative Impact
29/06/2022,107.38,110.99,106.91,108.92,108.92,66375300,-0.27,-314.4290963,1.192,0,14.33339876,0.959429757,-0.018638346,1.21,296.311,11177.88965,14599.58984,7312.299805,6031.47998,3361.52002,53026.96875,19078.59961,118.4623706,151.9532203,119.9767069,143.8779376,113.19575,128.4410941,97.95040596,38.1247529,-2.545193127,-3.11733535,0.5721422234,5.794285366,102.0853804,10144067700,37.69500165,38.81646178,28.15999985,3 Reasons Why Microsoft Is a Stellar Long-Term Hold,"A robust cloud computing service, a beefed-up gaming segment, and strong future growth prospects bode well for the company in the long term.",https://www.zacks.com/stock/news/1945965/3-reasons-why-microsoft-is-a-stellar-long-term-hold,zacks.com,8,robust cloud computing service beefedup gaming segment strong future growth prospect bode well company long term,0.891,0.7128,0.176353125,0.536446875,Positive Impact
30/06/2022,108.11,108.18,102.52,106.21,106.21,97679400,-0.27,-314.4290963,1.192,0,14.33339876,0.959429757,-0.018638346,1.21,296.311,11028.74023,14487.63965,7169.299805,5922.859863,3398.620117,53018.94141,18861.40039,117.4242607,151.6217703,119.436836,143.5031322,112.4220501,127.4222296,97.42187058,39.91885913,-2.705902835,-3.035048847,0.3291460122,5.879999433,102.4032729,10046388300,28.88216252,31.10816061,28.70999908,"Why Amazon, Apple, and Nvidia Are Falling Today",Stubborn inflation is causing these stocks to tumble again today.,https://www.fool.com/investing/2022/06/30/why-amazon-apple-and-nvidia-are-falling-today/,fool.com,7,stubborn inflation causing stock tumble today,-0.4019,-0.28133,0.1652733333,-0.446603333,Negative Impact
01/07/2022,106.29,109.75,105.85,109.56,109.56,73021200,-0.27,-314.4290963,1.192,0,14.33339876,0.959429757,-0.018638346,1.68,296.276,11127.84961,14636.75977,7168.700195,5931.060059,3387.639893,52907.92969,18861.40039,116.5355006,151.3006227,119.049509,143.1653896,111.6244999,125.3352298,97.91376996,49.90248755,-2.533742154,-2.934787509,0.4010453542,5.651428223,102.5199966,10119409500,49.12384142,38.56700186,26.70000076,Go Long Alibaba And Short Amazon,"Amazon and Alibaba are two major e-commerce players. Their business models are somewhat different, however. Amazon is negatively impacted by high inflation that pressures its margins. At the same time, a potential recession and weak consumer sentiment hurt its revenue outlook.",https://seekingalpha.com/article/4521296-long-alibaba-short-amazon-stock,seekingalpha.com,6,amazon alibaba two major ecommerce player business model somewhat different however amazon negatively impacted high inflation pressure margin time potential recession weak consumer sentiment hurt revenue outlook,-0.836,-0.5016,0.1393747059,-0.640974706,Negative Impact
05/07/2022,107.6,114.08,106.32,113.50,113.50,76583700,-0.27,-314.4290963,1.192,0,14.33339876,0.959429757,-0.018638346,1.68,296.276,11322.24023,14499.49023,7025.5,5794.959961,3404.030029,53134.35156,18834.19922,115.8395805,150.9960627,118.8318812,142.8702116,111.182,123.9758275,98.38817247,61.14260383,-2.055681687,-2.758966344,0.7032846575,5.649285453,102.5199966,10195993200,72.9304983,50.31216741,27.54000092,Jim Cramer says investors should eye these three tech names in the Nasdaq 100,"""Tech's become absolutely hated, maybe so hated that I think we could see a serious bounce,"" he said.",https://www.cnbc.com/2022/07/05/jim-cramer-says-investors-should-eye-these-three-tech-names-in-the-nasdaq-100-.html,cnbc.com,9,tech become absolutely hated maybe hated think could see serious bounce said,-0.883,-0.7947,0.103666875,-0.898366875,Negative Impact
06/07/2022,113.21,115.48,112.01,114.33,114.33,66958900,-0.27,-314.4290963,1.192,0,14.33339876,0.959429757,-0.018638346,1.68,296.276,11361.84961,14465.29004,7107.799805,5912.379883,3355.350098,53750.96875,18729.69922,115.2391805,150.7020827,118.6553369,142.5862294,110.659,121.8675611,99.45043889,63.79073884,-1.591495343,-2.525472144,0.9339768009,5.650714329,102.8291968,10262952100,77.1446384,66.39965937,26.72999954,German antitrust watchdog subjects Amazon to stricter supervision rules,"BERLIN (Reuters) -Germany's antitrust watchdog said on Wednesday that U.S. ecommerce giant Amazon's position is of outstanding, cross-market importance for competition, a classification that allows the authority to prohibit any anti-competitive behaviour at an earlier stage.",https://www.reuters.com/business/german-antitrust-watchdog-subjects-amazon-stricter-supervision-rules-2022-07-06/,reuters.com,10,berlin reuters germany antitrust watchdog said wednesday u ecommerce giant amazon position outstanding crossmarket importance competition classification allows authority prohibit anticompetitive behaviour earlier stage,0.8176,0.8176,0.1280109091,0.6895890909,Positive Impact
07/07/2022,113.85,116.99,113.49,116.33,116.33,57872300,-0.27,-314.4290963,1.192,0,14.33339876,0.959429757,-0.018638346,1.68,296.276,11621.34961,14676.5,7189.100098,6006.700195,3364.399902,54178.46094,19063.19922,114.6443004,150.4448002,118.5641473,142.3249734,110.3255001,120.3190432,100.331957,60.76579648,-1.050135725,-2.23040486,1.180269135,5.418571472,103.1322129,10320824400,89.66811897,79.91441856,26.07999992,Amazon stock rallies toward 1st close above the 50-day moving average in 2 1/2 months,"Shares of Amazon.com Inc. AMZN, +1.87% rallied 2.0% in afternoon trading Thursday, putting them on track to close above its 50-day moving average (DMA), which many chart watchers view as a short-term trend tracker, for the first time since April 19. The 50-DMA came in at $114.65 on Thursday according to FactSet, the lowest reading for the trend tracker since June 4, 2020.",https://www.marketwatch.com/story/amazon-stock-rallies-toward-1st-close-above-the-50-day-moving-average-in-2-12-months-2022-07-07,marketwatch.com,8,share amazoncom inc amzn rallied afternoon trading thursday putting track close day moving average dma many chart watcher view shortterm trend tracker first time since april dma came thursday according factset lowest reading trend tracker since june,-0.1027,-0.08216,0.2985685714,-0.380728571,Negative Impact
08/07/2022,114.6,116.58,113.69,115.54,115.54,45719700,-0.27,-314.4290963,1.192,0,14.33339876,0.959429757,-0.018638346,1.68,296.276,11635.30957,14642.33008,7196.200195,6033.129883,3356.080078,54481.83984,19022.90039,114.1672803,150.1865927,118.4455534,142.0584563,110.0435001,119.0132405,101.0737597,66.05405365,-0.677046232,-1.919733135,1.242686903,5.220714569,103.4291687,10275104700,84.22752263,83.68009334,24.63999939,This Emerging Tech Is the ÃÂÃÂInflation Killer',Advanced supply chain localization via automation could turn today's inflation situation into a win-win for businesses and consumers. The post This Emerging Tech Is the ÃÂÃÂInflation Killer' appeared first on InvestorPlace.,https://investorplace.com/hypergrowthinvesting/2022/07/this-emerging-tech-is-the-inflation-killer/,investorplace.com,6,advanced supply chain localization via automation could turn today inflation situation winwin business consumer post emerging tech inflation killer appeared first investorplace,-0.5106,-0.30636,0.113045,-0.419405,Negative Impact
11/07/2022,114.08,114.30,110.87,111.75,111.75,53487600,-0.27,-314.4290963,1.192,0,14.33339876,0.959429757,-0.018638346,1.68,296.276,11372.59961,14502.42969,7196.600098,5996.299805,3313.580078,54395.23047,18816.80078,113.6389401,149.9003302,118.1829826,141.7568796,109.8235001,118.36839,101.2786101,57.2325391,-0.679360278,-1.671658563,0.9922982856,5.235000065,103.7201854,10221617100,59.70245374,77.86603178,26.17000008,An Incredible Stock Market Money-Maker Formed Amid the Chaos,"Divergence, an ultra-rare stock market phenomenon, can give you a real shot at turning $10,000 investments into multi-million-dollar paydays. The post An Incredible Stock Market Money-Maker Formed Amid the Chaos appeared first on InvestorPlace.",https://investorplace.com/hypergrowthinvesting/2022/07/an-incredible-stock-market-money-making-opportunity-is-fast-approaching/,investorplace.com,6,divergence ultrarare stock market phenomenon give real shot turning investment multimilliondollar payday post incredible stock market moneymaker formed amid chaos appeared first investorplace,-0.5719,-0.34314,0.1666425,-0.5097825,Negative Impact
12/07/2022,112.16,113.23,108.34,109.22,109.22,54280300,-0.27,-314.4290963,1.192,0,14.33339876,0.959429757,-0.018638346,1.68,296.276,11264.73047,14395.04004,7209.899902,6044.200195,3281.469971,53886.60938,18678.59961,112.9314102,149.5924302,117.8314932,141.4331296,109.802,118.350891,101.2531091,50.70496211,-0.875254543,-1.512377759,0.6371232159,5.007857731,104.0053818,10167336800,43.33765633,62.42254423,27.29000092,Outrun a Bear Market with Sector Rotation,The dreaded bear market implies an economic recession led by a falling stock market.,https://www.marketbeat.com/originals/outrun-a-bear-market-with-sector-rotation/?SNAPI,marketbeat.com,5,dreaded bear market implies economic recession led falling stock market,-0.7964,-0.3982,0.1847222727,-0.582922273,Negative Impact
13/07/2022,107.03,111.78,106.01,110.40,110.40,61353800,-0.27,-314.4290963,1.192,0,14.33339876,0.959429757,-0.018638346,1.68,296.276,11247.58008,14340.28027,7156.399902,6000.240234,3284.290039,53514.14844,18615.19922,112.6537802,149.2880502,117.5400621,141.1243422,110.1385002,118.1862303,102.0907701,51.84902399,-0.924627467,-1.394827701,0.4702002335,5.055000305,104.2848742,10228690600,50.97025524,51.33678844,26.81999969,Amazon has handed Ring video footage to police without user consent,"Amazon has provided Ring doorbell footage to law enforcement 11 times this year without the user's permission, a revelation that's bound to raise more privacy and civil liberty concerns about its video-sharing agreements with police departments across the country.",https://www.marketwatch.com/story/amazon-has-handed-ring-video-footage-to-police-without-user-consent-01657758401,marketwatch.com,8,amazon provided ring doorbell footage law enforcement time year without user permission revelation thats bound raise privacy civil liberty concern videosharing agreement police department across country,0.8074,0.64592,0.2345076471,0.4114123529,Positive Impact
14/07/2022,110.24,111.18,107.58,110.63,110.63,51163100,-0.27,-314.4290963,1.192,0,14.33339876,0.959429757,-0.018638346,1.68,296.276,11251.19043,14171.24023,7039.799805,5915.410156,3281.73999,53416.14844,18329.09961,112.3763802,148.9897502,117.2690792,140.8209159,110.5545002,117.7089365,103.4000639,47.48260678,-0.934425655,-1.302747292,0.3683216366,4.950000218,104.5587768,10279853700,52.45793718,48.92194958,26.39999962,Amazon is reducing its private-label items - WSJ,"Amazon.com Inc has started reducing the number of items it sells under its own brands amid weak sales, the Wall Street Journal reported on Thursday, citing people familiar with the matter.",https://www.reuters.com/technology/amazon-is-reducing-its-private-label-items-wsj-2022-07-15/,reuters.com,10,amazoncom inc started reducing number item sell brand amid weak sale wall street journal reported thursday citing people familiar matter,-0.3612,-0.3612,0.1957714286,-0.556971429,Negative Impact
15/07/2022,112.5,115.59,111.59,113.55,113.55,84317800,-0.27,-314.4290963,1.192,0,14.33339876,0.959429757,-0.018638346,1.68,296.276,11452.41992,14449.67969,7159,6036,3228.060059,53760.78125,18394.5,112.1623102,148.7285102,117.1232331,140.5495635,110.8485004,117.9870875,103.7099134,45.82496964,-0.698518637,-1.181901561,0.4833829238,4.927143097,104.8272013,10364171500,71.34541797,58.25787013,24.22999954,Ranking Recession Readiness: Is Amazon Prepared For A Recession?,"Ranking Recession Readiness is a series considering how prepared the top 100 U.S. Firms are to face a prolonged and damaging recession. Research and advice from the 2008 Great Recession recommended firms carefully manage debt, build cash stockpiles and monitor liquidity before a recession hits.",https://seekingalpha.com/article/4523688-ranking-recession-readiness-is-amazon-prepared-for-recession,seekingalpha.com,6,ranking recession readiness series considering prepared top u firm face prolonged damaging recession research advice great recession recommended firm carefully manage debt build cash stockpile monitor liquidity recession hit,-0.7096,-0.42576,0.1308966667,-0.556656667,Negative Impact
18/07/2022,115,117.24,113.15,113.76,113.76,59115400,-0.27,-314.4290963,1.192,0,14.33339876,0.959429757,-0.018638346,1.68,296.276,11360.0498,14403.17969,7223.200195,6091.910156,3278.100098,54521.14844,18595.59961,111.9189403,148.4720302,116.9913417,140.2830007,111.3535004,117.7403145,104.9666862,50.84852439,-0.488978811,-1.043317011,0.5543381998,4.842142378,105.0902574,10423286900,76.35872664,66.72069393,25.29999924,Amazon takes on Britain's Tesco with price match scheme,"Amazon, seeking an edge amid a deteriorating cost of living crisis, will match UK grocery market leader Tesco's prices on hundreds of products, it said on Monday.",https://www.reuters.com/business/retail-consumer/amazon-takes-britains-tesco-with-price-match-scheme-2022-07-18/,reuters.com,10,amazon seeking edge amid deteriorating cost living crisis match uk grocery market leader tescos price hundred product said monday,-0.5267,-0.5267,0.008010769231,-0.534710769,Negative Impact
19/07/2022,115.7,118.95,114.03,118.21,118.21,60990000,-0.27,-314.4290963,1.192,0,14.33339876,0.959429757,-0.018638346,1.68,296.276,11713.15039,14766.59961,7296.299805,6201.220215,3279.429932,54767.62109,18937.69922,111.9550003,148.2418202,117.0391321,140.0633689,111.9530003,118.5581001,105.3479004,67.75040828,0.03574848787,-0.827503911,0.8632523989,4.654999324,105.3480523,10484276900,95.49605691,81.06673384,24.5,Amazon nimmt Fake Rezensions-BetrÃÂÃÂ¼ger in Social Media ins Visier,"SEATTLE--(BUSINESS WIRE)--Amazon hat heute rechtliche Schritte gegen die Administratoren von mehr als 10.000 Facebook-Gruppen eingeleitet, die versuchen, gefÃÂÃÂ¤lschte Bewertungen bei Amazon im Austausch gegen Geld oder kostenlose Produkte zu verbreiten. Diese Gruppen wurden mit dem Ziel eingerichtet, Personen zu rekrutieren, die bereit sind, gekaufte und irrefÃÂÃÂ¼hrende Rezensionen in Amazons Stores in den USA, im Vereinigten KÃÂÃÂ¶nigreich, Deutschland, Frankreich, Italien, Spanien und Japan zu verÃÂÃÂ¶ffentlichen. Amazon wird die im Rahmen dieser Klage erlangten Informationen nutzen, um Akteure mit schlechten Absichten zu identifizieren und die von ihnen in Auftrag gegebenen gefÃÂÃÂ¤lschten Bewertungen zu entfernen, sofern diese nicht bereits von Amazons fortschrittlicher Technologie, den erfahrenen PrÃÂÃÂ¼fteams und im Rahmen der kontinuierlichen Untersuchungen entdeckt wurden. ÃÂÃÂUnsere Teams stoppen Millionen verdÃÂÃÂ¤chtiger Bewertungen, bevor sie jemals von Kund:innen gesehen werden. Und diese Klage geht noch einen Schritt weiter, um TÃÂÃÂ¤ter in den sozialen Medien zu enttarnenÃÂÃÂ, sagte Dharmesh Mehta, Amazons Vice President Selling Partner Services. ÃÂÃÂProaktives rechtliches Vorgehen ist eine von vielen unserer MaÃÂÃÂnahmen, um Kund:innen zu schÃÂÃÂ¼tzen und Akteure mit schlechten Absichten zur Verantwortung zu ziehen.ÃÂÃÂ Die fÃÂÃÂ¼r solche Gruppen verantwortlichen Drahtzieher werben um gefÃÂÃÂ¤lschte Bewertungen fÃÂÃÂ¼r Hunderte von Produkten, die bei Amazon zum Verkauf stehen. Darunter etwa Autoradios und Kamerastative. Eine der Gruppen, die in der Klage genannt werden, ist ÃÂÃÂAmazon Product ReviewÃÂÃÂ, die ÃÂÃÂ¼ber 43.000 Mitglieder hatte, bis Meta die Gruppe Anfang des Jahres lÃÂÃÂ¶schte. Die Untersuchungen von Amazon haben ergeben, dass die Gruppenadministratoren versuchten, ihre AktivitÃÂÃÂ¤ten zu verbergen und der Erkennung durch Facebook zu entgehen, indem sie zum Teil Buchstaben aus problematischen SÃÂÃÂ¤tzen verschleiern. Amazon verbietet gefÃÂÃÂ¤lschte Rezensionen strikt und beschÃÂÃÂ¤ftigt mehr als 12.000 Mitarbeiter:innen auf der ganzen Welt, die sich dem Schutz der Stores vor Betrug und Missbrauch widmen ÃÂÃÂ einschlieÃÂÃÂlich gefÃÂÃÂ¤lschter Rezensionen. Ein spezialisiertes Team untersucht Machenschaften in Bezug auf gefÃÂÃÂ¤lschte Rezensionen bei Facebook, Instagram, TikTok, Twitter und anderen Social Media-Seiten und meldet die missbrÃÂÃÂ¤uchlichen Gruppen regelmÃÂÃÂ¤ÃÂÃÂig an diese Unternehmen. Seit 2020 hat Amazon mehr als 10.000 Gruppen fÃÂÃÂ¼r gefÃÂÃÂ¤lschte Bewertungen an Meta gemeldet. Mehr als die HÃÂÃÂ¤lfte von diesen hat Meta wegen VerstÃÂÃÂ¶ÃÂÃÂen gegen die Richtlinien entfernt, andere werden weiter untersucht. Amazon war ein Pionier in Sachen Produktrezensionen und fÃÂÃÂ¼hrte sie 1995 ein, um den Kund:innen zu helfen, fundiertere Kaufentscheidungen zu treffen. Das Unternehmen mÃÂÃÂ¶chte sicherstellen, dass jede Bewertung, die in den Stores erscheint, vertrauenswÃÂÃÂ¼rdig ist und eine tatsÃÂÃÂ¤chliche Erfahrung von Kund:innen widerspiegelt. Amazons Expert:innen verwenden branchenfÃÂÃÂ¼hrende Tools, um gefÃÂÃÂ¤lschte Rezensionen zu erkennen und zu blockieren. So konnte Amazon allein im Jahr 2020 mehr als 200 Millionen mutmaÃÂÃÂlich gefÃÂÃÂ¤lschte Rezensionen proaktiv stoppen. Die heutigen rechtlichen Schritte sind die jÃÂÃÂ¼ngsten BemÃÂÃÂ¼hungen von Amazon, betrÃÂÃÂ¼gerische Versuche zu stoppen, gefÃÂÃÂ¤lschte Bewertungen in Amazons Stores zu verÃÂÃÂ¶ffentlichen. Im vergangenen Jahr hat Amazon das GeschÃÂÃÂ¤ft mehrerer groÃÂÃÂer Anbieter gefÃÂÃÂ¤lschter Rezensionen durch rechtliche Schritte unterbunden ÃÂÃÂ sie hatten es auf Kund:innen in den USA, im Vereinigten KÃÂÃÂ¶nigreich, Deutschland, Frankreich, Italien und Spanien abgesehen. Das dreiste GeschÃÂÃÂ¤ft mit der Vermittlung gefÃÂÃÂ¤lschter Rezensionen ist jedoch nach wie vor ein branchenweites Problem und Zivilklagen sind nur ein Schritt von vielen. Um gefÃÂÃÂ¤lschte Bewertungen im Einzelhandel, in der Reisebranche und in anderen Industriezweigen dauerhaft aus der Welt zu schaffen, bedarf es einer intensiveren Partnerschaft von privatem und ÃÂÃÂ¶ffentlichem Sektor, einschlieÃÂÃÂlich der Zusammenarbeit betroffener Unternehmen, Social-Media-Seiten und StrafverfolgungsbehÃÂÃÂ¶rden, die alle das Ziel eint, Verbraucher:innen besser zu schÃÂÃÂ¼tzen. Amazon bleibt weiterhin darauf erpicht, mit allen relevanten Interessengruppen zusammenzuarbeiten, um dieses gemeinsame Ziel zu erreichen. ÃÂÃÂber Amazon Amazon wird von vier Grundprinzipien geleitet: Fokus auf Kund:innen statt auf den Wettbewerb, Leidenschaft fÃÂÃÂ¼rs Erfinden, Verpflichtung zu operativer Exzellenz und langfristiges Denken. Amazon strebt danach, das kundenorientierteste Unternehmen, der beste Arbeitgeber und der sicherste Arbeitsplatz der Welt zu sein. Kundenrezensionen, 1-Click-Shopping, personalisierte Empfehlungen, Prime, Versand durch Amazon, AWS, Kindle Direct Publishing, Kindle, Fire Tablets, Fire TV, Amazon Echo, Alexa, Just-Walk-Out-Technologie, Amazon Studios und The Climate Pledge sind nur einige Beispiele, fÃÂÃÂ¼r die Amazon Pionierarbeit geleistet hat. Mehr Informationen auf www.aboutamazon.de und auf Twitter unter @AmazonNewsDE.",https://www.businesswire.com/news/home/20220718005748/de/,businesswire.com,5,seattlebusiness wireamazon hat heute rechtliche schritte gegen die administratoren von mehr al facebookgruppen eingeleitet die versuchen geflschte bewertungen bei amazon im austausch gegen geld oder kostenlose produkte zu verbreiten diese gruppen wurden mit dem ziel eingerichtet personen zu rekrutieren die bereit sind gekaufte und irrefhrende rezensionen amazon store den usa im vereinigten knigreich deutschland frankreich italien spanien und japan zu verffentlichen amazon wird die im rahmen dieser klage erlangten informationen nutzen um akteure mit schlechten absichten zu identifizieren und die von ihnen auftrag gegebenen geflschten bewertungen zu entfernen sofern diese nicht bereits von amazon fortschrittlicher technologie den erfahrenen prfteams und im rahmen der kontinuierlichen untersuchungen entdeckt wurden unsere team stoppen millionen verdchtiger bewertungen bevor sie jemals von kundinnen gesehen werden und diese klage geht noch einen schritt weiter um tter den sozialen medien zu enttarnen sagte dharmesh mehta amazon vice president selling partner service proaktives rechtliches vorgehen ist eine von vielen unserer manahmen um kundinnen zu schtzen und akteure mit schlechten absichten zur verantwortung zu ziehen die fr solche gruppen verantwortlichen drahtzieher werben um geflschte bewertungen fr hunderte von produkten die bei amazon zum verkauf stehen darunter etwa autoradios und kamerastative eine der gruppen die der klage genannt werden ist amazon product review die ber mitglieder hatte bi meta die gruppe anfang de jahres lschte die untersuchungen von amazon haben ergeben das die gruppenadministratoren versuchten ihre aktivitten zu verbergen und der erkennung durch facebook zu entgehen indem sie zum teil buchstaben au problematischen stzen verschleiern amazon verbietet geflschte rezensionen strikt und beschftigt mehr al mitarbeiterinnen auf der ganzen welt die sich dem schutz der store vor betrug und missbrauch widmen einschlielich geflschter rezensionen ein spezialisiertes team untersucht machenschaften bezug auf geflschte rezensionen bei facebook instagram tiktok twitter und anderen social mediaseiten und meldet die missbruchlichen gruppen regelmig diese unternehmen seit hat amazon mehr al gruppen fr geflschte bewertungen meta gemeldet mehr al die hlfte von diesen hat meta wegen versten gegen die richtlinien entfernt andere werden weiter untersucht amazon war ein pionier sachen produktrezensionen und fhrte sie ein um den kundinnen zu helfen fundiertere kaufentscheidungen zu treffen da unternehmen mchte sicherstellen das jede bewertung die den store erscheint vertrauenswrdig ist und eine tatschliche erfahrung von kundinnen widerspiegelt amazon expertinnen verwenden branchenfhrende tool um geflschte rezensionen zu erkennen und zu blockieren konnte amazon allein im jahr mehr al millionen mutmalich geflschte rezensionen proaktiv stoppen die heutigen rechtlichen schritte sind die jngsten bemhungen von amazon betrgerische versuche zu stoppen geflschte bewertungen amazon store zu verffentlichen im vergangenen jahr hat amazon da geschft mehrerer groer anbieter geflschter rezensionen durch rechtliche schritte unterbunden sie hatten e auf kundinnen den usa im vereinigten knigreich deutschland frankreich italien und spanien abgesehen da dreiste geschft mit der vermittlung geflschter rezensionen ist jedoch nach wie vor ein branchenweites problem und zivilklagen sind nur ein schritt von vielen um geflschte bewertungen im einzelhandel der reisebranche und anderen industriezweigen dauerhaft au der welt zu schaffen bedarf e einer intensiveren partnerschaft von privatem und ffentlichem sektor einschlielich der zusammenarbeit betroffener unternehmen socialmediaseiten und strafverfolgungsbehrden die alle da ziel eint verbraucherinnen besser zu schtzen amazon bleibt weiterhin darauf erpicht mit allen relevanten interessengruppen zusammenzuarbeiten um diesis gemeinsame ziel zu erreichen ber amazon amazon wird von vier grundprinzipien geleitet fokus auf kundinnen statt auf den wettbewerb leidenschaft fr erfinden verpflichtung zu operativer exzellenz und langfristiges denken amazon strebt danach da kundenorientierteste unternehmen der beste arbeitgeber und der sicherste arbeitsplatz der welt zu sein kundenrezensionen clickshopping personalisierte empfehlungen prime versand durch amazon aws kindle direct publishing kindle fire tablet fire tv amazon echo alexa justwalkouttechnologie amazon studio und climate pledge sind nur einige beispiele fr die amazon pionierarbeit geleistet hat mehr informationen auf und auf twitter unter amazonnewsde,-0.9972,-0.4986,0.1367260714,-0.635326071,Negative Impact
20/07/2022,118.62,123.48,118.32,122.77,122.77,71268300,-0.27,-314.4290963,1.192,0,14.33339876,0.959429757,-0.018638346,1.68,296.276,11897.65039,14778.46973,7264.299805,6184.660156,3304.719971,55397.53125,19020.69922,112.1149503,148.0348552,117.2638719,139.8912955,112.6575001,120.6522137,104.6627864,70.67781331,0.8102127183,-0.499960585,1.310173304,4.740000044,105.8921301,10555545200,96.61256447,89.48911601,23.87999916,"Glancy Prongay & Murray LLP, a Leading Securities Fraud Law Firm, Announces Investigation of Amazon.com, Inc. (AMZN) on Behalf of Investors","LOS ANGELES--(BUSINESS WIRE)--Glancy Prongay & Murray LLP (ÃÂÃÂGPMÃÂÃÂ), a leading national shareholder rights law firm, today announced that it has commenced an investigation on behalf of Amazon.com, Inc. (ÃÂÃÂAmazonÃÂÃÂ or the ÃÂÃÂCompanyÃÂÃÂ) (NASDAQ: AMZN) investors concerning the Company's possible violations of the federal securities laws. If you suffered a loss on your Amazon investments or would like to inquire about potentially pursuing claims to recover your loss under the federal securities laws,",https://www.businesswire.com/news/home/20220720005138/en/Glancy-Prongay-Murray-LLP-a-Leading-Securities-Fraud-Law-Firm-Announces-Investigation-of-Amazon.com-Inc.-AMZN-on-Behalf-of-Investors/,businesswire.com,5,los angelesbusiness wireglancy prongay murray llp gpm leading national shareholder right law firm today announced commenced investigation behalf amazoncom inc amazon company nasdaq amzn investor concerning company possible violation federal security law suffered loss amazon investment would like inquire potentially pursuing claim recover loss federal security law,-0.3182,-0.1591,0.24154,-0.40064,Negative Impact
21/07/2022,123.2,124.85,121.26,124.63,124.63,60239900,-0.27,-314.4290963,1.192,0,14.33339876,0.959429757,-0.018638346,1.68,296.276,12059.61035,14871.12988,7270.5,6201.109863,3272,55681.94922,19062.90039,112.4317702,147.8605602,117.5527396,139.7394418,113.4415001,122.8548205,104.0281797,78.21690949,1.556129612,-0.088742546,1.644872158,4.539285387,106.9474025,10615785100,98.84209884,96.98357341,23.11000061,Jim Cramer offers his favorite stock picks for 3 possible recession scenarios,"""We've got mild, we've got moderate and we've got severe,"" the ""Mad Money"" host said.",https://www.cnbc.com/2022/07/21/jim-cramer-offers-his-favorite-stock-picks-for-3-possible-recession-scenarios.html,cnbc.com,9,weve got mild weve got moderate weve got severe mad money host said,-0.7003,-0.63027,0.2243242222,-0.854594222,Negative Impact
22/07/2022,125.01,125.50,121.35,122.42,122.42,51463800,-0.27,-314.4290963,1.192,0,14.33339876,0.959429757,-0.018638346,1.68,296.276,11834.11035,14790.79004,7276.399902,6216.819824,3269.969971,56072.23047,18982.90039,112.7029901,147.6674102,117.7436125,139.567109,113.9404999,124.1543272,103.7266726,70.41269938,1.94650754,0.3183074714,1.628200069,4.55714253,108.3796101,10564321300,84.19701299,93.21722543,23.03000069,"Glancy Prongay & Murray LLP, a Leading Securities Fraud Law Firm, Announces the Filing of a Securities Class Action on Behalf of Amazon.com, Inc. (AMZN) Investors","LOS ANGELES--(BUSINESS WIRE)--Glancy Prongay & Murray LLP (ÃÂÃÂGPMÃÂÃÂ), a leading national shareholder rights law firm, announces that a class action lawsuit has been filed on behalf of investors who purchased or otherwise acquired Amazon.com, Inc. (ÃÂÃÂAmazonÃÂÃÂ or the ÃÂÃÂCompanyÃÂÃÂ) (NASDAQ: AMZN) common stock between July 30, 2021 and April 28, 2022, inclusive (the ÃÂÃÂClass PeriodÃÂÃÂ). Amazon investors have until September 6, 2022 to file a lead plaintiff motion. If you suffered a loss on your Amazon inve",https://www.businesswire.com/news/home/20220722005088/en/Glancy-Prongay-Murray-LLP-a-Leading-Securities-Fraud-Law-Firm-Announces-the-Filing-of-a-Securities-Class-Action-on-Behalf-of-Amazon.com-Inc.-AMZN-Investors/,businesswire.com,5,los angelesbusiness wireglancy prongay murray llp gpm leading national shareholder right law firm announces class action lawsuit filed behalf investor purchased otherwise acquired amazoncom inc amazon company nasdaq amzn common stock july april inclusive class period amazon investor september file lead plaintiff motion suffered loss amazon inve,-0.5106,-0.2553,0.176305,-0.431605,Negative Impact
25/07/2022,122.7,123.64,120.03,121.14,121.14,50221300,-0.27,-314.4290963,1.192,0,14.33339876,0.959429757,-0.018638346,1.68,296.276,11782.66992,14899.08984,7306.299805,6237.549805,3250.389893,55766.21875,19104.5,113.0183501,147.4576077,117.8768041,139.3837547,114.1744999,124.8359955,103.5130043,63.245493,2.128068607,0.6802596984,1.447808908,4.26071385,110.0916491,10514100000,77.62954803,86.88955329,23.36000061,Amazon earnings preview: Recession fears could drive discounts for Amazon's cloud computing services,"With recession fears looming, Amazon.com Inc.'s cloud service business could be under pressure warns Mizuho Securities analysts in a note heading into the tech giant's second-quarter earnings announcement scheduled for Thursday.",https://www.marketwatch.com/story/amazon-earnings-preview-recession-fears-could-drive-discounts-for-amazons-cloud-computing-services-11658775658,marketwatch.com,8,recession fear looming amazoncom inc cloud service business could pressure warns mizuho security analyst note heading tech giant secondquarter earnings announcement scheduled thursday,-0.7717,-0.61736,0.1407938889,-0.758153889,Negative Impact
26/07/2022,115.79,118.15,114.53,114.81,114.81,67075100,-0.27,-314.4290963,1.192,0,14.33339876,0.959429757,-0.018638346,1.68,296.276,11562.57031,14793.5498,7306.299805,6211.450195,3277.439941,55268.48828,18972.69922,113.1759401,147.2060502,117.7565372,139.1392397,114.2539997,124.9092376,103.5987618,50.69888727,1.7411084,0.8924294388,0.8486789615,4.48499952,111.6324842,10447024900,45.15134113,68.99263405,24.69000053,"Stock Market Investing Action Plan: Fed Vote, Apple, Amazon, Google Earnings","A crushing week of stock market news with the Federal Reserve rate decision, and earnings from nearly half of the 30 Dow stocks due. The post Stock Market Investing Action Plan: Fed Vote, Apple, Amazon, Google Earnings appeared first on Investor's Business Daily.",https://www.investors.com/research/investing-action-plan/stock-market-investing-action-plan-fed-vote-apple-amazon-google-earnings/,investors.com,5,crushing week stock market news federal reserve rate decision earnings nearly half dow stock due post stock market investing action plan fed vote apple amazon google earnings appeared first investor business daily,-0.2023,-0.10115,0.2474133333,-0.348563333,Negative Impact
27/07/2022,117.31,121.90,117.16,120.97,120.97,61582000,-0.27,-314.4290963,1.192,0,14.33339876,0.959429757,-0.018638346,1.68,296.276,12032.41992,15031.04004,7348.200195,6257.939941,3275.76001,55816.32031,19254.59961,113.3342401,146.9887452,117.8825554,138.9584513,114.9324997,125.4777116,104.3872878,56.02597323,1.909489062,1.095841363,0.8136476985,4.741428375,113.0192358,10508606900,76.75731516,66.51273477,23.23999977,Will Amazon Show Renewed Momentum With Second-Quarter Earnings Report?,Will the Amazon earnings report show renewed momentum after back-to-back quarters of disappointing results by the e-commerce giant? The post Will Amazon Show Renewed Momentum With Second-Quarter Earnings Report?,https://www.investors.com/news/technology/amazon-earnings-report-second-quarter-thursday/,investors.com,5,amazon earnings report show renewed momentum backtoback quarter disappointing result ecommerce giant post amazon show renewed momentum secondquarter earnings report,-0.2023,-0.10115,0.2508085714,-0.351958571,Negative Impact
28/07/2022,121.57,122.84,118.08,122.28,122.28,82245500,-0.27,-314.4290963,1.192,0,14.33339876,0.959429757,-0.018638346,1.68,296.276,12162.58984,15198.80957,7345.299805,6339.209961,3282.580078,56857.78906,19456.69922,113.5636301,146.7885702,118.0550042,138.7924965,115.6004997,126.2342908,104.9667087,58.63659462,2.124151903,1.301503471,0.8226484319,4.874999455,114.2673122,10590852400,83.47869896,68.46245175,22.32999992,Amazon workers in Illinois file complaints with the EEOC alleging racist work environment,"Twenty-six workers at an Amazon facility in Joliet, Illinois, have filed complaints with the U.S. Equal Employment Opportunity Commission alleging a racist workplace environment and retaliation against an employee who spoke up, their lawyer said Wednesday.",https://techxplore.com/news/2022-07-amazon-workers-illinois-complaints-eeoc.html,techxplore.com,5,twentysix worker amazon facility joliet illinois filed complaint u equal employment opportunity commission alleging racist workplace environment retaliation employee spoke lawyer said wednesday,-0.4019,-0.20095,0.2880533333,-0.489003333,Negative Impact
29/07/2022,134.9,137.65,132.41,134.95,134.95,148892900,-0.27,-314.4290963,1.192,0,14.33339876,0.959429757,-0.018638346,1.68,296.276,12390.69043,15327.70996,7423.399902,6448.5,3253.23999,57570.25,19692.90039,113.95526,146.6514877,118.7175529,138.7542627,117.0374996,129.8687144,104.2062848,74.2171189,3.278840286,1.696970834,1.581869452,5.639284951,115.390581,10739745300,91.46650553,83.90083988,21.32999992,Apple and Amazon's Tech Strength Gets Bulls Buying Despite Recession on the Radar,"Recession, what recession? Apple and Amazon.com reported results after the latest Federal Reserve decision, but their results fit with Chair Jerome Powell's declaration that too many areas of the U.S. economy were performing too well for recession to have begunÃÂÃÂa day before Commerce Department data suggested that, by some measures, it had.",https://www.marketwatch.com/articles/things-to-know-today-51659090182,marketwatch.com,8,recession recession apple amazoncom reported result latest federal reserve decision result fit chair jerome powell declaration many area u economy performing well recession beguna day commerce department data suggested measure,-0.5859,-0.46872,0.3283848387,-0.797104839,Negative Impact
01/08/2022,134.96,138.83,133.51,135.39,135.39,76846900,-0.27,-314.4290963,1.192,0,14.33339876,0.959429757,-0.018638346,2.33,296.171,12368.98047,15286.00977,7413.399902,6436.859863,3259.959961,58115.5,19692.90039,114.5208099,146.5073676,119.3713743,138.7207874,118.3289997,133.0515718,103.6064276,78.56363192,4.181244881,2.193825644,1.987419237,5.669999259,118.0617105,10816592200,89.51857869,88.15459439,22.84000015,"Amazon pauses 18 warehouses in a 12 states, bringing total site closures to over 40","After expanding its fulfillment network during the pandemic, Amazon has delayed or canceled the launch of over a dozen warehouses across the country, a company spokesperson confirmed.",https://techxplore.com/news/2022-08-amazon-warehouses-states-total-site.html,techxplore.com,5,expanding fulfillment network pandemic amazon delayed canceled launch dozen warehouse across country company spokesperson confirmed,-0.0516,-0.0258,0.2213071429,-0.247107143,Negative Impact
02/08/2022,134.72,137.44,134.09,134.16,134.16,61922400,-0.27,-314.4290963,1.192,0,14.33339876,0.959429757,-0.018638346,2.33,296.171,12348.75977,15162.67969,7409.100098,6409.799805,3186.27002,58136.35938,19505.30078,115.05763,146.3532027,119.9513206,138.6754065,119.3619999,135.4900518,103.233948,75.90493434,4.742488196,2.703558154,2.038930042,5.497142792,120.9692713,10754669800,85.05600586,88.68036336,23.93000031,Amazon's Expenses Are Through the Roof: Time to Sell?,Amazon invested aggressively in adding capacity to serve surging demand at the pandemic's onset.,https://www.fool.com/investing/2022/08/02/amazons-expenses-are-through-the-roof-time-to-sell/,fool.com,7,amazon invested aggressively adding capacity serve surging demand pandemic onset,-0.2732,-0.19124,0.2423581818,-0.433598182,Negative Impact
03/08/2022,136.21,140.49,136.05,139.52,139.52,71827800,-0.27,-314.4290963,1.192,0,14.33339876,0.959429757,-0.018638346,2.33,296.171,12668.16016,15267.16016,7445.700195,6472.060059,3163.669922,58350.53125,19545.90039,115.69621,146.1985477,120.7187199,138.6838105,120.6215,138.887598,102.355402,78.3290922,5.555741688,3.273994861,2.281746827,5.692143032,123.4697736,10826497600,96.64359546,90.40606,21.95000076,Here's What to Do if Your Favorite Stock Is Crashing,"Earnings season is underway, and many stocks are making big moves to the upside and the downside.",https://www.fool.com/investing/2022/08/03/heres-what-to-do-if-your-favorite-stock-crashing/,fool.com,7,earnings season underway many stock making big move upside downside,-0.25,-0.175,0.103594,-0.278594,Negative Impact
04/08/2022,140.58,143.56,139.55,142.57,142.57,70585000,-0.27,-314.4290963,1.192,0,14.33339876,0.959429757,-0.018638346,2.33,296.171,12720.58008,15224.20996,7448.100098,6513.390137,3189.040039,58298.80078,19577,116.3964702,146.0497127,121.5756332,138.7224791,121.9335003,142.5233916,101.343609,78.38420094,6.372897897,3.893775468,2.479122429,5.626428332,126.1930107,10897082600,96.74452363,92.81470832,21.44000053,Amazon workers at UK warehouse stop work to protest pay,"More than 700 Amazon warehouse workers in England staged a protest Thursday in a dispute over pay, in the latest sign of workplace friction stoked by Britain's cost of living crisis and a growing discontent among employees over wage and working conditions.",https://techxplore.com/news/2022-08-amazon-workers-uk-warehouse-protest.html,techxplore.com,5,amazon warehouse worker england staged protest thursday dispute pay latest sign workplace friction stoked britain cost living crisis growing discontent among employee wage working condition,-0.7783,-0.38915,0.1184983333,-0.507648333,Negative Impact
05/08/2022,140.1,142.86,139.60,140.80,140.80,50686900,-0.27,-314.4290963,1.192,0,14.33339876,0.959429757,-0.018638346,2.33,296.171,12657.5498,15273.23047,7439.700195,6472.350098,3227.030029,58387.92969,19620.09961,117.1304703,145.8926752,122.32953,138.743151,123.1965004,145.1864355,101.2065653,75.66438948,6.799297458,4.474879866,2.324417592,5.567142487,129.3190683,10846395700,90.65359085,94.68056998,21.14999962,Amazon's $1.7 billion purchase of Roomba maker iRobot sparks privacy fears: ÃÂÃÂHomes were your last data sanctuary',"Amazon.com Inc.'s deal to purchase Roomba maker iRobot Corp., which comes hot on the heels of the tech giant's deal to acquire One Medical health clinics, is sparking more privacy fears.",https://www.marketwatch.com/story/amazons-1-7-billion-purchase-of-roomba-maker-irobot-sparks-privacy-fears-homes-were-your-last-data-sanctuary-11659715276,marketwatch.com,8,amazoncom inc deal purchase roomba maker irobot corp come hot heel tech giant deal acquire one medical health clinic sparking privacy fear,-0.4939,-0.39512,0.271874375,-0.666994375,Negative Impact
08/08/2022,142.05,144.23,138.29,139.41,139.41,52229000,-0.27,-314.4290963,1.192,0,14.33339876,0.959429757,-0.018638346,2.33,296.171,12644.45996,15305.7998,7482.399902,6524.439941,3236.929932,58853.07031,19669.19922,117.7831703,145.7359602,122.9993525,138.7497863,124.5795006,147.0130208,102.1459803,71.36235732,6.945003175,4.968904528,1.976098647,5.62071446,131.8824356,10794166700,83.77106882,90.38972777,21.29000092,What to Expect from the Markets in a Recession,The big R word is upon us. A recession is defined as two consecutive quarters of declining gross domestic product (GDP).,https://www.marketbeat.com/originals/what-to-expect-from-the-markets-in-a-recession/?SNAPI,marketbeat.com,5,big r word upon u recession defined two consecutive quarter declining gross domestic product gdp,-0.7096,-0.3548,0.08932,-0.44412,Negative Impact
09/08/2022,138.05,138.95,136.21,137.83,137.83,40434700,-0.27,-314.4290963,1.192,0,14.33339876,0.959429757,-0.018638346,2.33,296.171,12493.92969,15264.79004,7488.200195,6490,3247.429932,58853.07031,19578.30078,118.3182204,145.5663577,123.5809466,138.7406342,126.0100006,147.9632208,104.0567805,66.1449431,6.853974709,5.345918564,1.508056145,5.472856794,134.3519476,10753732000,78.45119679,84.29195215,21.77000046,2 Top Warren Buffett Stocks to Buy Right Now,These two stock names offer a portfolio centerpiece and a hidden opportunity.,https://www.fool.com/investing/2022/08/09/2-top-warren-buffett-stocks-to-buy-right-now/,fool.com,7,two stock name offer portfolio centerpiece hidden opportunity,0.4215,0.29505,0.26588,0.02917,Positive Impact
10/08/2022,142.9,144.60,141.01,142.69,142.69,54773800,-0.27,-314.4290963,1.192,0,14.33339876,0.959429757,-0.018638346,2.33,296.171,12854.7998,15552.7002,7507.100098,6523.439941,3230.02002,58817.28906,19885.90039,118.8690904,145.4459202,124.3303213,138.7799314,127.6245007,149.4932555,105.7557458,68.19097767,7.092240492,5.69518295,1.397057542,5.700000218,136.2100067,10808505800,93.64814368,85.29013643,19.73999977,7 Companies Amazon Should Acquire Next,"No one would've predicted the monstrous success of Amazon (NASDAQ: AMZN ). It's among the top-five most valuable companies in terms of market capitalization, trading at over a whopping $1.4 trillion.",https://investorplace.com/2022/08/7-companies-amazon-should-acquire-next/,investorplace.com,6,one wouldve predicted monstrous success amazon nasdaq amzn among topfive valuable company term market capitalization trading whopping trillion,0.8176,0.49056,0.09658166667,0.3939783333,Positive Impact
11/08/2022,143.86,144.49,139.76,140.64,140.64,44867300,-0.27,-314.4290963,1.192,0,14.33339876,0.959429757,-0.018638346,2.33,296.171,12779.91016,15602.92969,7465.899902,6544.669922,3281.669922,59332.60156,19991.90039,119.2777003,145.3190277,124.9699166,138.7984396,129.1250008,150.1873725,108.062629,68.41147653,7.034559703,5.9630583,1.071501402,5.741429465,136.2100067,10763638500,86.83070918,86.31001655,20.20000076,OSHA investigates deaths of 3 Amazon workers in New Jersey,"Federal work-safety investigators are looking into the death of an Amazon worker and an injury that potentially led to the death of another employee, adding to a probe already underway following a third fatality during the company's annual Prime Day shopping event in mid-July.",https://www.marketwatch.com/story/osha-investigates-deaths-of-3-amazon-workers-in-new-jersey-01660260638,marketwatch.com,8,federal worksafety investigator looking death amazon worker injury potentially led death another employee adding probe already underway following third fatality company annual prime day shopping event midjuly,-0.9371,-0.74968,0.0905375,-0.8402175,Negative Impact
12/08/2022,142.05,143.57,140.12,143.55,143.55,47643500,-0.27,-314.4290963,1.192,0,14.33339876,0.959429757,-0.018638346,2.33,296.171,13047.19043,15804.37988,7500.899902,6553.859863,3276.889893,59462.78125,20179.80078,119.7150204,145.1927602,125.6985474,138.8457188,130.6250008,151.2862372,109.9637644,71.92329946,7.141339323,6.198714505,0.9426248182,5.730001722,137.8880066,10811282000,96.50813836,92.32899707,19.53000069,3 Explosive Growth Stocks to Keep on Your Radar,"The search for growth stocks is always on for many investors. While sentiment for many high-growth stocks is at rock-bottom levels, many growth investors now have opportunities available at much more attractive prices.",https://investorplace.com/2022/08/3-explosive-growth-stocks-to-keep-on-your-radar/,investorplace.com,6,search growth stock always many investor sentiment many highgrowth stock rockbottom level many growth investor opportunity available much attractive price,0.872,0.5232,0.2140442857,0.3091557143,Positive Impact
15/08/2022,142.8,143.76,141.49,143.18,143.18,39014600,-0.27,-314.4290963,1.192,0,14.33339876,0.959429757,-0.018638346,2.33,296.171,13128.0498,15794.33008,7509.200195,6569.950195,3276.090088,59462.78125,20180.59961,120.0684003,145.0605377,126.3840943,138.8888459,132.0960003,151.8717676,112.3202329,81.41747484,7.114099288,6.381791461,0.7323078266,5.420000894,139.2304065,10772267400,94.82502441,92.72129065,19.95000076,"Berkshire Hathaway boosts Apple, Amazon stakes","Warren Buffett's Berkshire Hathaway Inc. BRK.A, +0.55% BRK.B, +0.42% added to its positions of Amazon.com Inc. AMZN, -0.26% and Apple Inc. AAPL, +0.63% over the past quarter, according to a filing with the Securities and Exchange Commission late Monday. Berkshire reported 10.7 million shares of Amazon, up from 534,000 shares in the previous quarter, and a whopping 895 million shares of Apple, up from about 150 million shares in the previous quarter.",https://www.marketwatch.com/story/berkshire-hathaway-boosts-apple-amazon-stakes-11660596627,marketwatch.com,8,warren buffetts berkshire hathaway inc brka brkb added position amazoncom inc amzn apple inc aapl past quarter according filing security exchange commission late monday berkshire reported million share amazon share previous quarter whopping million share apple million share previous quarter,0.872,0.6976,0.22623125,0.47136875,Positive Impact
16/08/2022,143.91,146.57,142.00,144.78,144.78,59102900,-0.27,-314.4290963,1.192,0,14.33339876,0.959429757,-0.018638346,2.33,296.171,13102.5498,15846.79004,7536.100098,6592.580078,3277.879883,59842.21094,20270,120.5170003,144.9227952,127.1055023,138.9474643,133.4245003,152.8390861,114.0099145,79.3298618,7.139320838,6.533297337,0.6060235015,5.240001134,140.1199951,10831370300,93.71706494,95.01674257,19.69000053,$1 Billion Losses Put Warren Buffett And Jeff Bezos In Bad Company,"Just when you thought $1 billion losses in the S&P 500 were bygones of Covid-19 lockdown days, they're back. The post $1 Billion Losses Put Warren Buffett And Jeff Bezos In Bad Company appeared first on Investor's Business Daily.",https://www.investors.com/etfs-and-funds/sectors/sp500-billion-losses-put-warren-buffett-and-jeff-bezos-in-bad-company/,investors.com,5,thought billion loss sp bygone covid lockdown day theyre back post billion loss put warren buffett jeff bezos bad company appeared first investor business daily,-0.7964,-0.3982,0.2270718519,-0.625271852,Negative Impact
17/08/2022,142.69,143.38,140.78,142.10,142.10,48149800,-0.27,-314.4290963,1.192,0,14.33339876,0.959429757,-0.018638346,2.33,296.171,12938.12012,15734.11035,7515.799805,6528.319824,3292.530029,60260.12891,20181.40039,120.8632004,144.7901877,127.6935221,138.9788329,134.3910007,153.4943907,115.2876108,73.61772753,6.863932941,6.599424458,0.2645084833,5.185715812,146.5700073,10783220500,68.43220293,85.65809743,19.89999962,Amazon and Walmart Take Last Mile Logistics Battle from Main Street to Mumbai,"In the eCommerce war between Amazon and Walmart, global in scope, India looms as a key battleground ÃÂÃÂ especially for the last mile which ultimately will decide the victor. India, after all, has a population of 1.4 billion individuals, and consumer spending, per sites including Statista, is about $304 USD equivalent.",https://www.pymnts.com/news/retail/2022/amazon-and-walmart-take-last-mile-logistics-battle-from-main-street-to-mumbai/,pymnts.com,5,ecommerce war amazon walmart global scope india loom key battleground especially last mile ultimately decide victor india population billion individual consumer spending per site including statista usd equivalent,-0.7783,-0.38915,0.1854358333,-0.574585833,Negative Impact
18/08/2022,141.32,142.77,140.38,142.30,142.30,37458700,-0.27,-314.4290963,1.192,0,14.33339876,0.959429757,-0.018638346,2.33,296.171,12965.33984,15763.90039,7541.899902,6557.399902,3277.540039,60298,20265.40039,121.2492004,144.6721602,128.2663252,139.0118794,135.274501,154.109666,116.4393361,62.46185305,6.585905907,6.596720747,-0.010814841,4.25857326,146.5700073,10820679200,67.30474669,76.48467152,19.55999947,5 Top Cloud Stocks to Buy Now,These hypergrowth stocks could launch your portfolio into the stratosphere.,https://www.fool.com/investing/2022/08/18/5-top-cloud-stocks-to-buy-now/,fool.com,7,hypergrowth stock could launch portfolio stratosphere,0,0,0.22934,-0.22934,Negative Impact
19/08/2022,140.47,141.11,137.91,138.23,138.23,47792800,-0.27,-314.4290963,1.192,0,14.33339876,0.959429757,-0.018638346,2.33,296.171,12705.21973,15588.32031,7550.399902,6495.830078,3258.080078,59646.14844,20111.40039,121.5902003,144.5351227,128.6570574,139.0040995,136.0650009,153.9307296,118.1992723,54.28743077,5.968352451,6.471047088,-0.502694637,4.192144121,146.3224072,10772886400,33.17304283,56.30333082,20.60000038,Better Buy: Amazon vs. MercadoLibre,Which e-commerce stock should you buy today?,https://www.fool.com/investing/2022/08/19/better-buy-amazon-vs-mercadolibre/,fool.com,7,ecommerce stock buy today,0,0,0.3190557143,-0.319055714,Negative Impact
22/08/2022,135.72,136.32,132.85,133.22,133.22,50461500,-0.27,-314.4290963,1.192,0,14.33339876,0.959429757,-0.018638346,2.33,296.171,12381.57031,15341.84961,7533.799805,6378.740234,3277.790039,58773.87109,19974.90039,121.9316003,144.3552227,128.8359964,138.9465462,136.669001,153.1752503,120.1627517,48.7262848,5.016841179,6.180205906,-1.163364727,4.337142944,145.817663,10722424900,2.696757174,34.39151557,23.79999924,"Signify Health Rockets As Amazon, UnitedHealth Said To Lead A Bidding Battle","A rumored bidding war over home-health technology player Signify Health sent SGFY stock to a year-high Monday. The post Signify Health Rockets As Amazon, UnitedHealth Said To Lead A Bidding Battle appeared first on Investor's Business Daily.",https://www.investors.com/news/technology/sgfy-stock-rockets-as-amazon-unitedhealth-said-to-lead-a-bidding-battle/,investors.com,5,rumored bidding war homehealth technology player signify health sent sgfy stock yearhigh monday post signify health rocket amazon unitedhealth said lead bidding battle appeared first investor business daily,-0.7003,-0.35015,0.2302186667,-0.580368667,Negative Impact
23/08/2022,133.41,134.99,132.95,133.62,133.62,36252100,-0.27,-314.4290963,1.192,0,14.33339876,0.959429757,-0.018638346,2.33,296.171,12381.2998,15338.15039,7488.100098,6362.02002,3276.219971,59031.30078,19985.40039,122.4110002,144.1540726,129.0236042,138.8935457,137.6095009,150.6515937,124.5674081,40.76392316,4.246091506,5.793383026,-1.547291521,4.030714852,144.7802505,10758677000,5.612164323,13.82732144,24.11000061,2 E-Commerce Stocks You Can Buy and Hold for the Next Decade,Tech stocks are volatile right now but don't count these e-commerce plays out just yet.,https://www.fool.com/investing/2022/08/23/e-commerce-stocks-buy-and-hold-for-next-decade/,fool.com,7,tech stock volatile right dont count ecommerce play yet,-0.2584,-0.18088,0.2217161538,-0.402596154,Negative Impact
24/08/2022,132.75,135.47,132.10,133.80,133.80,38627000,-0.27,-314.4290963,1.192,0,14.33339876,0.959429757,-0.018638346,2.33,296.171,12431.53027,15392.05957,7471.5,6386.759766,3215.199951,59085.42969,20021.40039,123.0136003,143.9433252,129.2109139,138.8428637,138.251001,148.8872424,127.6147596,34.91572504,3.608198901,5.356346201,-1.7481473,3.98285784,143.8258309,10797304000,11.74842298,6.685781492,22.81999969,TikTok stars boycott Amazon in activism push,TikTok influencers boasting collectively more than 51 million followers say they won't work with Amazon until the e-commerce colossus delivers key concessions to workers and halts anti-union efforts.,https://techxplore.com/news/2022-08-tiktok-stars-boycott-amazon.html,techxplore.com,5,tiktok influencers boasting collectively million follower say wont work amazon ecommerce colossus delivers key concession worker halt antiunion effort,-0.1326,-0.0663,0.3332527273,-0.399552727,Negative Impact
25/08/2022,135.26,137.42,134.28,137.28,137.28,37496300,-0.27,-314.4290963,1.192,0,14.33339876,0.959429757,-0.018638346,2.33,296.171,12639.26953,15595.24023,7479.700195,6381.560059,3246.25,58774.71875,20172.30078,123.7130003,143.7574802,129.5273486,138.8273128,139.001001,146.5680443,131.4339577,44.28199697,3.344912915,4.954059544,-1.609146629,4.00857217,142.6532484,10834800300,35.79814954,17.71957895,21.78000069,Pick n Pay Selects AWS as Its Strategic Cloud Provider,"SEATTLE--(BUSINESS WIRE)--Amazon Web Services, Inc. (AWS), an Amazon.com, Inc. company (NASDAQ: AMZN), today announced that Pick n Pay Group (JSE: PIK), a leading retail business operating in South African and other selected African countries, has migrated its entire on-premises information technology (IT) infrastructure to AWS. Pick n Pay worked with Lemongrass ConsultingÃÂÃÂan AWS Premier Consulting Partner with Migration and SAP Consulting CompetenciesÃÂÃÂto migrate its on-premises SAP environment",https://www.businesswire.com/news/home/20220824005685/en/Pick-n-Pay-Selects-AWS-as-Its-Strategic-Cloud-Provider/,businesswire.com,5,seattlebusiness wireamazon web service inc aws amazoncom inc company nasdaq amzn today announced pick n pay group jse pik leading retail business operating south african selected african country migrated entire onpremises information technology infrastructure aws pick n pay worked lemongrass consultingan aws premier consulting partner migration sap consulting competenciesto migrate onpremises sap environment,-0.2023,-0.10115,0.3334732258,-0.434623226,Negative Impact
26/08/2022,136.55,137.83,130.50,130.75,130.75,53322700,-0.27,-314.4290963,1.192,0,14.33339876,0.959429757,-0.018638346,2.33,296.171,12141.70996,15178.20996,7427.299805,6274.259766,3236.219971,58833.87109,19873.30078,124.1746004,143.5171727,129.5752957,138.7469415,138.7910011,147.0343023,130.5476999,37.94543371,2.579604471,4.479168529,-1.899564059,4.10785784,141.5979242,10781477600,1.55569313,16.36742188,25.55999947,Exploring Weak Retail Sector Earnings and Guidance,"The overall trend emerging from the Retail sector's Q2 results has been on the weak side, with most operators suffering from softening sales, rising expenses, bigger than expected inventory builds and lowered guidance for the current period.",https://www.zacks.com/commentary/1973076/exploring-weak-retail-sector-earnings-and-guidance,zacks.com,8,overall trend emerging retail sector q result weak side operator suffering softening sale rising expense bigger expected inventory build lowered guidance current period,-0.7579,-0.60632,0.159475,-0.765795,Negative Impact
29/08/2022,129.9,131.95,128.77,129.79,129.79,48101600,-0.27,-314.4290963,1.192,0,14.33339876,0.959429757,-0.018638346,2.33,296.171,12017.66992,15118.84961,7427.299805,6222.279785,3240.72998,57972.62109,19836.09961,124.6972002,143.2956102,129.5837153,138.6578177,138.5110008,147.5798068,129.4421949,38.61189182,1.874024904,3.958139804,-2.0841149,4.106428964,140.2661733,10733376000,5.730274375,14.36137235,26.20999908,"Could Amazon Dive Further Into Gaming? Why the Stock Is a Buy Now, Anyway",Rumors swirled last week that Amazon could make the next blockbuster gaming deal of 2022.,https://www.fool.com/investing/2022/08/29/could-amazon-dive-into-gaming-why-stock-is-buy-now/,fool.com,7,rumor swirled last week amazon could make next blockbuster gaming deal,0.6808,0.47656,0.2118242857,0.2647357143,Positive Impact
30/08/2022,131.25,132.07,126.85,128.73,128.73,49203000,-0.27,-314.4290963,1.192,0,14.33339876,0.959429757,-0.018638346,2.33,296.171,11883.13965,14931.41992,7361.600098,6210.220215,3227.219971,59537.07031,19512.90039,125.1474001,143.0711352,129.5502361,138.5590334,138.2395004,148.1434394,128.3355615,27.84126992,1.215305781,3.409572999,-2.194267219,3.995715005,138.6567096,10684173000,9.533450353,5.60647262,26.20999908,"Amazon, Google slam Microsoft's cloud computing changes","Amazon and Alphabet unit Google criticised Microsoft's cloud computing changes on Tuesday, saying they limit competition and discourage customers from switching to rival cloud service providers.",https://www.reuters.com/technology/amazon-google-slam-microsofts-cloud-computing-changes-2022-08-30/,reuters.com,10,amazon alphabet unit google criticised microsofts cloud computing change tuesday saying limit competition discourage customer switching rival cloud service provider,-0.5994,-0.5994,0.1087933333,-0.708193333,Negative Impact
31/08/2022,129.45,130.59,126.74,126.77,126.77,53648700,-0.27,-314.4290963,1.192,0,14.33339876,0.959429757,-0.018638346,2.33,296.171,11816.2002,14801.24023,7284.200195,6125.100098,3202.139893,59537.07031,19330.80078,125.5092,142.8236976,129.4412071,138.4417295,137.602,148.7252306,126.4787695,27.92104782,0.529012458,2.833460891,-2.304448433,3.932856968,136.7676358,10630524300,0.1512797024,5.13833481,25.87000084,"Amazon, facing ÃÂÃÂunfavorable' regulatory environment, struggles to expand in India","Amazon is lagging its chief rival Flipkart in India on several key metrics and struggling to make inroads in smaller Indian cities and towns, according to a scathing report by investment firm Sanford C. Bernstein.",https://techcrunch.com/2022/08/31/amazon-facing-unfavorable-regulatory-environment-in-india-struggles-to-expand/,techcrunch.com,5,amazon lagging chief rival flipkart india several key metric struggling make inroad smaller indian city town according scathing report investment firm sanford c bernstein,-0.4939,-0.24695,0.2298290909,-0.476779091,Negative Impact
01/09/2022,126,128.02,123.66,127.82,127.82,56636100,-0.27,-314.4290963,1.192,0,14.33339876,0.959429757,-0.018638346,2.56,296.808,11785.12988,14771.90039,7148.5,6034.310059,3184.97998,58766.58984,19142.69922,125.8866,142.5763776,129.3776303,138.3360407,136.8644997,148.5428919,125.1861074,23.3840987,0.06905055447,2.280578824,-2.211528269,3.99785614,134.962661,10687160400,18.15798938,9.28090648,25.55999947,Amazon Under Investigation for String of Warehouse Deaths as Scrutiny Grows,"Warehouse deaths are worrying in light of complaints over heat and pace of work, advocates and workers say.",https://www.cnet.com/tech/services-and-software/amazon-under-investigation-for-string-of-warehouse-deaths-as-scrutiny-grows/,cnet.com,5,warehouse death worrying light complaint heat pace work advocate worker say,-0.8176,-0.4088,0.1625835294,-0.571383529,Negative Impact
02/09/2022,129.5,131.38,126.39,127.51,127.51,57429800,-0.27,-314.4290963,1.192,0,14.33339876,0.959429757,-0.018638346,2.56,296.808,11630.86035,14689.5,7281.200195,6167.509766,3186.47998,58803.32813,19270.90039,126.188,142.3287526,129.30439,138.2283189,136.1999996,148.4346807,123.9653185,23.43168587,-0.316834509,1.761096157,-2.077930666,4.192143032,132.7021295,10629730600,16.80487935,11.70471614,25.46999931,"Up 4% After the Stock Split, Is Amazon Stock Still a Buy?",The stock split created a surge in interest. But fundamentals will power long-term growth.,https://www.fool.com/investing/2022/09/02/up-10-after-the-stock-split-is-amazon-stock-still/,fool.com,7,stock split created surge interest fundamental power longterm growth,0.765,0.5355,-0.008894737,0.5443947368,Positive Impact
06/09/2022,127.92,128.62,124.74,126.11,126.11,43888600,-0.27,-314.4290963,1.192,0,14.33339876,0.959429757,-0.018638346,2.56,296.808,11544.91016,14631.51953,7300.399902,6104.609863,3243.449951,59196.98828,19088.19922,126.3810001,142.0720527,129.1791198,138.1077386,135.5349995,148.4613064,122.6086925,18.1290501,-0.727236495,1.263429627,-1.990666122,4.142856598,131.3800049,10585842000,12.42391885,15.79559586,26.90999985,"AMZN ALERT: The Klein Law Firm Announces a Lead Plaintiff Deadline of September 6, 2022 in the Class Action Filed on Behalf of Amazon.com, Inc. Shareholders","NEW YORK , Sept. 6, 2022 /PRNewswire/ -- The Klein Law Firm announces that a class action complaint has been filed on behalf of shareholders of Amazon.com, Inc. (NASDAQ: AMZN) alleging that the Company violated federal securities laws.",https://www.prnewswire.com/news-releases/amzn-alert-the-klein-law-firm-announces-a-lead-plaintiff-deadline-of-september-6-2022-in-the-class-action-filed-on-behalf-of-amazoncom-inc-shareholders-301618328.html,prnewswire.com,5,new york sept prnewswire klein law firm announces class action complaint filed behalf shareholder amazoncom inc nasdaq amzn alleging company violated federal security law,-0.4939,-0.24695,0.401642,-0.648592,Negative Impact
07/09/2022,126.12,129.82,125.40,129.48,129.48,47900300,-0.27,-314.4290963,1.192,0,14.33339876,0.959429757,-0.018638346,2.56,296.808,11791.90039,14844.57031,7237.799805,6105.919922,3246.290039,59028.91016,19241.40039,126.7062,141.7954377,129.1909189,138.0218904,135.1174992,148.2691219,121.9658764,28.95261479,-0.771657398,0.8564122217,-1.62806962,4.172857012,131.3800049,10633742300,30.45521653,19.89467158,24.63999939,"Getty Images stock shoots up after renewing deal with Amazon to provide images for Alexa, Fire TV","Shares of Getty Images Holdings Inc. GETY, -8.47% shot up 13.4% in premarket trading Wednesday, after the visual content company said it signed a ""multi-year"" renewal agreement with Amazon.com Inc. AMZN, -1.10% . Financial terms of the agreement were not disclosed.",https://www.marketwatch.com/story/getty-images-stock-shoots-up-after-renewing-deal-with-amazon-to-provide-images-for-alexa-fire-tv-2022-09-07,marketwatch.com,8,share getty image holding inc gety shot premarket trading wednesday visual content company said signed multiyear renewal agreement amazoncom inc amzn financial term agreement disclosed,0.8225,0.658,0.300385,0.357615,Positive Impact
08/09/2022,127.72,130.28,127.10,129.82,129.82,43988500,-0.27,-314.4290963,1.192,0,14.33339876,0.959429757,-0.018638346,2.56,296.808,11862.12988,14961.76953,7262.100098,6125.899902,3235.590088,59688.21875,19413,127.1546001,141.5253952,129.215589,137.9402797,134.4739994,147.3214721,121.6265267,29.28288276,-0.770542852,0.531021207,-1.301564059,4.229285649,123.6600037,10677730800,35.30088676,26.06000738,23.61000061,An Incredible Stock Market Money-Maker Formed Amid the Chaos,Source: Zakharchuk / Shutterstock [Editor's note: ÃÂÃÂAn Incredible Stock Market Money-Maker Formed Amid the Chaos ÃÂÃÂ was previously published in July 2022 . It has since been updated to include the most relevant information available.,https://investorplace.com/hypergrowthinvesting/2022/09/an-incredible-stock-market-money-making-opportunity-is-fast-approaching/,investorplace.com,6,source zakharchuk shutterstock editor note incredible stock market moneymaker formed amid chaos previously published july since updated include relevant information available,-0.5719,-0.34314,0.242636,-0.585776,Negative Impact
09/09/2022,130.91,133.69,130.76,133.27,133.27,49387600,-0.27,-314.4290963,1.192,0,14.33339876,0.959429757,-0.018638346,2.56,296.808,12112.30957,15190.79004,7351.100098,6212.330078,3262.050049,59793.14063,19773.30078,127.6416002,141.2986027,129.3745857,137.8938093,134.1054996,146.6269557,121.5840436,41.59323482,-0.485675084,0.3276819488,-0.813357033,4.192142487,123.7924036,10727118400,67.8193497,44.525151,22.79000092,"Amazon.com deal for iRobot blasted by pro-privacy, labor groups","A group of some 20 pro-privacy and worker organizations, including Public Citizen and Fight for the Future, urged U.S. antitrust enforcers Friday to stop Amazon.com from buying iRobot Corp, maker of the robotic vacuum cleaner Roomba.",https://www.reuters.com/markets/deals/amazoncom-deal-irobot-blasted-by-pro-privacy-labor-groups-2022-09-09/,reuters.com,10,group proprivacy worker organization including public citizen fight future urged u antitrust enforcer friday stop amazoncom buying irobot corp maker robotic vacuum cleaner roomba,-0.4767,-0.4767,0.2980033333,-0.774703333,Negative Impact
12/09/2022,134.1,136.49,134.00,136.45,136.45,53826900,-0.27,-314.4290963,1.192,0,14.33339876,0.959429757,-0.018638346,2.56,296.808,12266.41016,15352.17969,7473,6333.589844,3262.050049,60115.12891,19987.19922,128.2464001,141.0858427,129.6520528,137.879443,133.7504993,145.5248256,121.9761731,55.83663885,-0.003278699,0.2614898193,-0.264768518,4.037857601,124.1883075,10780945300,90.26107931,64.46043859,23.87000084,"Amazon's offer to end EU antitrust probe is full of loopholes, NGOs say","Amazon's proposal to halt certain online selling and marketing practices in a bid to avert possible hefty EU antitrust fines should be rejected because it is weak and full of loopholes, a group of 11 non-governmental bodies have told EU regulators.",https://www.reuters.com/technology/amazons-offer-end-eu-antitrust-probe-is-full-loopholes-ngos-say-2022-09-12/,reuters.com,10,amazon proposal halt certain online selling marketing practice bid avert possible hefty eu antitrust fine rejected weak full loophole group nongovernmental body told eu regulator,-0.5106,-0.5106,0.1778858333,-0.688485833,Negative Impact
13/09/2022,131.01,131.40,126.27,126.82,126.82,72694000,-0.27,-314.4290963,1.192,0,14.33339876,0.959429757,-0.018638346,2.56,296.808,11633.57031,14820.79004,7385.899902,6245.689941,3263.800049,60571.07813,19645.40039,128.5916002,140.8248402,129.5409919,137.7693988,132.9324997,144.2112559,121.6537435,40.78591444,-0.393500358,0.1304917839,-0.523992142,4.619285583,124.9264094,10708251300,22.30061003,60.12701301,27.27000046,Tech stocks crushed in market selloff,The six largest tech U.S. tech companies lost more than $500 billion Tuesday after an unexpectedly high August inflation report sent tech stocks tumbling.,https://www.cnbc.com/2022/09/13/tech-stocks-crushed-in-market-selloff.html,cnbc.com,9,six largest tech u tech company lost billion tuesday unexpectedly high august inflation report sent tech stock tumbling,-0.3182,-0.28638,0.2114585,-0.4978385,Negative Impact
14/09/2022,127.36,128.84,126.33,128.55,128.55,45316800,-0.27,-314.4290963,1.192,0,14.33339876,0.959429757,-0.018638346,2.56,296.808,11719.67969,14843.20996,7277.299805,6222.410156,3237.540039,60346.96875,19726.09961,128.8926003,140.5914503,129.5021296,137.6776635,132.1209999,142.0673986,122.1746012,43.17295134,-0.556739277,-0.006954428,-0.549784849,4.557856968,125.6202252,10753568100,34.50952732,49.02373889,26.15999985,"Amazon hit with antitrust lawsuit from California, which claims seller rules are increasing consumer prices","California is suing Amazon.com Inc., claiming the e-commerce giant's policies for those who sell on its platform have blocked competition and driven up prices for consumers, state Attorney General Rob Bonta announced Wednesday.",https://www.marketwatch.com/story/amazon-hit-with-antitrust-lawsuit-from-california-which-claims-seller-rules-are-increasing-consumer-prices-11663179158,marketwatch.com,8,california suing amazoncom inc claiming ecommerce giant policy sell platform blocked competition driven price consumer state attorney general rob bonta announced wednesday,-0.7783,-0.62264,0.1055074074,-0.728147407,Negative Impact
15/09/2022,127.38,130.37,125.50,126.28,126.28,52887200,-0.27,-314.4290963,1.192,0,14.33339876,0.959429757,-0.018638346,2.56,296.808,11552.36035,14722.03027,7282.100098,6157.839844,3199.919922,59934.01172,19560.19922,129.1316002,140.3324577,129.3757715,137.5642539,131.3299995,140.4137574,122.2462417,35.23093666,-0.859371373,-0.177437817,-0.681933555,4.647142683,136.4900055,10700680900,18.48973504,25.09995746,26.27000046,Amazon's Coventry workers initiate UK strike ballot over pay,"Amazon.com Inc (NASDAQ:AMZN) workers at a Coventry warehouse will become the first in the UK to take part in a formal strike ballot, with the GMB union stating Coventry's staff is ""making history"". The company's reported offer of a rise of 35p per hour has sparked anger among hundreds of workers who will begin voting on whether to walk out.",https://www.proactiveinvestors.co.uk/companies/news/992830?SNAPI,proactiveinvestors.co.uk,5,amazoncom inc nasdaqamzn worker coventry warehouse become first uk take part formal strike ballot gmb union stating coventry staff making history company reported offer rise p per hour sparked anger among hundred worker begin voting whether walk,-0.6369,-0.31845,0.2955661905,-0.61401619,Negative Impact
16/09/2022,122.78,123.87,120.70,123.53,123.53,115667800,-0.27,-314.4290963,1.192,0,14.33339876,0.959429757,-0.018638346,2.56,296.808,11448.40039,14573.91016,7236.700195,6077.299805,3126.399902,58840.78906,19385.90039,129.2756001,140.0733402,129.1465255,137.4246095,130.3914993,138.5327265,122.2502722,39.21099855,-1.306056104,-0.403161475,-0.902894629,4.522142683,136.2702054,10585013100,17.92273781,23.64066672,26.29999924,"FedEx Warning Drags Down Amazon and Other E-Commerce, Packaging Shares",Some packaging stocks were on track for their worst day since 2020 following FedEx's worse-than-expected earnings and withdrawn guidance.,https://www.barrons.com/articles/fedex-stock-price-today-amazon-international-paper-51663348720,barrons.com,9,packaging stock track worst day since following fedexs worsethanexpected earnings withdrawn guidance,-0.6249,-0.56241,0.03899153846,-0.601401538,Negative Impact
19/09/2022,122.16,124.71,121.80,124.66,124.66,47279700,-0.27,-314.4290963,1.192,0,14.33339876,0.959429757,-0.018638346,2.56,296.808,11535.01953,14674.45996,7236.700195,6061.589844,3115.600098,59141.23047,19562.40039,129.4580002,139.8357102,128.9705835,137.2975985,129.7129997,137.3498741,122.0761254,42.37289789,-1.550996104,-0.6327284,-0.918267703,4.502857208,135.647397,10632292800,25.07919298,20.49722194,25.76000023,Amazon halts construction of new warehouses in Spain until 2024 - El Confidencial,"Amazon.com Inc has suspended the construction of new warehouses in Spain until 2024, Spanish news website El Confidencial said on Monday, citing unidentified company sources.",https://www.reuters.com/technology/amazon-halts-construction-new-warehouses-spain-until-2024-el-confidencial-2022-09-19/,reuters.com,10,amazoncom inc suspended construction new warehouse spain spanish news website el confidencial said monday citing unidentified company source,-0.4767,-0.4767,0.1945714286,-0.671271429,Negative Impact
20/09/2022,123.35,124.40,121.14,122.19,122.19,47698400,-0.27,-314.4290963,1.192,0,14.33339876,0.959429757,-0.018638346,2.56,296.808,11425.0498,14474.71973,7192.700195,5979.470215,3122.409912,59719.73828,19368.69922,129.6668002,139.5873203,128.7046783,137.1472742,129.1614998,137.3080802,121.0149194,40.66782008,-1.922262627,-0.890635246,-1.031627382,4.38142831,135.049501,10584594400,9.436381804,17.47943753,27.15999985,7 Nasdaq Stocks to Buy During a Stock Market Crash,"With technology-focused companies suffering a disproportionate beating during the present market rout, diving into Nasdaq stocks to buy seems risky. After all, the Nasdaq Composite has sustained a loss of 27% since the start of the year, far wider than the other two major indices.",https://investorplace.com/2022/09/7-nasdaq-stocks-to-buy-during-stock-market-crash/,investorplace.com,6,technologyfocused company suffering disproportionate beating present market rout diving nasdaq stock buy seems risky nasdaq composite sustained loss since start year far wider two major index,-0.836,-0.5016,0.228199,-0.729799,Negative Impact
21/09/2022,122.49,123.76,118.45,118.54,118.54,58498900,-0.27,-314.4290963,1.192,0,14.33339876,0.959429757,-0.018638346,2.56,296.808,11220.19043,14236.61035,7237.600098,6031.330078,3117.179932,59456.78125,19184.5,129.8532002,139.3325727,128.3060635,136.9621272,128.4075001,137.5474634,119.2675367,38.79663318,-2.482403044,-1.208988805,-1.273414238,4.485714504,134.4755209,10526095500,0.4989131078,11.67149596,27.98999977,"U.S. FTC rejects Amazon bid to quash Bezos, Jassy testimony",The U.S. Federal Trade Commission on Wednesday rejected a bid by Amazon.com Inc to quash demands that both Chief Executive Andy Jassy and Executive Chairman Jeff Bezos testify at investigative hearings.,https://www.reuters.com/business/us-ftc-rejects-amazon-bid-quash-bezos-jassy-testimony-2022-09-22/,reuters.com,10,u federal trade commission wednesday rejected bid amazoncom inc quash demand chief executive andy jassy executive chairman jeff bezos testify investigative hearing,-0.5859,-0.5859,0.2346184,-0.8205184,Negative Impact
22/09/2022,117.08,118.79,116.26,117.31,117.31,55229200,-0.27,-314.4290963,1.192,0,14.33339876,0.959429757,-0.018638346,2.56,296.808,11066.80957,14116.58984,7159.5,5918.5,3108.909912,59119.71875,19002.69922,129.9914001,139.0622802,127.8748453,136.7665836,127.5829998,137.6070695,117.5589301,35.76266741,-2.991089928,-1.56540903,-1.425680898,4.355000087,133.5139894,10470866300,5.190287929,5.041860947,27.35000038,Amazon drivers were more than twice as likely to be rated unsafe,"Amazon.com Inc. has rapidly built a sprawling network to move merchandise around the nation's highways. Many of the trucking companies it hired for all that driving are more dangerous than their peers, sometimes fatally so.",https://www.marketwatch.com/story/amazon-drivers-were-more-than-twice-as-likely-to-be-rated-unsafe-11663859044,marketwatch.com,8,amazoncom inc rapidly built sprawling network move merchandise around nation highway many trucking company hired driving dangerous peer sometimes fatally,-0.8074,-0.64592,0.07827916667,-0.724199167,Negative Impact
23/09/2022,116,116.05,112.06,113.78,113.78,65126700,-0.27,-314.4290963,1.192,0,14.33339876,0.959429757,-0.018638346,2.56,296.808,10867.92969,13796.99023,7018.600098,5783.410156,3088.370117,58098.92188,18481,130.0544002,138.7503577,127.3221062,136.5378614,126.4079998,137.1309994,115.6850002,32.89309858,-3.637142632,-1.97975575,-1.657386882,4.373571123,132.1336705,10405739600,7.040526656,4.243242564,29.92000008,My Take: 4 Strong Growth Stocks to Buy This Week,Quality and resiliency shine through when trouble starts setting in.,https://www.fool.com/investing/2022/09/23/my-take-4-strong-growth-stocks-to-buy-this-week/,fool.com,7,quality resiliency shine trouble start setting,-0.4019,-0.28133,0.3176133333,-0.598943333,Negative Impact
26/09/2022,113.3,117.34,113.13,115.15,115.15,62723300,-0.27,-314.4290963,1.192,0,14.33339876,0.959429757,-0.018638346,2.56,296.808,10802.91992,13580.38965,7021,5769.390137,3051.22998,57145.21875,18327,130.0864001,138.4453177,126.8447688,136.3250469,125.6279999,137.252742,114.0032578,36.33417041,-3.992572394,-2.382319079,-1.610253315,4.397142683,130.1263032,10468462900,12.64839527,8.293069951,32.25999832,Amazon and Berkshire Hathaway could be among top payers of new corporate minimum tax,"WASHINGTONÃÂÃÂA handful of large companies, such as Berkshire Hathaway Inc. BRK.B, -0.55% and Amazon.com Inc. AMZN, +1.98% , could bear most of the burden from a 15% corporate minimum tax President Biden signed into law last month.",https://www.marketwatch.com/story/amazon-and-berkshire-hathaway-could-be-among-top-payers-of-new-corporate-minimum-tax-11664204306,marketwatch.com,8,washingtona handful large company berkshire hathaway inc brkb amazoncom inc amzn could bear burden corporate minimum tax president biden signed law last month,-0.4404,-0.35232,0.290993,-0.643313,Negative Impact
27/09/2022,117.2,118.32,113.05,114.41,114.41,60094700,-0.27,-314.4290963,1.192,0,14.33339876,0.959429757,-0.018638346,2.56,296.808,10829.5,13541.75977,6984.600098,5753.819824,3093.860107,57107.51953,18307.90039,130.0994002,138.1465127,126.3571309,136.1069867,124.8590004,137.3286143,112.3893865,29.89059856,-4.284574773,-2.762770218,-1.521804555,4.457856315,128.3196726,10408368200,9.619342367,9.76942143,32.59999847,2 Growth Stocks to Set You Up for the Next 5 Years,"These two stocks have sold off, but their growth prospects remain attractive.",https://www.fool.com/investing/2022/09/27/2-growth-stocks-to-set-you-up-for-the-next-5-years/,fool.com,7,two stock sold growth prospect remain attractive,0.7717,0.54019,0.2300216667,0.3101683333,Positive Impact
28/09/2022,114.38,118.70,113.80,118.01,118.01,55763800,-0.27,-314.4290963,1.192,0,14.33339876,0.959429757,-0.018638346,2.56,296.808,11051.63965,13833.17969,7005.399902,5765.009766,3045.070068,56598.28125,18648.90039,130.0954002,137.8755027,126.0297925,135.9269172,124.3230007,137.0116761,111.6343254,35.50208174,-4.177345137,-3.045685202,-1.131659935,4.580713,126.6937051,10464132000,24.35531169,15.54101644,30.18000031,Amazon Upgrades Fire TV with Third Generation Fire TV Cube and New Alexa Voice Remote Pro,"SEATTLE--(BUSINESS WIRE)--Amazon (NASDAQ: AMZN) today announced upgrades to its industry-leading Fire TV family, including the next generation Fire TV CubeÃÂÃÂFire TV's most powerful streaming media player yetÃÂÃÂand Alexa Voice Remote Pro, a premium remote with an all-new Remote Finder and customizable buttons. ÃÂÃÂThe all-new Fire TV Cube is a big step forward for Fire TVÃÂÃÂit's the fastest, most powerful, and most versatile streaming media player we've ever made,ÃÂÃÂ said Daniel Rausch, vice president of",https://www.businesswire.com/news/home/20220928005788/en/Amazon-Upgrades-Fire-TV-with-Third-Generation-Fire-TV-Cube-and-New-Alexa-Voice-Remote-Pro/,businesswire.com,5,seattlebusiness wireamazon nasdaq amzn today announced upgrade industryleading fire tv family including next generation fire tv cubefire tv powerful streaming medium player yetand alexa voice remote pro premium remote allnew remote finder customizable button allnew fire tv cube big step forward fire tvits fastest powerful versatile streaming medium player weve ever made said daniel rausch vice president,-0.4588,-0.2294,0.288405,-0.517805,Negative Impact
29/09/2022,115.6,116.07,113.06,114.80,114.80,58969700,-0.27,-314.4290963,1.192,0,14.33339876,0.959429757,-0.018638346,2.56,296.808,10737.50977,13608.29004,6881.600098,5676.870117,3041.199951,56409.96094,18441.80078,129.9360004,137.6016652,125.5894086,135.7166992,123.724501,137.0408736,110.4081285,27.19190082,-4.301796544,-3.29690747,-1.004889074,4.657856533,125.2303343,10405162300,11.21573722,15.06346376,31.84000015,"Amazon, major publishers win dismissal of antitrust lawsuits over book pricing","A federal judge on Thursday dismissed two antitrust lawsuits accusing Amazon.com Inc and five large publishers of illegally conspiring to fix U.S. prices of electronic and traditional books, causing consumers and bookstores to pay more.",https://www.reuters.com/legal/amazon-major-publishers-win-dismissal-antitrust-lawsuits-over-book-pricing-2022-09-29/,reuters.com,10,federal judge thursday dismissed two antitrust lawsuit accusing amazoncom inc five large publisher illegally conspiring fix u price electronic traditional book causing consumer bookstore pay,-0.4588,-0.4588,0.2254,-0.6842,Negative Impact
30/09/2022,114.08,116.92,112.84,113.00,113.00,59479600,-0.27,-314.4290963,1.192,0,14.33339876,0.959429757,-0.018638346,2.56,296.808,10575.62012,13472.17969,6893.799805,5762.339844,3024.389893,57426.92188,18444.19922,129.7034004,137.3212076,125.0957063,135.4906624,122.9835011,136.9726521,108.99435,20.02047119,-4.493867873,-3.536299551,-0.957568322,4.719285148,123.9133007,10345682700,4.860406512,13.47715181,31.62000084,Amazon's business model is inhumane and unsustainable,"With Britain suffering through its worst cost-of-living crisis in decadesÃÂÃÂowing to high inflation and soaring energy pricesÃÂÃÂhundreds of workers at an Amazon AMZN, +0.05% warehouse in Coventry, England, this month demanded a wage hike. If the demand is not met, they say they will go on strike in November, just ahead of Black Friday and the holiday shopping season.",https://www.marketwatch.com/story/amazons-business-model-is-inhumane-and-unsustainable-11664560894,marketwatch.com,8,britain suffering worst costofliving crisis decadesowing high inflation soaring energy priceshundreds worker amazon amzn warehouse coventry england month demanded wage hike demand met say go strike november ahead black friday holiday shopping season,-0.8658,-0.69264,0.17622,-0.86886,Negative Impact
03/10/2022,113.58,116.91,112.45,115.88,115.88,50941900,-0.27,-314.4290963,1.192,0,14.33339876,0.959429757,-0.018638346,3.08,298.012,10815.42969,13855.71973,6908.799805,5794.149902,3024.389893,56788.80859,18881.19922,129.5726004,137.0340326,124.734306,135.2955314,122.4020008,136.5647046,108.239297,33.09641984,-4.363395567,-3.701718754,-0.661676813,4.310714177,122.7279704,10396624600,20.86291755,12.31302043,30.10000038,3 Warren Buffett Stocks to Buy Hand Over Fist in October,Following in the Oracle of Omaha's footsteps has been a moneymaking proposition for nearly six decades.,https://www.fool.com/investing/2022/10/03/3-warren-buffett-stocks-buy-hand-over-fist-october/,fool.com,7,following oracle omaha footstep moneymaking proposition nearly six decade,0,0,0.3320407692,-0.332040769,Negative Impact
04/10/2022,119.89,123.00,119.79,121.09,121.09,62812600,-0.27,-314.4290963,1.192,0,14.33339876,0.959429757,-0.018638346,3.08,298.012,11176.41016,14319.49023,7086.5,6039.689941,3024.389893,58065.46875,19371,129.5716003,136.7951276,124.5913919,135.1541828,122.1510006,136.2145961,108.0874051,39.59262793,-3.795835907,-3.720542185,-0.075293723,4.64000048,112.0599976,10459437200,49.31731285,25.01354564,29.06999969,"Amazon faces fines of up to $200,000 in Russia over banned content -agencies","Amazon.com Inc faces fines of up to 12 million roubles ($204,000) in Russia for failing to delete content Moscow deems illegal, news agencies reported on Tuesday, in what would be a first penalty of this kind for the U.S. tech giant.",https://www.reuters.com/technology/amazon-faces-fines-up-200000-russia-over-banned-content-agencies-2022-10-04/,reuters.com,10,amazoncom inc face fine million rouble russia failing delete content moscow deems illegal news agency reported tuesday would first penalty kind u tech giant,-0.6908,-0.6908,-0.011090714,-0.679709286,Negative Impact
05/10/2022,118.58,121.75,117.69,120.95,120.95,48217500,-0.27,-314.4290963,1.192,0,14.33339876,0.959429757,-0.018638346,3.08,298.012,11148.63965,14262.03027,7052.600098,5985.459961,3024.389893,58065.46875,19235.09961,129.6944003,136.54979,124.4485921,135.0128476,121.7245007,135.3632042,108.0857971,42.09433288,-3.319077311,-3.64024921,0.3211718988,4.582143511,112.2787976,10411219700,70.27666654,46.81896565,28.54999924,Amazon suspends at least 50 warehouse workers who protested after fire,"NEW YORK ÃÂÃÂ Amazon has suspended at least 50 warehouse employees who refused to work their shifts following a trash compactor fire at one of its New York facilities, according to union organizers.",https://www.marketwatch.com/story/amazon-suspends-at-least-50-warehouse-workers-who-protested-after-fire-01665005386,marketwatch.com,8,new york amazon suspended least warehouse employee refused work shift following trash compactor fire one new york facility according union organizer,-0.7184,-0.57472,0.05553571429,-0.630255714,Negative Impact
06/10/2022,120.77,121.53,119.50,120.30,120.30,42253800,-0.27,-314.4290963,1.192,0,14.33339876,0.959429757,-0.018638346,3.08,298.012,11073.30957,14087.37988,6997.299805,5936.419922,3024.389893,58222.10156,18979,129.6810004,136.3158951,124.2859023,134.8664511,121.2485004,134.351558,108.1454429,44.89086418,-2.959575619,-3.504114492,0.544538873,4.328571865,112.4932217,10368965900,65.13837549,61.57745163,30.52000046,Fire reported at another Amazon warehouse in New York,NEW YORK ÃÂÃÂ A fire broke out late Wednesday at an Amazon facility in upstate New York that's voting in a union election next week.,https://www.marketwatch.com/story/fire-reported-at-another-amazon-warehouse-in-new-york-01665089277,marketwatch.com,8,new york fire broke late wednesday amazon facility upstate new york thats voting union election next week,-0.5423,-0.43384,0.2562185714,-0.690058571,Negative Impact
07/10/2022,118,118.17,113.88,114.56,114.56,54678000,-0.27,-314.4290963,1.192,0,14.33339876,0.959429757,-0.018638346,3.08,298.012,10652.40039,13798.25977,6991.100098,5866.939941,3024.389893,58191.28906,18583.09961,129.5266003,136.03661,123.9044943,134.6643969,120.3130001,132.4373067,108.1886935,36.05741888,-3.102079567,-3.423707507,0.3216279397,4.579286848,112.7033572,10314287900,20.25931277,51.8914516,31.36000061,Should Investors Buy Alphabet Stock Before It's Too Late?,"Alphabet recently dipped below the $100 a share level after routinely trading over $2,000 pre-split. The lower price makes the stock more attainable to many investors and offers a great chance to buy Alphabet shares for the long haul.",https://www.zacks.com/stock/news/1989462/should-investors-buy-alphabet-stock-before-it-s-too-late,zacks.com,8,alphabet recently dipped share level routinely trading presplit lower price make stock attainable many investor offer great chance buy alphabet share long haul,0.8074,0.64592,0.1842454545,0.4616745455,Positive Impact
10/10/2022,115.1,116.25,112.43,113.67,113.67,42339700,-0.27,-314.4290963,1.192,0,14.33339876,0.959429757,-0.018638346,3.08,298.012,10542.09961,13693.57031,6959.299805,5840.549805,2974.149902,57991.10938,18583.09961,129.1010004,135.749775,123.5031415,134.4554974,119.1740002,128.972225,109.3757754,37.70207214,-3.249373728,-3.388840751,0.1394670231,4.600715092,123,10271948200,13.76068359,33.05279062,32.45000076,Masters Of Cloud: Winter Is Coming,"The global macro and geopolitical landscape have changed significantly over 2022, leading to fears of stagflation. Amid fears of weakness, cloud providers have also seen some demand challenges.",https://seekingalpha.com/article/4545733-masters-of-cloud-winter-is-coming,seekingalpha.com,6,global macro geopolitical landscape changed significantly leading fear stagflation amid fear weakness cloud provider also seen demand challenge,-0.8555,-0.5133,0.1401722222,-0.653472222,Negative Impact
11/10/2022,112.71,115.48,110.39,112.21,112.21,56432200,-0.27,-314.4290963,1.192,0,14.33339876,0.959429757,-0.018638346,3.08,298.012,10426.19043,13608.08984,6885.200195,5833.200195,2979.790039,57147.32031,18216.69922,128.6374004,135.4554825,123.0602732,134.2341491,118.4435001,128.0174576,108.8695427,40.24652939,-3.4442124,-3.399915081,-0.044297319,4.585000719,122.7886,10215516000,14.43298657,16.15099431,33.63000107,Amazon workers hold walkouts on Prime Day in Georgia and Illinois,"Amazon employees at two locations held walkouts Tuesday at the start of the company's second Prime Day of the year, making demands of the retail giant.",https://www.foxbusiness.com/economy/amazon-workers-hold-walkouts-prime-day-two-locations,foxbusiness.com,5,amazon employee two location held walkout tuesday start company second prime day year making demand retail giant,-0.2732,-0.1366,0.3360216667,-0.472621667,Negative Impact
12/10/2022,112.49,113.83,111.40,112.90,112.90,45728700,-0.27,-314.4290963,1.192,0,14.33339876,0.959429757,-0.018638346,3.08,298.012,10417.09961,13546.7998,6826.200195,5818.470215,3025.51001,57625.91016,18206.30078,128.2122003,135.1716351,122.6618311,134.0218691,117.6610001,126.2661514,109.0558487,43.08994581,-3.502570567,-3.420446178,-0.082124389,4.577857971,122.292656,10261244700,19.90485341,16.03284119,33.56999969,Amazon cost cuts under Jassy reflect changing reality after 25 years of growth over profit,"With Amazon's stock down 33% this year and recession concerns mounting, the company is in the unfamiliar position of cutting costs.",https://www.cnbc.com/2022/10/12/amazon-cost-cuts-under-andy-jassy-reflect-new-reality-after-25-years.html,cnbc.com,9,amazon stock year recession concern mounting company unfamiliar position cutting cost,-0.3818,-0.34362,0.2175235714,-0.561143571,Negative Impact
13/10/2022,107.88,113.44,105.35,112.53,112.53,86868100,-0.27,-314.4290963,1.192,0,14.33339876,0.959429757,-0.018638346,3.08,298.012,10649.15039,13888.96973,6850.299805,5879.189941,3016.360107,57235.32813,18613.59961,127.6724002,134.8809801,122.2645044,133.8080196,116.9735001,124.8450732,109.101927,47.82608696,-3.537893332,-3.443935609,-0.093957723,4.780715397,121.8165497,10174376600,40.6798849,25.00590829,31.94000053,Here's Why I Just Opened a Position in Amazon's Stock,"I may have missed the stock once, but I'm not about to miss it again.",https://www.fool.com/investing/2022/10/13/heres-why-i-just-opened-a-position-in-amazons-stoc/,fool.com,7,may missed stock im miss,-0.4215,-0.29505,0.1590604762,-0.454110476,Negative Impact
14/10/2022,114.1,114.96,106.60,106.90,106.90,67737300,-0.27,-314.4290963,1.192,0,14.33339876,0.959429757,-0.018638346,3.08,298.012,10321.38965,13607.30957,6858.799805,5931.919922,3071.98999,57919.96875,18326.40039,126.9590001,134.5694751,121.6619748,133.5402781,116.1420002,124.5897063,107.6942941,37.50378465,-3.974366581,-3.550021803,-0.424344777,5.077144078,120.8285566,10106639300,8.78188622,23.12220818,32.02000046,"Amazon's Second Sales Event Comes In 25% Lower, Analyst Says","Amazon stock traded down during the retailer's second major sales event of the year, with gross merchandise sales falling 25%. The post Amazon's Second Sales Event Comes In 25% Lower, Analyst Says appeared first on Investor's Business Daily.",https://www.investors.com/news/technology/amazon-stock-prime-day-early-access-a-test-for-holiday-sales/,investors.com,5,amazon stock traded retailer second major sale event year gross merchandise sale falling post amazon second sale event come lower analyst say appeared first investor business daily,-0.5423,-0.27115,0.020885,-0.292035,Negative Impact
17/10/2022,110.11,114.19,110.09,113.79,113.79,62782000,-0.27,-314.4290963,1.192,0,14.33339876,0.959429757,-0.018638346,3.08,298.012,10675.7998,13923.20996,6920.200195,6040.660156,3084.939941,58410.98047,18621,126.4188,134.2952026,121.35327,133.343758,115.5985001,123.0824538,108.1145463,49.20837231,-3.721411293,-3.584299701,-0.137111592,5.221430097,119.8998432,10169421300,47.81870658,32.4268259,31.37000084,AWS to Launch an Infrastructure Region in Thailand,"SEATTLE--(BUSINESS WIRE)--Amazon Web Services (AWS), an Amazon.com, Inc. company (NASDAQ:AMZN), today announced plans to open an infrastructure Region in Thailand.",https://www.businesswire.com/news/home/20221017006079/en/AWS-to-Launch-an-Infrastructure-Region-in-Thailand/,businesswire.com,5,seattlebusiness wireamazon web service aws amazoncom inc company nasdaqamzn today announced plan open infrastructure region thailand,0,0,0.3001823077,-0.300182308,Negative Impact
18/10/2022,119.06,119.52,114.79,116.36,116.36,65607400,-0.27,-314.4290963,1.192,0,14.33339876,0.959429757,-0.018638346,3.08,298.012,10772.40039,14089.2002,6936.700195,6067,3080.959961,58960.60156,18798.19922,125.9578,134.0434176,121.1574555,133.1747653,115.307,122.1353921,108.4786079,47.83634717,-3.275803485,-3.522600458,0.246796973,5.280715942,105.3499985,10235028700,62.37961011,39.66006764,30.5,AWS startet Infrastrukturregion in Thailand,"SEATTLE--(BUSINESS WIRE)--Amazon Web Services (AWS), ein Unternehmen von Amazon.com, Inc. (NASDAQ:AMZN), gab heute PlÃÂÃÂ¤ne zur ErÃÂÃÂ¶ffnung einer Infrastrukturregion in Thailand bekannt. Die neue AWS-Region Asien-Pazifik (Bangkok) wird aus drei Availability Zones bestehen, die zu den bestehenden 87 Availability Zones in 27 geografischen Regionen hinzukommen. Weltweit hat AWS jetzt PlÃÂÃÂ¤ne fÃÂÃÂ¼r 24 weitere Availability Zones in acht weiteren AWS-Regionen in Australien, Kanada, Indien, Israel, Neuseeland, Spanien, der Schweiz und Thailand angekÃÂÃÂ¼ndigt. Die kommende AWS-Region in Thailand wird es Entwicklern, Startups und Unternehmen sowie Regierungs-, Bildungs- und gemeinnÃÂÃÂ¼tzigen Organisationen ermÃÂÃÂ¶glichen, ihre Anwendungen auszufÃÂÃÂ¼hren und Endbenutzer von AWS-Rechenzentren in Thailand aus zu bedienen. Damit wird sichergestellt, dass Kunden, die ihre Daten in Thailand behalten mÃÂÃÂ¶chten, dies auch tun kÃÂÃÂ¶nnen. DarÃÂÃÂ¼ber hinaus plant AWS als Teil seines Engagements in der Region eine geschÃÂÃÂ¤tzte Investition von mehr als 5 Milliarden US-Dollar (190 Milliarden Baht) in Thailand ÃÂÃÂ¼ber 15 Jahre. Weitere Informationen ÃÂÃÂ¼ber AWS Global Infrastructure finden Sie unter aws.amazon.com/about-aws/global-infrastructure. ÃÂÃÂWir setzen uns dafÃÂÃÂ¼r ein, die digitale Transformation Thailands durch unsere Investitionen in die lokale Infrastruktur und unser hohes Innovationstempo zu unterstÃÂÃÂ¼tzen und den Kunden in Thailand dabei zu helfen, das volle Potenzial der Cloud auszuschÃÂÃÂ¶pfen, um die Art und Weise zu verÃÂÃÂ¤ndern, wie Unternehmen und Institutionen ihren Interessengruppen begegnenÃÂÃÂ, sagte Prasad Kalyanaraman, Vice President of Infrastructure Services bei AWS. ÃÂÃÂDie AWS-Region Asien-Pazifik (Bangkok) wird es Unternehmen ermÃÂÃÂ¶glichen, mit AWS-Technologien wie kÃÂÃÂ¼nstlicher Intelligenz und maschinellem Lernen, Datenanalyse und dem Internet der Dinge zu arbeiten. Mit diesen neuen Tools ermÃÂÃÂ¶glicht AWS Regierungen eine bessere Interaktion mit den BÃÂÃÂ¼rgern, Unternehmen Innovationen fÃÂÃÂ¼r ihre nÃÂÃÂ¤chste Wachstumsphase und Unternehmern den Aufbau von GeschÃÂÃÂ¤ften und den Wettbewerb auf globaler Ebene.ÃÂÃÂ ÃÂÃÂDer Plan von AWS, Rechenzentren in Thailand zu errichten, ist ein bedeutender Meilenstein, der mehr Unternehmen fortschrittliche Cloud-Computing-Dienste zur VerfÃÂÃÂ¼gung stellen und uns dabei helfen wird, unser Thailand 4.0-Ziel zu erreichen, eine digitalisierte, wertorientierte Wirtschaft zu schaffenÃÂÃÂ, sagte Seine Exzellenz Supattanapong Punmeechaow, stellvertretender Premierminister von Thailand und Energieminister. ÃÂÃÂDie kÃÂÃÂ¶nigliche Regierung Thailands freut sich, mit AWS, dem weltweit fÃÂÃÂ¼hrenden Cloud-Service-Anbieter, zusammenzuarbeiten, um eine sichere und robuste Cloud-Infrastruktur von Weltklasse nach Thailand zu bringen. Die Investition von AWS wird die WettbewerbsfÃÂÃÂ¤higkeit des Landes verbessern, langfristig erhebliche wirtschaftliche Vorteile bringen und zum Aufbau hochqualifizierter ArbeitskrÃÂÃÂ¤fte beitragen.ÃÂÃÂ ÃÂÃÂEine AWS-Region in Thailand wird Unternehmen und BehÃÂÃÂ¶rden dabei helfen, verbesserte digitale Dienste bereitzustellen, von denen die BÃÂÃÂ¼rger unseres Landes in den kommenden Jahrzehnten profitieren werdenÃÂÃÂ, sagte Seine Exzellenz Chaiwut Thanakamanusorn, Minister des thailÃÂÃÂ¤ndischen Ministeriums fÃÂÃÂ¼r digitale Wirtschaft und Gesellschaft (MDES). ÃÂÃÂDas MDES und AWS arbeiten zusammen, um die digitale Transformation der Regierung zu unterstÃÂÃÂ¼tzen, indem sie die bestehende Infrastruktur modernisieren und den Betrieb verbessern. Die Investition von AWS wird unser Land der digitalen Zukunft Thailands einen Schritt nÃÂÃÂ¤her bringen.ÃÂÃÂ ÃÂÃÂCloud-Dienste sind eine der wichtigsten TriebkrÃÂÃÂ¤fte der digitalen Wirtschaft. Wir begrÃÂÃÂ¼ÃÂÃÂen die PlÃÂÃÂ¤ne von AWS, eine Region in Thailand zu errichten, die dazu beitragen wird, unsere Position als Innovationszentrum in Asien und als Top-Ziel fÃÂÃÂ¼r Investitionen zu stÃÂÃÂ¤rkenÃÂÃÂ, sagte Narit Therdsteerasukdi, GeneralsekretÃÂÃÂ¤r des Thailand Board of Investment. ÃÂÃÂDie AWS-Region Asien-Pazifik (Bangkok) wird dazu beitragen, die globale WettbewerbsfÃÂÃÂ¤higkeit des Landes zu stÃÂÃÂ¤rken und gleichzeitig die Innovation und wirtschaftliche ProduktivitÃÂÃÂ¤t in allen Branchen in Thailand zu fÃÂÃÂ¶rdern.ÃÂÃÂ AWS-Regionen bestehen aus Availability Zones, in denen die Infrastruktur an getrennten und unterschiedlichen geografischen Standorten untergebracht ist. Diese sind weit genug voneinander entfernt, um das Risiko, dass ein einzelnes Ereignis die GeschÃÂÃÂ¤ftskontinuitÃÂÃÂ¤t der Kunden beeintrÃÂÃÂ¤chtigt, deutlich zu verringern, und dennoch nahe genug, um eine geringe Latenz fÃÂÃÂ¼r HochverfÃÂÃÂ¼gbarkeitsanwendungen zu bieten, die mehrere Availability Zones nutzen. Jede Availability Zone verfÃÂÃÂ¼gt ÃÂÃÂ¼ber eine unabhÃÂÃÂ¤ngige Stromversorgung, KÃÂÃÂ¼hlung und physische Sicherheit und ist ÃÂÃÂ¼ber redundante Netzwerke mit extrem niedriger Latenz verbunden. AWS-Kunden, die Wert auf hohe VerfÃÂÃÂ¼gbarkeit legen, kÃÂÃÂ¶nnen ihre Anwendungen so konzipieren, dass sie in mehreren Availability Zones und ÃÂÃÂ¼ber mehrere Regionen hinweg ausgefÃÂÃÂ¼hrt werden, um eine noch grÃÂÃÂ¶ÃÂÃÂere Fehlertoleranz zu erreichen. Die neue AWS-Region Asien-Pazifik (Bangkok) ermÃÂÃÂ¶glicht es Kunden mit PrÃÂÃÂ¤ferenzen oder Anforderungen an die Datenresidenz, Daten sicher in Thailand zu speichern und gleichzeitig eine noch geringere Latenz im ganzen Land zu bieten. Kunden von Startups ÃÂÃÂ¼ber Unternehmen bis hin zu Regierungsorganisationen und gemeinnÃÂÃÂ¼tzigen Organisationen kÃÂÃÂ¶nnen fortschrittliche Technologien aus der weltweit fÃÂÃÂ¼hrenden Cloud nutzen, um Innovationen voranzutreiben. AWS bietet das breiteste und tiefste Portfolio an Diensten, darunter Analysen, Datenverarbeitung, Datenbanken, Internet of Things (IoT), maschinelles Lernen, mobile Dienste, Speicher und andere Cloud-Technologien. Organisationen in Thailand gehÃÂÃÂ¶ren zu den Millionen aktiver Kunden, die AWS in mehr als 190 LÃÂÃÂ¤ndern auf der ganzen Welt nutzen. Zu den thailÃÂÃÂ¤ndischen Unternehmen, die AWS fÃÂÃÂ¼r die AusfÃÂÃÂ¼hrung ihrer Arbeitslasten wÃÂÃÂ¤hlen, um Innovationen zu beschleunigen, die AgilitÃÂÃÂ¤t zu erhÃÂÃÂ¶hen und Kosteneinsparungen zu erzielen, gehÃÂÃÂ¶ren 2C2P, CP All Plc, Digital Economy Promotion Agency, Energy Response Co. Ltd. (ENRES), Papyrus Studio, PTT Global Public Company Limited, PTT Oil and Retail Business Public Company Limited, Siam Cement Group, Sukhothai Thammathirat Open University, The Stock Exchange of Thailand und andere. AnwendungsfÃÂÃÂ¤lle, die zeigen, wie diese thailÃÂÃÂ¤ndischen Unternehmen AWS-Services nutzen, um ihr GeschÃÂÃÂ¤ft zu transformieren, finden Sie hier: press.aboutamazon.com/news-releases/news-release-details/aws-launch-infrastructure-region-thailand Die in Thailand ansÃÂÃÂ¤ssigen Partner sind Teil des AWS Partner Network (APN), zu dem mehr als 100.000 unabhÃÂÃÂ¤ngige Softwareanbieter (ISVs) und Systemintegratoren (SIs) auf der ganzen Welt gehÃÂÃÂ¶ren. AWS-Partner entwickeln innovative LÃÂÃÂ¶sungen und Services auf AWS, und das APN bietet Kunden geschÃÂÃÂ¤ftliche, technische, Marketing- und Go-to-Market-UnterstÃÂÃÂ¼tzung. AWS SIs, Beratungspartner und ISVs helfen Kunden aus Unternehmen und dem ÃÂÃÂ¶ffentlichen Sektor bei der Migration zu AWS, bei der Bereitstellung geschÃÂÃÂ¤ftskritischer Anwendungen und bieten eine breite Palette an ÃÂÃÂberwachungs-, Automatisierungs- und Verwaltungsservices fÃÂÃÂ¼r Kundenumgebungen. Beispiele fÃÂÃÂ¼r AWS-Partner in Thailand sind DailiTech, G-Able Public Company Limited, National Telecom Public Company Limited, NTT (Thailand) Ltd. und True IDC. AWS-ISVs in Thailand, darunter 2C2P und Amity, nutzen AWS bereits, um ihre Software an Kunden auf der ganzen Welt zu liefern, und planen, ihre thailÃÂÃÂ¤ndischen Kunden beim Start von der AWS-Region Asien-Pazifik (Bangkok) aus zu bedienen. Die vollstÃÂÃÂ¤ndige Liste der APN-Mitglieder finden Sie unter aws.amazon.com/partners, und AnwendungsfÃÂÃÂ¤lle von DailiTech, National Telecom und NTT (Thailand) Ltd. finden Sie unter: press.aboutamazon.com/news-releases/news-release-details/aws-launch-infrastructure-region-thailand AWS-Investitionen in Thailand Die neue AWS-Region Asien-Pazifik (Bangkok) ist die jÃÂÃÂ¼ngste der laufenden Investitionen von AWS in Thailand, um Kunden fortschrittliche und sichere Cloud-Technologien zu bieten. Seit 2020 hat AWS 10 Amazon CloudFront-Edge-Standorte in Bangkok eingefÃÂÃÂ¼hrt. Amazon CloudFront ist ein hochsicheres und programmierbares Content Delivery Network (CDN), das die Bereitstellung von Daten, Videos, Anwendungen und APIs fÃÂÃÂ¼r Benutzer weltweit mit geringer Latenz und hohen ÃÂÃÂbertragungsgeschwindigkeiten beschleunigt. Im Jahr 2020 fÃÂÃÂ¼hrte AWS in Thailand AWS Outposts ein. AWS Outposts ist eine Familie vollstÃÂÃÂ¤ndig verwalteter LÃÂÃÂ¶sungen, die AWS-Infrastruktur und -Services an praktisch jedem Standort oder Edge-Standort bereitstellen, um ein wirklich konsistentes Hybrid-Erlebnis zu ermÃÂÃÂ¶glichen. AWS plant, seine Investitionen in Thailand mit dem Start einer neuen AWS Local Zone in Bangkok zu vertiefen. AWS Local Zones sind eine Art von AWS-Infrastrukturbereitstellung, die Rechen-, Speicher-, Datenbank- und andere ausgewÃÂÃÂ¤hlte Services nÃÂÃÂ¤her an groÃÂÃÂen BevÃÂÃÂ¶lkerungs-, Industrie- und IT-Zentren platziert und es Kunden ermÃÂÃÂ¶glicht, Anwendungen, die eine Latenz im einstelligen Millisekundenbereich benÃÂÃÂ¶tigen, an Endbenutzer zu liefern. Um das Wachstum der Cloud-EinfÃÂÃÂ¼hrung in Thailand zu unterstÃÂÃÂ¼tzen, investiert AWS weiterhin in die Weiterbildung von lokalen Entwicklern, Studenten und der nÃÂÃÂ¤chsten Generation von IT-FÃÂÃÂ¼hrungskrÃÂÃÂ¤ften in Thailand durch Programme wie AWS re/Start, AWS Academy und AWS Educate. Diese AWS-Bildungsprogramme helfen Lernenden aller HintergrÃÂÃÂ¼nde und Erfahrungen bei der Vorbereitung auf Karrieren in der Cloud. Von Hochschulkursen bis hin zu Vollzeitschulungsprogrammen und Lerninhalten zum Selbststudium bieten die AWS-Bildungsprogramme Zugang zu Schulungen, die Einzelpersonen dabei helfen kÃÂÃÂ¶nnen, ihre Cloud-Karriere zu beginnen oder auszubauen. Acht thailÃÂÃÂ¤ndische Hochschuleinrichtungen in Bangkok, Chiang Rai und Pathum Thani haben AWS Academy-Kurse in ihre LehrplÃÂÃÂ¤ne aufgenommen. AWS arbeitet auch direkt mit Unternehmen wie der Siam Cement Group zusammen, um gefragte Cloud-FÃÂÃÂ¤higkeiten aufzubauen und Mitarbeiter zu schulen. AWS plant, mit dem thailÃÂÃÂ¤ndischen Ministerium fÃÂÃÂ¼r digitale Wirtschaft und Gesellschaft an einem Qualifizierungsplan zusammenzuarbeiten und UnterstÃÂÃÂ¼tzung bei der Schulung von mehr als 1.200 Mitarbeitern mit Cloud-FÃÂÃÂ¤higkeiten, digitalen On-Demand-Kursen und moderierten Schulungsveranstaltungen zu leisten, damit die Mitarbeiter der Regierung die erforderlichen FÃÂÃÂ¤higkeiten entwickeln kÃÂÃÂ¶nnen, um Cloud-Technologien in groÃÂÃÂem Umfang zu implementieren, bessere datengesteuerte GeschÃÂÃÂ¤ftsentscheidungen zu treffen und neue Dienste zu entwickeln, um bessere Ergebnisse fÃÂÃÂ¼r die BÃÂÃÂ¼rger zu erzielen. Um das Unternehmertum in Thailand weiter zu fÃÂÃÂ¶rdern, bietet AWS ÃÂÃÂ¼ber das AWS Activate-Programm UnterstÃÂÃÂ¼tzung fÃÂÃÂ¼r Startups im FrÃÂÃÂ¼hstadium. Dieses Programm bietet Zugang zu Beratung und persÃÂÃÂ¶nlichen GesprÃÂÃÂ¤chen mit AWS-Experten, technischen Support, Business-Mentoring und die MÃÂÃÂ¶glichkeit, bis zu 100.000 US-Dollar an AWS-Service-Gutschriften zu erhalten - alles kostenlos. AWS arbeitet auch mit der Risikokapitalgemeinschaft, Startup-Beschleunigern und Inkubatoren zusammen, um Startups beim Wachstum in der Cloud zu unterstÃÂÃÂ¼tzen. In Thailand gehÃÂÃÂ¶ren dazu Beschleunigerorganisationen wie AIS The Startup und Stormbreaker, die das schnelle Wachstum ihrer Portfoliounternehmen unterstÃÂÃÂ¼tzen. Im Jahr 2021 hat AWS sein Startup Ramp-Programm auf ASEAN ausgeweitet. Dieses Programm dient der UnterstÃÂÃÂ¼tzung von Startup-Unternehmern im FrÃÂÃÂ¼hstadium, die LÃÂÃÂ¶sungen in den Bereichen Gesundheit, digitale Verwaltung, intelligente StÃÂÃÂ¤dte, Landwirtschaft und Raumfahrttechnologie entwickeln, starten und ausbauen. AWS Startup Ramp arbeitet daran, Barrieren fÃÂÃÂ¼r Unternehmer zu beseitigen, die im ÃÂÃÂ¶ffentlichen Sektor etwas bewirken mÃÂÃÂ¶chten, indem es technische Design- und ArchitekturÃÂÃÂ¼berprÃÂÃÂ¼fungen, Mentoren, Kredite und UnterstÃÂÃÂ¼tzung bei MarkteinfÃÂÃÂ¼hrungsplÃÂÃÂ¤nen bietet, um bei der BewÃÂÃÂ¤ltigung komplexer regulatorischer und Sicherheitsanforderungen zu helfen. Startups, die sich noch in der Anfangsphase befinden und daran arbeiten, das Produkt an den Markt anzupassen und erste Kunden zu finden, kÃÂÃÂ¶nnen sich als Startup Ramp Innovators bewerben. Unternehmen mit zahlenden Kunden, die auf Wachstum und Skalierung ausgerichtet sind, kÃÂÃÂ¶nnen sich als Startup Ramp Members bewerben, um die Vorteile des Programms zu nutzen. Seit 2017 unterstÃÂÃÂ¼tzt AWS EdStart, der AWS-Startup-Beschleuniger fÃÂÃÂ¼r Bildungstechnologie, Unternehmer beim Aufbau der nÃÂÃÂ¤chsten Generation von Online-Lern-, Analyse- und Campus-Management-LÃÂÃÂ¶sungen. Zu den AWS EdStart-Mitgliedern in Thailand gehÃÂÃÂ¶ren Gantik, OpenDurian und Vonder. Durch die Nutzung von AWS EdStart haben diese Mitglieder innovative LÃÂÃÂ¶sungen entwickelt, die SchÃÂÃÂ¼lern helfen, fundierte Entscheidungen auf ihrem Bildungsweg zu treffen, ErfahrungslernmÃÂÃÂ¶glichkeiten fÃÂÃÂ¼r Grund- und Sekundarschulen im ganzen Land bieten und virtuelles Mentoring zwischen SchÃÂÃÂ¼lern und Unternehmern ermÃÂÃÂ¶glichen. Bekenntnis zur Nachhaltigkeit Amazon hat sich im Rahmen des Klimaversprechens (The Climate Pledge) dazu verpflichtet, nachhaltiger zu werden und bis 2040, also 10 Jahre vor dem Pariser Abkommen, eine Netto-Null-Kohlenstoffbilanz fÃÂÃÂ¼r seine gesamte GeschÃÂÃÂ¤ftstÃÂÃÂ¤tigkeit zu erreichen. Amazon ist MitbegrÃÂÃÂ¼nder des Klimaversprechens und wurde 2019 dessen Erstunterzeichner. Im Rahmen seiner Verpflichtung zum Climate Pledge ist Amazon auf dem Weg, seinen Betrieb bis 2025 zu 100 % mit erneuerbarer Energie zu versorgen, fÃÂÃÂ¼nf Jahre vor dem ursprÃÂÃÂ¼nglichen Ziel fÃÂÃÂ¼r 2030. Amazon ist der weltweit grÃÂÃÂ¶ÃÂÃÂte EinkÃÂÃÂ¤ufer von erneuerbaren Energien, und bis Ende 2021 hat das Unternehmen 85 % erneuerbare Energien in seinem gesamten Unternehmen erreicht. Weitere Informationen zum Ansatz von Amazon finden Sie in seiner ÃÂÃÂ¶ffentlichen Methodik. Unternehmen, die Rechenlasten in die AWS Cloud verlagern, kÃÂÃÂ¶nnen von den Nettoeffekten der NachhaltigkeitsbemÃÂÃÂ¼hungen von Amazon profitieren, um ihren CO2-FuÃÂÃÂabdruck zu reduzieren. ÃÂÃÂber Amazon Web Services Seit ÃÂÃÂ¼ber 15 Jahren ist Amazon Web Services das umfassendste und am weitesten verbreitete Cloud-Angebot der Welt. AWS hat seine Services kontinuierlich erweitert, um praktisch jede Cloud-Arbeitslast zu unterstÃÂÃÂ¼tzen, und bietet jetzt mehr als 200 voll ausgestattete Services fÃÂÃÂ¼r Datenverarbeitung, Speicherung, Datenbanken, Netzwerke, Analysen, maschinelles Lernen und kÃÂÃÂ¼nstliche Intelligenz (KI), Internet der Dinge (IoT), MobilgerÃÂÃÂ¤te, Sicherheit, Hybrid, Virtual und Augmented Reality (VR und AR), Medien sowie Anwendungsentwicklung, -bereitstellung und -verwaltung aus 87 Availability Zones in 27 geografischen Regionen, mit angekÃÂÃÂ¼ndigten PlÃÂÃÂ¤nen fÃÂÃÂ¼r 24 weitere Availability Zones und acht weitere AWS-Regionen in Australien, Kanada, Indien, Israel, Neuseeland, Spanien, der Schweiz und Thailand. Millionen von Kunden - darunter die am schnellsten wachsenden Startups, die grÃÂÃÂ¶ÃÂÃÂten Unternehmen und fÃÂÃÂ¼hrende RegierungsbehÃÂÃÂ¶rden - vertrauen auf AWS, um ihre Infrastruktur zu betreiben, agiler zu werden und Kosten zu senken. Weitere Informationen ÃÂÃÂ¼ber AWS finden Sie unter aws.amazon.com. ÃÂÃÂber Amazon Amazon wird von vier Grundprinzipien geleitet: Fokus auf Kund:innen statt auf den Wettbewerb, Leidenschaft fÃÂÃÂ¼rs Erfinden, Verpflichtung zu operativer Exzellenz und langfristiges Denken. Amazon strebt danach, das kundenorientierteste Unternehmen, der beste Arbeitgeber und der sicherste Arbeitsplatz der Welt zu sein. Kundenrezensionen, 1-Click-Shopping, personalisierte Empfehlungen, Prime, Versand durch Amazon, AWS, Kindle Direct Publishing, Kindle, Career Choice, Fire Tablets, Fire TV, Amazon Echo, Alexa, Just-Walk-Out-Technologie, Amazon Studios und The Climate Pledge sind nur einige Beispiele, fÃÂÃÂ¼r die Amazon Pionierarbeit geleistet hat. Mehr Informationen auf amazon.com/about und auf Twitter unter @AmazonNews. Die Ausgangssprache, in der der Originaltext verÃÂÃÂ¶ffentlicht wird, ist die offizielle und autorisierte Version. ÃÂÃÂbersetzungen werden zur besseren VerstÃÂÃÂ¤ndigung mitgeliefert. Nur die Sprachversion, die im Original verÃÂÃÂ¶ffentlicht wurde, ist rechtsgÃÂÃÂ¼ltig. Gleichen Sie deshalb ÃÂÃÂbersetzungen mit der originalen Sprachversion der VerÃÂÃÂ¶ffentlichung ab.",https://www.businesswire.com/news/home/20221017006080/de/,businesswire.com,5,seattlebusiness wireamazon web service aws ein unternehmen von amazoncom inc nasdaqamzn gab heute plne zur erffnung einer infrastrukturregion thailand bekannt die neue awsregion asienpazifik bangkok wird au drei availability zone bestehen die zu den bestehenden availability zone geografischen regionen hinzukommen weltweit hat aws jetzt plne fr weitere availability zone acht weiteren awsregionen australien kanada indien israel neuseeland spanien der schweiz und thailand angekndigt die kommende awsregion thailand wird e entwicklern startup und unternehmen sowie regierungs bildungs und gemeinntzigen organisationen ermglichen ihre anwendungen auszufhren und endbenutzer von awsrechenzentren thailand au zu bedienen damit wird sichergestellt das kunden die ihre daten thailand behalten mchten dy auch tun knnen darber hinaus plant aws al teil seine engagement der region eine geschtzte investition von mehr al milliarden usdollar milliarden baht thailand ber jahre weitere informationen ber aws global infrastructure finden sie unter awsamazoncomaboutawsglobalinfrastructure wir setzen un dafr ein die digitale transformation thailand durch unsere investitionen die lokale infrastruktur und unser hohes innovationstempo zu untersttzen und den kunden thailand dabei zu helfen da volle potenzial der cloud auszuschpfen um die art und weise zu verndern wie unternehmen und institutionen ihren interessengruppen begegnen sagte prasad kalyanaraman vice president infrastructure service bei aws die awsregion asienpazifik bangkok wird e unternehmen ermglichen mit awstechnologien wie knstlicher intelligenz und maschinellem lernen datenanalyse und dem internet der dinge zu arbeiten mit diesen neuen tool ermglicht aws regierungen eine bessere interaktion mit den brgern unternehmen innovationen fr ihre nchste wachstumsphase und unternehmern den aufbau von geschften und den wettbewerb auf globaler ebene der plan von aws rechenzentren thailand zu errichten ist ein bedeutender meilenstein der mehr unternehmen fortschrittliche cloudcomputingdienste zur verfgung stellen und un dabei helfen wird unser thailand ziel zu erreichen eine digitalisierte wertorientierte wirtschaft zu schaffen sagte seine exzellenz supattanapong punmeechaow stellvertretender premierminister von thailand und energieminister die knigliche regierung thailand freut sich mit aws dem weltweit fhrenden cloudserviceanbieter zusammenzuarbeiten um eine sichere und robuste cloudinfrastruktur von weltklasse nach thailand zu bringen die investition von aws wird die wettbewerbsfhigkeit de landes verbessern langfristig erhebliche wirtschaftliche vorteile bringen und zum aufbau hochqualifizierter arbeitskrfte beitragen eine awsregion thailand wird unternehmen und behrden dabei helfen verbesserte digitale dienste bereitzustellen von denen die brger unseres landes den kommenden jahrzehnten profitieren werden sagte seine exzellenz chaiwut thanakamanusorn minister de thailndischen ministeriums fr digitale wirtschaft und gesellschaft mdes da mdes und aws arbeiten zusammen um die digitale transformation der regierung zu untersttzen indem sie die bestehende infrastruktur modernisieren und den betrieb verbessern die investition von aws wird unser land der digitalen zukunft thailand einen schritt nher bringen clouddienste sind eine der wichtigsten triebkrfte der digitalen wirtschaft wir begren die plne von aws eine region thailand zu errichten die dazu beitragen wird unsere position al innovationszentrum asien und al topziel fr investitionen zu strken sagte narit therdsteerasukdi generalsekretr de thailand board investment die awsregion asienpazifik bangkok wird dazu beitragen die globale wettbewerbsfhigkeit de landes zu strken und gleichzeitig die innovation und wirtschaftliche produktivitt allen branchen thailand zu frdern awsregionen bestehen au availability zone denen die infrastruktur getrennten und unterschiedlichen geografischen standorten untergebracht ist diese sind weit genug voneinander entfernt um da risiko das ein einzelnes ereignis die geschftskontinuitt der kunden beeintrchtigt deutlich zu verringern und dennoch nahe genug um eine geringe latenz fr hochverfgbarkeitsanwendungen zu bieten die mehrere availability zone nutzen jede availability zone verfgt ber eine unabhngige stromversorgung khlung und physische sicherheit und ist ber redundante netzwerke mit extrem niedriger latenz verbunden awskunden die wert auf hohe verfgbarkeit legen knnen ihre anwendungen konzipieren das sie mehreren availability zone und ber mehrere regionen hinweg ausgefhrt werden um eine noch grere fehlertoleranz zu erreichen die neue awsregion asienpazifik bangkok ermglicht e kunden mit prferenzen oder anforderungen die datenresidenz daten sicher thailand zu speichern und gleichzeitig eine noch geringere latenz im ganzen land zu bieten kunden von startup ber unternehmen bi hin zu regierungsorganisationen und gemeinntzigen organisationen knnen fortschrittliche technologien au der weltweit fhrenden cloud nutzen um innovationen voranzutreiben aws bietet da breiteste und tiefste portfolio diensten darunter analysen datenverarbeitung datenbanken internet thing iot maschinelles lernen mobile dienste speicher und andere cloudtechnologien organisationen thailand gehren zu den millionen aktiver kunden die aws mehr al lndern auf der ganzen welt nutzen zu den thailndischen unternehmen die aws fr die ausfhrung ihrer arbeitslasten whlen um innovationen zu beschleunigen die agilitt zu erhhen und kosteneinsparungen zu erzielen gehren cp cp plc digital economy promotion agency energy response co ltd enres papyrus studio ptt global public company limited ptt oil retail business public company limited siam cement group sukhothai thammathirat open university stock exchange thailand und andere anwendungsflle die zeigen wie diese thailndischen unternehmen awsservices nutzen um ihr geschft zu transformieren finden sie hier pressaboutamazoncomnewsreleasesnewsreleasedetailsawslaunchinfrastructureregionthailand die thailand ansssigen partner sind teil de aws partner network apn zu dem mehr al unabhngige softwareanbieter isvs und systemintegratoren si auf der ganzen welt gehren awspartner entwickeln innovative lsungen und service auf aws und da apn bietet kunden geschftliche technische marketing und gotomarketuntersttzung aws si beratungspartner und isvs helfen kunden au unternehmen und dem ffentlichen sektor bei der migration zu aws bei der bereitstellung geschftskritischer anwendungen und bieten eine breite palette berwachungs automatisierungs und verwaltungsservices fr kundenumgebungen beispiele fr awspartner thailand sind dailitech gable public company limited national telecom public company limited ntt thailand ltd und true idc awsisvs thailand darunter cp und amity nutzen aws bereits um ihre software kunden auf der ganzen welt zu liefern und planen ihre thailndischen kunden beim start von der awsregion asienpazifik bangkok au zu bedienen die vollstndige liste der apnmitglieder finden sie unter awsamazoncompartners und anwendungsflle von dailitech national telecom und ntt thailand ltd finden sie unter pressaboutamazoncomnewsreleasesnewsreleasedetailsawslaunchinfrastructureregionthailand awsinvestitionen thailand die neue awsregion asienpazifik bangkok ist die jngste der laufenden investitionen von aws thailand um kunden fortschrittliche und sichere cloudtechnologien zu bieten seit hat aws amazon cloudfrontedgestandorte bangkok eingefhrt amazon cloudfront ist ein hochsicheres und programmierbares content delivery network cdn da die bereitstellung von daten video anwendungen und apis fr benutzer weltweit mit geringer latenz und hohen bertragungsgeschwindigkeiten beschleunigt im jahr fhrte aws thailand aws outpost ein aws outpost ist eine familie vollstndig verwalteter lsungen die awsinfrastruktur und service praktisch jedem standort oder edgestandort bereitstellen um ein wirklich konsistentes hybriderlebnis zu ermglichen aws plant seine investitionen thailand mit dem start einer neuen aws local zone bangkok zu vertiefen aws local zone sind eine art von awsinfrastrukturbereitstellung die rechen speicher datenbank und andere ausgewhlte service nher groen bevlkerungs industrie und itzentren platziert und e kunden ermglicht anwendungen die eine latenz im einstelligen millisekundenbereich bentigen endbenutzer zu liefern um da wachstum der cloudeinfhrung thailand zu untersttzen investiert aws weiterhin die weiterbildung von lokalen entwicklern studenten und der nchsten generation von itfhrungskrften thailand durch programme wie aws restart aws academy und aws educate diese awsbildungsprogramme helfen lernenden aller hintergrnde und erfahrungen bei der vorbereitung auf karrieren der cloud von hochschulkursen bi hin zu vollzeitschulungsprogrammen und lerninhalten zum selbststudium bieten die awsbildungsprogramme zugang zu schulungen die einzelpersonen dabei helfen knnen ihre cloudkarriere zu beginnen oder auszubauen acht thailndische hochschuleinrichtungen bangkok chiang rai und pathum thani haben aws academykurse ihre lehrplne aufgenommen aws arbeitet auch direkt mit unternehmen wie der siam cement group zusammen um gefragte cloudfhigkeiten aufzubauen und mitarbeiter zu schulen aws plant mit dem thailndischen ministerium fr digitale wirtschaft und gesellschaft einem qualifizierungsplan zusammenzuarbeiten und untersttzung bei der schulung von mehr al mitarbeitern mit cloudfhigkeiten digitalen ondemandkursen und moderierten schulungsveranstaltungen zu leisten damit die mitarbeiter der regierung die erforderlichen fhigkeiten entwickeln knnen um cloudtechnologien groem umfang zu implementieren bessere datengesteuerte geschftsentscheidungen zu treffen und neue dienste zu entwickeln um bessere ergebnisse fr die brger zu erzielen um da unternehmertum thailand weiter zu frdern bietet aws ber da aws activateprogramm untersttzung fr startup im frhstadium diesis programm bietet zugang zu beratung und persnlichen gesprchen mit awsexperten technischen support businessmentoring und die mglichkeit bi zu usdollar awsservicegutschriften zu erhalten alles kostenlos aws arbeitet auch mit der risikokapitalgemeinschaft startupbeschleunigern und inkubatoren zusammen um startup beim wachstum der cloud zu untersttzen thailand gehren dazu beschleunigerorganisationen wie ai startup und stormbreaker die da schnelle wachstum ihrer portfoliounternehmen untersttzen im jahr hat aws sein startup rampprogramm auf asean ausgeweitet diesis programm dient der untersttzung von startupunternehmern im frhstadium die lsungen den bereichen gesundheit digitale verwaltung intelligente stdte landwirtschaft und raumfahrttechnologie entwickeln starten und ausbauen aws startup ramp arbeitet daran barrieren fr unternehmer zu beseitigen die im ffentlichen sektor etwas bewirken mchten indem e technische design und architekturberprfungen mentoren kredite und untersttzung bei markteinfhrungsplnen bietet um bei der bewltigung komplexer regulatorischer und sicherheitsanforderungen zu helfen startup die sich noch der anfangsphase befinden und daran arbeiten da produkt den markt anzupassen und erste kunden zu finden knnen sich al startup ramp innovator bewerben unternehmen mit zahlenden kunden die auf wachstum und skalierung ausgerichtet sind knnen sich al startup ramp member bewerben um die vorteile de programms zu nutzen seit untersttzt aws edstart der awsstartupbeschleuniger fr bildungstechnologie unternehmer beim aufbau der nchsten generation von onlinelern analyse und campusmanagementlsungen zu den aws edstartmitgliedern thailand gehren gantik opendurian und vonder durch die nutzung von aws edstart haben diese mitglieder innovative lsungen entwickelt die schlern helfen fundierte entscheidungen auf ihrem bildungsweg zu treffen erfahrungslernmglichkeiten fr grund und sekundarschulen im ganzen land bieten und virtuelles mentoring zwischen schlern und unternehmern ermglichen bekenntnis zur nachhaltigkeit amazon hat sich im rahmen de klimaversprechens climate pledge dazu verpflichtet nachhaltiger zu werden und bi also jahre vor dem pariser abkommen eine nettonullkohlenstoffbilanz fr seine gesamte geschftsttigkeit zu erreichen amazon ist mitbegrnder de klimaversprechens und wurde dessen erstunterzeichner im rahmen seiner verpflichtung zum climate pledge ist amazon auf dem weg seinen betrieb bi zu mit erneuerbarer energie zu versorgen fnf jahre vor dem ursprnglichen ziel fr amazon ist der weltweit grte einkufer von erneuerbaren energien und bi ende hat da unternehmen erneuerbare energien seinem gesamten unternehmen erreicht weitere informationen zum ansatz von amazon finden sie seiner ffentlichen methodik unternehmen die rechenlasten die aws cloud verlagern knnen von den nettoeffekten der nachhaltigkeitsbemhungen von amazon profitieren um ihren cofuabdruck zu reduzieren ber amazon web service seit ber jahren ist amazon web service da umfassendste und weitesten verbreitete cloudangebot der welt aws hat seine service kontinuierlich erweitert um praktisch jede cloudarbeitslast zu untersttzen und bietet jetzt mehr al voll ausgestattete service fr datenverarbeitung speicherung datenbanken netzwerke analysen maschinelles lernen und knstliche intelligenz ki internet der dinge iot mobilgerte sicherheit hybrid virtual und augmented reality vr und ar medien sowie anwendungsentwicklung bereitstellung und verwaltung au availability zone geografischen regionen mit angekndigten plnen fr weitere availability zone und acht weitere awsregionen australien kanada indien israel neuseeland spanien der schweiz und thailand millionen von kunden darunter die schnellsten wachsenden startup die grten unternehmen und fhrende regierungsbehrden vertrauen auf aws um ihre infrastruktur zu betreiben agiler zu werden und kosten zu senken weitere informationen ber aws finden sie unter awsamazoncom ber amazon amazon wird von vier grundprinzipien geleitet fokus auf kundinnen statt auf den wettbewerb leidenschaft fr erfinden verpflichtung zu operativer exzellenz und langfristiges denken amazon strebt danach da kundenorientierteste unternehmen der beste arbeitgeber und der sicherste arbeitsplatz der welt zu sein kundenrezensionen clickshopping personalisierte empfehlungen prime versand durch amazon aws kindle direct publishing kindle career choice fire tablet fire tv amazon echo alexa justwalkouttechnologie amazon studio und climate pledge sind nur einige beispiele fr die amazon pionierarbeit geleistet hat mehr informationen auf amazoncomabout und auf twitter unter amazonnews die ausgangssprache der der originaltext verffentlicht wird ist die offizielle und autorisierte version bersetzungen werden zur besseren verstndigung mitgeliefert nur die sprachversion die im original verffentlicht wurde ist rechtsgltig gleichen sie deshalb bersetzungen mit der originalen sprachversion der verffentlichung ab,-0.9997,-0.49985,0.1565057143,-0.656355714,Negative Impact
19/10/2022,114.71,116.59,113.22,115.07,115.07,47198100,-0.27,-314.4290963,1.192,0,14.33339876,0.959429757,-0.018638346,3.08,298.012,10680.50977,13947.25977,6925,6040.720215,3044.379883,59107.19141,18674.40039,125.5025999,133.7667451,120.9187317,132.9946184,115.1334999,121.7901909,108.476809,50.37282056,-2.99225552,-3.41653147,0.42427595,5.167858124,105.6333984,10187830600,55.07082368,55.08971346,30.76000023,"Amazon, NY attorney general call off COVID-19 litigation",Amazon.com Inc and New York state's attorney general on Wednesday agreed to halt litigation against one another stemming from whether the online retailer adequately protected workers in the largest U.S. city during the initial COVID-19 outbreak.,https://www.reuters.com/legal/amazon-ny-attorney-general-call-off-covid-19-litigation-2022-10-19/,reuters.com,10,amazoncom inc new york state attorney general wednesday agreed halt litigation one another stemming whether online retailer adequately protected worker largest u city initial covid outbreak,0.4939,0.4939,0.1594433333,0.3344566667,Positive Impact
20/10/2022,113.83,118.24,113.51,115.25,115.25,48795100,-0.27,-314.4290963,1.192,0,14.33339876,0.959429757,-0.018638346,3.08,298.012,10614.83984,13840.46973,6943.899902,6086.899902,3035.050049,59202.89844,18579.30078,124.9537999,133.5053851,120.6964285,132.8180551,115.0305,121.6086783,108.4523218,53.25238543,-2.72164378,-3.277553932,0.5559101523,5.214286259,105.9111304,10236625700,56.09065535,57.84702972,29.97999954,"Months after floods, Brazil's Amazon faces a severe drought","Just months after enduring floods that destroyed crops and submerged entire communities, thousands of families in the Brazilian Amazon are now dealing with severe drought that, at least in some areas, is the worst in decades. The low level of the Amazon River, at the center of the largest drainage system in the world, has put dozens of municipalities under alert.",https://www.marketwatch.com/story/months-after-floods-brazils-amazon-faces-a-severe-drought-01666271661,marketwatch.com,8,month enduring flood destroyed crop submerged entire community thousand family brazilian amazon dealing severe drought least area worst decade low level amazon river center largest drainage system world put dozen municipality alert,-0.8126,-0.65008,-0.087842143,-0.562237857,Negative Impact
21/10/2022,114.79,119.59,114.50,119.32,119.32,55660500,-0.27,-314.4290963,1.192,0,14.33339876,0.959429757,-0.018638346,3.08,298.012,10859.71973,14144.0498,6969.700195,6035.390137,3038.929932,59307.14844,18861,124.5273999,133.2802001,120.6424509,132.683746,115.3075001,122.1261357,108.4888644,54.80715841,-2.153937811,-3.052830708,0.8988928972,5.259285518,106.1833077,10292286200,79.15014172,63.43720692,29.69000053,Hawaiian Airlines parent stock jumps after Amazon issued warrants to buy 15% of shares,"Shares of Hawaiian Airlines parent Hawaiian Holdings Inc. HA, -0.71% rallied 4.1% in premarket trading Friday, after the company said it issued Amazon.com Inc. AMZN, +0.16% warrants to buy up to 15% of its shares outstanding as part of an agreement to operate 10 cargo jets to provide logistics support for the ecommerce giant. As of Thursday's stock closing price of $14.08, 15% of Hawaiian's market capitalization would be worth about $108.5 million.",https://www.marketwatch.com/story/hawaiian-airlines-parent-stock-jumps-after-amazon-issued-warrants-to-buy-15-of-shares-2022-10-21,marketwatch.com,8,share hawaiian airline parent hawaiian holding inc ha rallied premarket trading friday company said issued amazoncom inc amzn warrant buy share outstanding part agreement operate cargo jet provide logistics support ecommerce giant thursday stock closing price hawaiian market capitalization would worth million,0.9485,0.7588,0.1419816667,0.6168183333,Positive Impact
24/10/2022,119.98,120.39,116.57,119.82,119.82,49531500,-0.27,-314.4290963,1.192,0,14.33339876,0.959429757,-0.018638346,3.08,298.012,10952.61035,14226.11035,7014,6131.359863,2977.560059,59831.66016,18918.40039,124.0527998,133.0630301,120.6101979,132.5557486,115.541,122.6505623,108.4314376,47.95623325,-1.644721592,-2.771208885,1.126487293,5.023571014,106.7195753,10341817700,88.23170655,74.49083454,29.85000038,Facebook and Google face skeptics on Wall Street this week amid digital ads collapse,"Following Snap's disappointing earnings report last week, investors turn their focus to Meta and Alphabet as they look for signs of recovery in online ads.",https://www.cnbc.com/2022/10/24/facebook-google-face-skeptical-wall-street-this-week-amid-ad-collapse.html,cnbc.com,9,following snap disappointing earnings report last week investor turn focus meta alphabet look sign recovery online ad,-0.4939,-0.44451,0.031849,-0.476359,Negative Impact
25/10/2022,119.65,121.32,118.95,120.60,120.60,50934600,-0.27,-314.4290963,1.192,0,14.33339876,0.959429757,-0.018638346,3.08,298.012,11199.12012,14440.69043,7013.5,6250.549805,2976.280029,59543.96094,19097,123.6012,132.8532601,120.609798,132.4367859,115.8504997,123.2842977,108.4167017,49.44812601,-1.164797625,-2.449926633,1.285129008,4.902857099,107.5398007,10392752300,94.25216139,87.21133655,28.45999908,"State of Michigan Retirement System Doubles-Down On Tesla, Amazon Bets ÃÂÃÂ Nearly Doubles Stake In This Telecom Stock - Tesla (NASDAQ:TSLA), Amazon.com (NASDAQ:AMZN)","The State of Michigan Retirement System has hiked its stake in Tesla Inc. (NASDAQ: TSLA), Amazon.com Inc. (NASDAQ: AMZN) and Verizon Communications Inc. (NYSE:",https://www.benzinga.com/trading-ideas/long-ideas/22/10/29390523/state-of-michigan-retirement-system-doubles-down-on-tesla-amazon-bets-nearly-doubles-sta?SNAPI,benzinga.com,5,state michigan retirement system hiked stake tesla inc nasdaq tsla amazoncom inc nasdaq amzn verizon communication inc nyse,0,0,0.2847225,-0.2847225,Negative Impact
26/10/2022,116,119.35,114.76,115.66,115.66,68802300,-0.27,-314.4290963,1.192,0,14.33339876,0.959429757,-0.018638346,3.08,298.012,10970.99023,14531.69043,7056.100098,6276.310059,2999.5,59543.96094,19279.80078,123.0188,132.6241302,120.4156884,132.2698527,115.7329998,123.0970396,108.36896,43.5555564,-1.169588433,-2.193858993,1.02427056,5.174999782,108.6422166,10323950000,64.55857483,82.34748092,27.28000069,Big Tech tumbles as results sound alarm bells,Grim results from Alphabet Inc and Microsoft Corp stoked fears of a global economic downturn and slammed the brakes on a fragile recovery in stock markets ahead of earnings from other tech megacaps.,https://www.reuters.com/markets/europe/big-tech-tumbles-results-sound-alarm-bells-2022-10-26/,reuters.com,10,grim result alphabet inc microsoft corp stoked fear global economic downturn slammed brake fragile recovery stock market ahead earnings tech megacaps,-0.7845,-0.7845,0.03174285714,-0.816242857,Negative Impact
27/10/2022,113.92,114.12,109.77,110.96,110.96,129605400,-0.27,-314.4290963,1.192,0,14.33339876,0.959429757,-0.018638346,3.08,298.012,10792.66992,14569.90039,7073.700195,6244.029785,2982.899902,59756.83984,19352.09961,122.3959999,132.3521202,120.044877,132.0578144,115.5409996,123.2017253,107.8802739,44.85126063,-1.534942411,-2.062075677,0.5271332654,5.137142726,109.6564393,10194344600,35.12836682,64.64636768,27.38999939,VIEW Weak Amazon outlook another blow to tech-type growth shares,"Amazon.com Inc shares skidded as much as 21% after hours on Thursday after it forecast costs might eviscerate its profit for the current quarter, as early holiday marketing does little to boost sales growth and as labor and delivery expenses continue to swell.",https://www.reuters.com/technology/view-weak-amazon-outlook-another-blow-tech-type-growth-shares-2022-10-27/,reuters.com,10,amazoncom inc share skidded much hour thursday forecast cost might eviscerate profit current quarter early holiday marketing little boost sale growth labor delivery expense continue swell,0.8896,0.8896,0.1296815625,0.759918438,Positive Impact
28/10/2022,97.91,103.96,97.66,103.41,103.41,223133400,-0.27,-314.4290963,1.192,0,14.33339876,0.959429757,-0.018638346,3.08,298.012,11102.4502,14795.62988,7047.700195,6273.049805,2915.929932,59959.85156,19471.19922,121.6181999,132.0431352,119.3925291,131.7727615,115.0614998,124.4071196,105.71588,37.67420025,-2.405975022,-2.130855546,-0.275119476,5.814285278,121.3199997,9971211200,24.30262453,41.32985539,25.75,A $3 trillion loss: Big Tech's horrible year is getting worse,"Big Tech companies are taking a heavy beating this week, to the tune of more than $255 billion in lost market capitalization that's helped make a bad year even worse for the once-beloved sector.",https://www.marketwatch.com/story/a-3-trillion-loss-big-techs-horrible-year-is-getting-worse-11666985436,marketwatch.com,8,big tech company taking heavy beating week tune billion lost market capitalization thats helped make bad year even worse oncebeloved sector,-0.8979,-0.71832,-0.01115375,-0.70716625,Negative Impact
31/10/2022,103.56,104.87,100.74,102.44,102.44,99251400,-0.27,-314.4290963,1.192,0,14.33339876,0.959429757,-0.018638346,3.08,298.012,10988.15039,14747.03027,7094.5,6266.77002,2893.47998,60746.58984,19426.09961,120.9024001,131.7492652,118.7277241,131.4808933,114.3895,125.2906683,103.4883318,38.12302784,-3.138368475,-2.332358131,-0.806010343,5.745713915,120.8467998,9871959800,20.20287228,26.54462121,25.87999916,Amazon: This Too Shall Pass,"Amazon's retail business was resilient in the quarter, with Europe being the only weaker segment due to the ongoing war in Ukraine and rising energy costs in the region. AWS posted weaker-than-expected revenue growth and margins due to some customers tightening their budgets and higher energy costs.",https://seekingalpha.com/article/4551102-amazon-this-too-shall-pass,seekingalpha.com,6,amazon retail business resilient quarter europe weaker segment due ongoing war ukraine rising energy cost region aws posted weakerthanexpected revenue growth margin due customer tightening budget higher energy cost,-0.0772,-0.04632,0.187256,-0.233576,Negative Impact
01/11/2022,103.99,104.58,96.06,96.79,96.79,153370000,-0.27,-314.4290963,1.192,0,14.33339876,0.959429757,-0.018638346,3.78,297.711,10890.84961,14790.70996,7186.200195,6328.25,2969.199951,61121.35156,19517.69922,120.1738,131.4225252,117.8674212,131.1357103,113.1745003,126.1505082,100.1984924,32.52332188,-4.127128498,-2.691312205,-1.435816294,6.180714199,120.3830639,9718589800,2.889957622,15.79848481,25.80999947,Amazon sell-off pushes market cap below $1 trillion for first time since April 2020,"Amazon shares dropped for a fifth straight day on Tuesday, as investors continued to punish the company for a disappointing fourth-quarter forecast.",https://www.cnbc.com/2022/11/01/amazon-plunge-pushes-valuation-below-1-trillion-first-time-since-2020.html,cnbc.com,9,amazon share dropped fifth straight day tuesday investor continued punish company disappointing fourthquarter forecast,-0.4215,-0.37935,0.2014014815,-0.580751481,Negative Impact
02/11/2022,97.32,97.74,92.01,92.12,92.12,135761800,-0.27,-314.4290963,1.192,0,14.33339876,0.959429757,-0.018638346,3.78,297.711,10524.7998,14497.84961,7144.100098,6276.879883,3003.370117,60906.08984,19277,119.3438002,131.0885377,116.8577185,130.7474943,111.7330006,127.2321672,96.23383388,29.74796649,-5.227300696,-3.198509903,-2.028790793,6.012142181,119.4101412,9582828000,0.3753006466,7.822710182,25.86000061,"AMD Q3 Earnings Meet Estimates, Data Center Growth Aids Top Line",Advanced Micro Devices' (AMD) third-quarter 2022 results benefit from strong EPYC processor sales as well as robust revenue growth in the Embedded segment.,https://www.zacks.com/stock/news/2012701/amd-q3-earnings-meet-estimates-data-center-growth-aids-top-line,zacks.com,8,advanced micro device amd thirdquarter result benefit strong epyc processor sale well robust revenue growth embedded segment,0.9246,0.73968,0.04984375,0.68983625,Positive Impact
03/11/2022,92.47,93.50,89.02,89.30,89.30,136683300,-0.27,-314.4290963,1.192,0,14.33339876,0.959429757,-0.018638346,3.78,297.711,10342.94043,14455.66992,7188.600098,6243.279785,2997.810059,60836.41016,19241.19922,118.4538002,130.7535427,115.7770238,130.3350814,110.1830006,128.0883696,92.27763152,31.50483331,-6.254645833,-3.809737089,-2.444908744,5.73499952,117.7661329,9446144700,0.8668928243,1.377383697,25.29999924,Amazon und USAID starten Initiative zur ErhÃÂÃÂ¶hung der KlimafÃÂÃÂ¶rderung fÃÂÃÂ¼r Frauen,"SEATTLE--(BUSINESS WIRE)--Amazon und die U.S. Agency for International Development (USAID) starten eine ÃÂÃÂ¶ffentlich-private Partnerschaft, um die geschlechtsspezifischen Ungleichheiten zu beseitigen, die fÃÂÃÂ¼r Frauen im ÃÂÃÂkosystem der Klimafinanzierung bestehen, und Unternehmerinnen mit den Ressourcen zu unterstÃÂÃÂ¼tzen, die sie benÃÂÃÂ¶tigen, um Innovationen im Bereich des Klimawandels voranzutreiben. Amazon wird insgesamt 53 Millionen Dollar bereitstellen, die Frauen bei der Entwicklung von KlimalÃÂÃÂ¶sungen unterstÃÂÃÂ¼tzen sollen, darunter 3 Millionen US-Dollar fÃÂÃÂ¼r die USAID-Partnerschaft und 50 Millionen US-Dollar fÃÂÃÂ¼r Amazon, um direkt in von Frauen gefÃÂÃÂ¼hrte Climate-Tech-Unternehmen zu investieren. Amazon wird als GrÃÂÃÂ¼ndungspartner des Climate Gender Equity Fund von USAID fungieren, einer neuen FazilitÃÂÃÂ¤t zur Klimafinanzierung, die darauf abzielt, systemische Marktbarrieren zu beseitigen, die Frauen und MÃÂÃÂ¤dchen am Zugang zur Klimafinanzierung hindern. USAID wird zudem die Investition von Amazon in HÃÂÃÂ¶he von 3 Millionen US-Dollar verdoppeln, um die Einrichtung des Fonds zu unterstÃÂÃÂ¼tzen. Der global ausgerichtete Climate Gender Equity Fund stellt ZuschÃÂÃÂ¼sse fÃÂÃÂ¼r Unternehmen, Nichtregierungsorganisationen, Beschleuniger, Inkubatoren und Basisorganisationen bereit, die an frauengefÃÂÃÂ¼hrten KlimalÃÂÃÂ¶sungen arbeiten. DarÃÂÃÂ¼ber hinaus werden MaÃÂÃÂnahmen finanziert, die Frauen den Zugang zu den Netzwerken und technischen Kompetenzen erleichtern, die sie benÃÂÃÂ¶tigen, um die Entwicklung ihrer Technologien fÃÂÃÂ¼r den Klimawandel zu beschleunigen. Als MitbegrÃÂÃÂ¼nder des Climate Pledge, einer Selbstverpflichtung zur Erreichung von Netto-Null-Emissionen bis 2040, wird Amazon mit den Unterzeichnern des Pledge und anderen Unternehmen zusammenarbeiten, um deren zusÃÂÃÂ¤tzliche UnterstÃÂÃÂ¼tzung und Unternehmensinvestitionen in diesen neuen Fonds zu fÃÂÃÂ¶rdern. Die Partnerschaft soll dazu beitragen, die gemeinsamen Ziele in Bezug auf die FÃÂÃÂ¼hrungsrolle von Frauen beim Klimaschutz und die Gleichstellung der Geschlechter voranzubringen, einschlieÃÂÃÂlich der Nachhaltigkeitsziele von Amazon, der Arbeit von The Climate Pledge und der National Strategy on Gender Equity and Equality der Regierung Biden. DarÃÂÃÂ¼ber hinaus stellt Amazon 50 Millionen Dollar aus seinem Climate Pledge Fund bereit, um in von Frauen gegrÃÂÃÂ¼ndete und von Frauen gefÃÂÃÂ¼hrte Klimatechnologie-Unternehmen sowie in Inkubatoren und Beschleuniger zu investieren, die vorrangig von Frauen gefÃÂÃÂ¼hrte Unternehmen unterstÃÂÃÂ¼tzen. Der Climate Pledge Fund ÃÂÃÂ Amazons Risikokapitalprogramm, das in Unternehmen investiert, die Pionierarbeit bei der Entwicklung von Technologien und LÃÂÃÂ¶sungen zur Dekarbonisierung leisten ÃÂÃÂ wird mit USAID und dem Climate Gender Equity Fund zusammenarbeiten, um neue InvestitionsmÃÂÃÂ¶glichkeiten zu erschlieÃÂÃÂen und seine Pipeline an Bewerberinnen zu erweitern. ÃÂÃÂEin wichtiger Schritt zur LÃÂÃÂ¶sung des Problems des Klimawandels besteht darin, die Ungleichheiten zwischen den Geschlechtern im Bereich der Klimafinanzierung zu beseitigen. Unternehmerinnen mÃÂÃÂ¼ssen gleichberechtigt am Tisch sitzen und Zugang zu den Finanzmitteln, Netzwerken und der technischen UnterstÃÂÃÂ¼tzung haben, die sie benÃÂÃÂ¶tigen, um LÃÂÃÂ¶sungen fÃÂÃÂ¼r den Klimawandel zu entwickelnÃÂÃÂ, so Kara Hurst, Vice President of Worldwide Sustainability bei Amazon. ÃÂÃÂWir sind stolz darauf, mit USAID und der Regierung Biden zusammenzuarbeiten, um frauengefÃÂÃÂ¼hrte KlimalÃÂÃÂ¶sungen weltweit zu fÃÂÃÂ¶rdern. Dies ist nur ein Teilaspekt unseres umfassenderen Climate Pledge-Ziels, bis zum Jahr 2040 eine Netto-Null-Emission zu erreichen, und wir ermutigen andere Unternehmen, sich uns in diesem BemÃÂÃÂ¼hen anzuschlieÃÂÃÂen.ÃÂÃÂ Von Frauen gegrÃÂÃÂ¼ndete Unternehmen erhalten in der Regel nur einen Bruchteil des weltweiten Risikokapitals, und dieser Anteil ist wÃÂÃÂ¤hrend der Pandemie gesunken. Untersuchungen zeigen jedoch, dass weibliche Unternehmerinnen eher als ihre mÃÂÃÂ¤nnlichen Kollegen innovative MaÃÂÃÂnahmen ergreifen, um soziale BedÃÂÃÂ¼rfnisse zu erfÃÂÃÂ¼llen. Von Frauen gefÃÂÃÂ¼hrte Unternehmen erwirtschaften auch mehr Umsatz pro investiertem Dollar und erzielen eine hÃÂÃÂ¶here Kapitalrendite fÃÂÃÂ¼r Investoren. Amazon hat in jÃÂÃÂ¼ngster Zeit mehrere zusÃÂÃÂ¤tzliche Schritte unternommen, um die Gleichstellung der Geschlechter in seiner gesamten WertschÃÂÃÂ¶pfungskette voranzutreiben. Dazu zÃÂÃÂ¤hlen: Verpflichtung zur Einhaltung der Women's Empowerment Principles (WEPs) der Vereinten Nationen, die Unternehmen eine Anleitung zur FÃÂÃÂ¶rderung der Gleichstellung der Geschlechter und zur StÃÂÃÂ¤rkung von Frauen am Arbeitsplatz, auf dem Markt und in der Gemeinschaft bieten. Vergabe von 1 Million US-Dollar an den Resilience Fund for Women in Global Value Chains, fÃÂÃÂ¼r Investitionen in Organisationen, die Frauen in globalen WertschÃÂÃÂ¶pfungsketten unterstÃÂÃÂ¼tzen, wie z. B. in der verarbeitenden Industrie, der Bekleidungsindustrie und der Landwirtschaft, wobei der Schwerpunkt auf geschlechtsspezifischer Gewalt und reproduktiver Gesundheit liegt. Partnerschaft mit dem HERproject von BSR zur BekÃÂÃÂ¤mpfung geschlechtsspezifischer Diskriminierung in China, Bangladesch, Vietnam und Indien unter Einbeziehung von Lieferanten, Fabrikarbeitern und GeschÃÂÃÂ¤ftsfÃÂÃÂ¼hrung. Diese MaÃÂÃÂnahmen haben fast 10.000 Frauen erreicht. Investitionen in den Elevate Future Fund, der die Finanzierung von Frauen und anderen unterreprÃÂÃÂ¤sentierten GrÃÂÃÂ¼ndern erhÃÂÃÂ¶ht, die an technischen LÃÂÃÂ¶sungen fÃÂÃÂ¼r den Klimaschutz arbeiten, sowie von Unternehmen, die wirtschaftliche Chancen fÃÂÃÂ¼r notleidende und benachteiligte Gemeinschaften schaffen. Diese Investition ist Teil der neuen Amazon Catalytic Capital Initiative, die unterreprÃÂÃÂ¤sentierten Unternehmern Zugang zu Kapital verschaffen soll. Kooperation mit Greentown Labs, Nordamerikas grÃÂÃÂ¶ÃÂÃÂtem Inkubator fÃÂÃÂ¼r Klimatechnologien, mit dem Ziel, neue Start-ups zu finden und mit ihnen in Kontakt zu treten. Der Climate Pledge Fund nimmt an Pitch-Veranstaltungen teil, darunter ÃÂÃÂAccess to SuccessÃÂÃÂ, eine Gemeinschaftsveranstaltung fÃÂÃÂ¼r diverse GrÃÂÃÂ¼nder. Amazon ist auÃÂÃÂerdem Mitglied des Greentown Labs' Industry Leadership Council. Zusammenarbeit mit Elemental Excelerator, einem Beschleuniger von Climate-Tech-Startups, der bei der FÃÂÃÂ¶rderung von Vielfalt, Gleichberechtigung und Inklusionsprinzipien in der Klimatechnologie-Branche eine fÃÂÃÂ¼hrende Rolle spielt. Elemental Excelerator hat kÃÂÃÂ¼rzlich ein Equity & Access-Programm ins Leben gerufen, das Startup-GrÃÂÃÂ¼ndern hilft, Eigenkapital in die Teams und AktivitÃÂÃÂ¤ten ihrer Unternehmen zu integrieren. Erfahren Sie mehr ÃÂÃÂ¼ber die NachhaltigkeitsmaÃÂÃÂnahmen von Amazon. Die Ausgangssprache, in der der Originaltext verÃÂÃÂ¶ffentlicht wird, ist die offizielle und autorisierte Version. ÃÂÃÂbersetzungen werden zur besseren VerstÃÂÃÂ¤ndigung mitgeliefert. Nur die Sprachversion, die im Original verÃÂÃÂ¶ffentlicht wurde, ist rechtsgÃÂÃÂ¼ltig. Gleichen Sie deshalb ÃÂÃÂbersetzungen mit der originalen Sprachversion der VerÃÂÃÂ¶ffentlichung ab.",https://www.businesswire.com/news/home/20221103005181/de/,businesswire.com,5,seattlebusiness wireamazon und die u agency international development usaid starten eine ffentlichprivate partnerschaft um die geschlechtsspezifischen ungleichheiten zu beseitigen die fr frau im kosystem der klimafinanzierung bestehen und unternehmerinnen mit den ressourcen zu untersttzen die sie bentigen um innovationen im bereich de klimawandels voranzutreiben amazon wird insgesamt millionen dollar bereitstellen die frau bei der entwicklung von klimalsungen untersttzen sollen darunter millionen usdollar fr die usaidpartnerschaft und millionen usdollar fr amazon um direkt von frau gefhrte climatetechunternehmen zu investieren amazon wird al grndungspartner de climate gender equity fund von usaid fungieren einer neuen fazilitt zur klimafinanzierung die darauf abzielt systemische marktbarrieren zu beseitigen die frau und mdchen zugang zur klimafinanzierung hindern usaid wird zudem die investition von amazon hhe von millionen usdollar verdoppeln um die einrichtung de fonds zu untersttzen der global ausgerichtete climate gender equity fund stellt zuschsse fr unternehmen nichtregierungsorganisationen beschleuniger inkubatoren und basisorganisationen bereit die frauengefhrten klimalsungen arbeiten darber hinaus werden manahmen finanziert die frau den zugang zu den netzwerken und technischen kompetenzen erleichtern die sie bentigen um die entwicklung ihrer technologien fr den klimawandel zu beschleunigen al mitbegrnder de climate pledge einer selbstverpflichtung zur erreichung von nettonullemissionen bi wird amazon mit den unterzeichnern de pledge und anderen unternehmen zusammenarbeiten um deren zustzliche untersttzung und unternehmensinvestitionen diesen neuen fonds zu frdern die partnerschaft soll dazu beitragen die gemeinsamen ziele bezug auf die fhrungsrolle von frau beim klimaschutz und die gleichstellung der geschlechter voranzubringen einschlielich der nachhaltigkeitsziele von amazon der arbeit von climate pledge und der national strategy gender equity equality der regierung biden darber hinaus stellt amazon millionen dollar au seinem climate pledge fund bereit um von frau gegrndete und von frau gefhrte klimatechnologieunternehmen sowie inkubatoren und beschleuniger zu investieren die vorrangig von frau gefhrte unternehmen untersttzen der climate pledge fund amazon risikokapitalprogramm da unternehmen investiert die pionierarbeit bei der entwicklung von technologien und lsungen zur dekarbonisierung leisten wird mit usaid und dem climate gender equity fund zusammenarbeiten um neue investitionsmglichkeiten zu erschlieen und seine pipeline bewerberinnen zu erweitern ein wichtiger schritt zur lsung de problem de klimawandels besteht darin die ungleichheiten zwischen den geschlechtern im bereich der klimafinanzierung zu beseitigen unternehmerinnen mssen gleichberechtigt tisch sitzen und zugang zu den finanzmitteln netzwerken und der technischen untersttzung haben die sie bentigen um lsungen fr den klimawandel zu entwickeln kara hurst vice president worldwide sustainability bei amazon wir sind stolz darauf mit usaid und der regierung biden zusammenzuarbeiten um frauengefhrte klimalsungen weltweit zu frdern dy ist nur ein teilaspekt unseres umfassenderen climate pledgeziels bi zum jahr eine nettonullemission zu erreichen und wir ermutigen andere unternehmen sich un diesem bemhen anzuschlieen von frau gegrndete unternehmen erhalten der regel nur einen bruchteil de weltweiten risikokapitals und dieser anteil ist whrend der pandemie gesunken untersuchungen zeigen jedoch das weibliche unternehmerinnen eher al ihre mnnlichen kollegen innovative manahmen ergreifen um soziale bedrfnisse zu erfllen von frau gefhrte unternehmen erwirtschaften auch mehr umsatz pro investiertem dollar und erzielen eine hhere kapitalrendite fr investoren amazon hat jngster zeit mehrere zustzliche schritte unternommen um die gleichstellung der geschlechter seiner gesamten wertschpfungskette voranzutreiben dazu zhlen verpflichtung zur einhaltung der womens empowerment principle weps der vereinten nationen die unternehmen eine anleitung zur frderung der gleichstellung der geschlechter und zur strkung von frau arbeitsplatz auf dem markt und der gemeinschaft bieten vergabe von million usdollar den resilience fund woman global value chain fr investitionen organisationen die frau globalen wertschpfungsketten untersttzen wie z b der verarbeitenden industrie der bekleidungsindustrie und der landwirtschaft wobei der schwerpunkt auf geschlechtsspezifischer gewalt und reproduktiver gesundheit liegt partnerschaft mit dem herproject von bsr zur bekmpfung geschlechtsspezifischer diskriminierung china bangladesch vietnam und indien unter einbeziehung von lieferanten fabrikarbeitern und geschftsfhrung diese manahmen haben fast frau erreicht investitionen den elevate future fund der die finanzierung von frau und anderen unterreprsentierten grndern erhht die technischen lsungen fr den klimaschutz arbeiten sowie von unternehmen die wirtschaftliche chancen fr notleidende und benachteiligte gemeinschaften schaffen diese investition ist teil der neuen amazon catalytic capital initiative die unterreprsentierten unternehmern zugang zu kapital verschaffen soll kooperation mit greentown lab nordamerikas grtem inkubator fr klimatechnologien mit dem ziel neue startup zu finden und mit ihnen kontakt zu treten der climate pledge fund nimmt pitchveranstaltungen teil darunter access success eine gemeinschaftsveranstaltung fr diverse grnder amazon ist auerdem mitglied de greentown lab industry leadership council zusammenarbeit mit elemental excelerator einem beschleuniger von climatetechstartups der bei der frderung von vielfalt gleichberechtigung und inklusionsprinzipien der klimatechnologiebranche eine fhrende rolle spielt elemental excelerator hat krzlich ein equity accessprogramm in leben gerufen da startupgrndern hilft eigenkapital die team und aktivitten ihrer unternehmen zu integrieren erfahren sie mehr ber die nachhaltigkeitsmanahmen von amazon die ausgangssprache der der originaltext verffentlicht wird ist die offizielle und autorisierte version bersetzungen werden zur besseren verstndigung mitgeliefert nur die sprachversion die im original verffentlicht wurde ist rechtsgltig gleichen sie deshalb bersetzungen mit der originalen sprachversion der verffentlichung ab,-0.999,-0.4995,0.1363636364,-0.635863636,Negative Impact
04/11/2022,91.49,92.44,88.04,90.98,90.98,129101300,-0.27,-314.4290963,1.192,0,14.33339876,0.959429757,-0.018638346,3.78,297.711,10475.25,14702.76953,7334.799805,6416.439941,3070.800049,60950.35938,19449.80078,117.5278003,130.4501053,114.8045916,129.9434886,109.0040009,128.7105685,89.29743323,23.08236938,-6.854250735,-4.418639818,-2.435610917,5.528570993,115.466442,9575246000,8.834142275,3.358778582,24.54999924,"Amazon stock breaks long-term chart support, and the worst may still be to come",Amazon's stock has tumbled enough over the past week to do real damage to its long-term chart ÃÂÃÂ and enough to warn investors the worst may be yet to come.,https://www.marketwatch.com/story/amazon-stock-breaks-long-term-chart-support-and-the-worst-may-still-be-to-come-11667590598,marketwatch.com,8,amazon stock tumbled enough past week real damage longterm chart enough warn investor worst may yet come,-0.7906,-0.63248,-0.032116,-0.600364,Negative Impact
07/11/2022,91.95,92.10,89.04,90.53,90.53,77495700,-0.27,-314.4290963,1.192,0,14.33339876,0.959429757,-0.018638346,3.78,297.711,10564.51953,14808.62988,7300,6416.609863,3077.820068,61185.14844,19545.90039,116.7234003,130.1895403,113.8526468,129.5513146,107.8470009,129.0597135,86.63428832,17.9130412,-7.281813337,-4.991274522,-2.290538815,5.337856838,112.7237979,9497750300,7.481965009,5.727666703,24.35000038,"As Layoffs Hit The Tech Sector, Facebooks Plans To Cut Thousands","Meta stock jumped Monday as a report said the social network plans large-scale layoffs that could hit thousands of employees. The post As Layoffs Hit The Tech Sector, Facebooks Plans To Cut Thousands appeared first on Investor's Business Daily.",https://www.investors.com/news/technology/meta-stock-jumps-reports-of-layoffs-thousands/,investors.com,5,meta stock jumped monday report said social network plan largescale layoff could hit thousand employee post layoff hit tech sector facebooks plan cut thousand appeared first investor business daily,-0.2732,-0.1366,0.1339275,-0.2705275,Negative Impact
08/11/2022,90.79,91.72,88.23,89.98,89.98,88703400,-0.27,-314.4290963,1.192,0,14.33339876,0.959429757,-0.018638346,3.78,297.711,10616.2002,14889.2998,7306.100098,6441.5,3064.48999,61185.14844,19660.30078,115.9272005,129.9167202,112.9164647,129.1575702,106.7355011,129.2738254,84.19717682,18.24854489,-7.577688933,-5.508557404,-2.069131529,5.346428462,110.2554182,9409046900,5.829334473,7.381813919,25.54000092,Amazon: Buying Opportunity In The Making,"Amazon reported quarterly results a few days ago, and especially due to the weak guidance for Q4/22, the stock declined about 20% the following trading days. While AWS will continue to perform quite well, the other two segments will probably suffer in an upcoming recession.",https://seekingalpha.com/article/4554856-amazon-buying-opportunity-in-the-making,seekingalpha.com,6,amazon reported quarterly result day ago especially due weak guidance q stock declined following trading day aws continue perform quite well two segment probably suffer upcoming recession,-0.7495,-0.4497,0.1441228571,-0.593822857,Negative Impact
09/11/2022,89.47,89.48,85.87,86.14,86.14,90796200,-0.27,-314.4290963,1.192,0,14.33339876,0.959429757,-0.018638346,3.78,297.711,10353.16992,14587.75977,7296.299805,6430.569824,3048.169922,61033.55078,19344.30078,115.0754005,129.6474903,111.8664073,128.7295347,105.397501,129.5167444,81.27825762,16.28445466,-8.02946997,-6.012739917,-2.016730053,5.302143097,108.0338764,9318250700,0.7616267033,4.690975395,26.09000015,"Lawsuit claims Apple, Amazon colluded to raise iPhone, iPad prices",Apple Inc and Amazon.com Inc were accused in an antitrust lawsuit on Wednesday of conspiring to drive up iPhone and iPad prices by removing nearly all other resellers of new Apple products from Amazon's website.,https://www.reuters.com/legal/lawsuit-claims-apple-amazon-colluded-raise-iphone-ipad-prices-2022-11-09/,reuters.com,10,apple inc amazoncom inc accused antitrust lawsuit wednesday conspiring drive iphone ipad price removing nearly resellers new apple product amazon website,-0.34,-0.34,0.15439,-0.49439,Negative Impact
10/11/2022,92.94,98.69,91.65,96.63,96.63,173414900,-0.27,-314.4290963,1.192,0,14.33339876,0.959429757,-0.018638346,3.78,297.711,11114.15039,15234.71973,7375.299805,6556.830078,3036.129883,60613.69922,19990.40039,114.4726006,129.4362778,111.268901,128.4101363,104.6025009,128.7799638,80.42503805,27.12239956,-7.455116595,-6.301215253,-1.153901342,5.835000719,105.3742116,9491665600,30.35259643,12.3145192,23.53000069,Amazon's stock bounces sharply off 2 1/2-year low after upbeat inflation data,"Shares of Amazon.com Inc. AMZN, -4.27% surged 7.3% in premarket trading Thursday, to bounce off the previous session's 2 1/2-year closing low, after cooler-than-expected inflation data fueled hopes that the Federal Reserve won't be so aggressive in raising interest rates. The stock has been suffering of late as historically high inflation, fast-rising interest rates and slowing consumer spending has increased fears that a recession was on the horizon.",https://www.marketwatch.com/story/amazons-stock-bounces-sharply-off-2-12-year-low-after-upbeat-inflation-data-2022-11-10,marketwatch.com,8,share amazoncom inc amzn surged premarket trading thursday bounce previous session year closing low coolerthanexpected inflation data fueled hope federal reserve wont aggressive raising interest rate stock suffering late historically high inflation fastrising interest rate slowing consumer spending increased fear recession horizon,-0.8184,-0.65472,0.0183875,-0.6731075,Negative Impact
11/11/2022,97.88,101.19,96.66,100.79,100.79,111590500,-0.27,-314.4290963,1.192,0,14.33339876,0.959429757,-0.018638346,3.78,297.711,11323.33008,15352.69043,7318,6594.620117,3087.290039,61795.03906,20111.5,113.9320006,129.2420403,110.8579637,128.1353091,104.2970009,128.5066169,80.08738485,32.13145655,-6.588313896,-6.358634982,-0.229678915,5.887858255,103.0337065,9603256100,42.08744557,24.40055623,22.52000046,"A first look at Amazon's new delivery drone, slated to start deliveries this year","After years of slow progress, Amazon says it's ready to deliver orders under five pounds in less than an hour using its 5-foot hexagonal drone.",https://www.cnbc.com/2022/11/11/a-first-look-at-amazons-new-delivery-drone.html,cnbc.com,9,year slow progress amazon say ready deliver order five pound less hour using foot hexagonal drone,0.7184,0.64656,0.165746875,0.480813125,Positive Impact
14/11/2022,98.77,100.12,97.29,98.49,98.49,99533100,-0.27,-314.4290963,1.192,0,14.33339876,0.959429757,-0.018638346,3.78,297.711,11196.21973,15228.98047,7385.200195,6609.169922,3083.399902,61624.14844,19921.80078,113.3516005,129.0146003,110.3729455,127.8403308,103.5320007,127.4436843,79.62031719,29.81559349,-6.0175905,-6.290426085,0.2728355854,5.968572344,101.1900024,9503723000,37.69413598,36.71139266,23.72999954,"Amazon Reportedly Set to Cut 10,000 Corporate Jobs","Retailing and cloud giant Amazon recently posted disappointing guidance for the fourth quarter, as the softening global economy impacts its businesses.",https://www.barrons.com/articles/amazon-layoffs-stock-51668454970,barrons.com,9,retailing cloud giant amazon recently posted disappointing guidance fourth quarter softening global economy impact business,-0.3612,-0.32508,0.116165313,-0.441245313,Negative Impact
15/11/2022,103.21,103.79,97.34,98.94,98.94,111336300,-0.27,-314.4290963,1.192,0,14.33339876,0.959429757,-0.018638346,3.78,297.711,11358.41016,15381,7369.399902,6641.660156,3134.080078,61872.98828,19994.80078,112.8082005,128.7614328,109.9245948,127.5527654,102.6610008,125.8637999,79.45820178,33.37311401,-5.465968209,-6.12553451,0.6595663013,6.012144361,85.87000275,9615059300,46.26548565,42.01568907,24.54000092,Redakteure von Amazon Books verkÃÂÃÂ¼nden die besten BÃÂÃÂ¼cher des Jahres 2022,"SEATTLE (USA)--(BUSINESS WIRE)--Heute gaben die Redakteure von Amazon Books ihre Auswahl fÃÂÃÂ¼r die besten BÃÂÃÂ¼cher des Jahres 2022 bekannt und wÃÂÃÂ¤hlten Gabrielle Zevins Roman Tomorrow, and Tomorrow, and Tomorrow zum besten Buch des Jahres. Die jÃÂÃÂ¤hrliche Liste wird von einem Team von Redakteuren handverlesen, die jedes Jahr Tausende von BÃÂÃÂ¼chern lesen und ihre Empfehlungen auf Amazon Book Review teilen, um den Kunden zu helfen, ihre nÃÂÃÂ¤chste groÃÂÃÂartige LektÃÂÃÂ¼re zu finden. Neben den 100 besten BÃÂÃÂ¼chern, die in diesem Jahr erschienen sind, haben die Herausgeber auch die jeweils 20 besten BÃÂÃÂ¼cher in beliebten Kategorien ausgewÃÂÃÂ¤hlt, darunter Krimis, Memoiren, Liebesromane, KinderbÃÂÃÂ¼cher (nach Alter), Geschichte, KochbÃÂÃÂ¼cher und mehr. Die vollstÃÂÃÂ¤ndige Liste der besten BÃÂÃÂ¼cher des Jahres 2022 finden Sie unter amazon.com/bestbooks2022. ÃÂÃÂWir hatten dieses Jahr eine reiche Auswahl an tollen BÃÂÃÂ¼chernÃÂÃÂ, sagte Sarah Gelman, Redaktionsleiterin bei Amazon Books. ÃÂÃÂAber dass sich unser leidenschaftliches (sprich: vielstimmiges!) Redaktionsteam auf ein Lieblingsbuch einigen konnte, grenzt an ein Wunder. Tomorrow, and Tomorrow, and Tomorrow ist so ein Wunder ÃÂÃÂ ein schlicht und einfach perfektes Buch ÃÂÃÂ¼ber die KomplexitÃÂÃÂ¤t menschlicher Beziehungen, die Bedeutung menschlicher Verbundenheit, die Unschuld und den Optimismus der Jugend, unsere Reise mit der Technologie und die zahlreichen Schattierungen der Liebe.ÃÂÃÂ Tomorrow, and Tomorrow, and Tomorrow findet auch bei den LeserInnen groÃÂÃÂen Anklang. Eines der von den Kindle-LeserInnen am hÃÂÃÂ¤ufigsten angefÃÂÃÂ¼hrten Zitate lautet: ÃÂÃÂWas ist ein Spiel?ÃÂÃÂ Marx sagte: ÃÂÃÂMorgen, morgen und wieder morgen. Es ist die MÃÂÃÂ¶glichkeit einer unendlichen Wiedergeburt, einer unendlichen ErlÃÂÃÂ¶sung. Die Vorstellung, dass man gewinnen kann, wenn man weiterspielt. Kein Verlust ist von Dauer, denn nichts ist von Dauer, niemals.ÃÂÃÂ ÃÂÃÂIch habe viele BÃÂÃÂ¼cher aus diesem Jahr geliebt, daher ist es eine unerwartete Ehre, dass Tomorrow, and Tomorrow, and Tomorrow zu Amazons ÃÂÃÂBest of the YearÃÂÃÂ gewÃÂÃÂ¤hlt wurdeÃÂÃÂ, so Zevin. ÃÂÃÂEs ist eine bemerkenswerte Zeit, um SchriftstellerIn und LeserIn zu sein!ÃÂÃÂ ÃÂÃÂDer Optimismus einer neuen Generation steht im Mittelpunkt vieler unserer Lieblingsgeschichten in diesem Jahr, nicht nur in Tomorrow, and Tomorrow, and Tomorrow, sondern auch in Solito, Demon Copperhead, Our Missing Hearts und IÃÂÃÂm Glad My Mom DiedÃÂÃÂ, erklÃÂÃÂ¤rte Gelman. ÃÂÃÂAuch in anderen ausgewÃÂÃÂ¤hlten BÃÂÃÂ¼chern wie Memphis, Remarkably Bright Creatures, und Now is Not the Time to Panic geht es um die Kraft von Beziehungen und platonischer Liebe.ÃÂÃÂ Nachstehend sind die Top 10-BÃÂÃÂ¼cher der Amazon Books Editors fÃÂÃÂ¼r das Jahr 2022 nebst einer Beschreibung der HerausgeberInnen aufgefÃÂÃÂ¼hrt: Das von den Amazon Books Editors ausgewÃÂÃÂ¤hlte Top-Kinderbuch des Jahres 2022 ist The Door of No Return von Kwame Alexander. Seira Wilson, Amazon Editor, erklÃÂÃÂ¤rte ihre Wahl mit den Worten: ÃÂÃÂKwame Alexanders auÃÂÃÂergewÃÂÃÂ¶hnlicher Roman ist von der ghanaischen Geschichte inspiriert und flieÃÂÃÂt so leicht wie das Wasser, das durch die TrÃÂÃÂ¤ume des jungen Protagonisten flieÃÂÃÂt. Inmitten der Familie, der Schule und der Aufregung ÃÂÃÂ¼ber die erste Verliebtheit gerÃÂÃÂ¤t Kofis Welt aus den Fugen, als ein schrecklicher Unfall einen festlichen Anlass in ein Ereignis voller Trauer und Wut verwandelt ÃÂÃÂ und das ist nur ein kleiner Vorgeschmack auf das, was noch kommen wird. The Door of No Return ist ein brillantes Werk, das die LeserInnen mit Freude, Angst, Trauer, Hoffnung und Liebe fÃÂÃÂ¼r den mutigen, widerstandsfÃÂÃÂ¤higen Jungen erfÃÂÃÂ¼llt.ÃÂÃÂ Die AutorInnen der drei besten BÃÂÃÂ¼cher ÃÂÃÂ Gabrielle Zevin, Javier Zamora und Johann Hari ÃÂÃÂ werden am 15. November 2022 um 9 Uhr PDT an einer Amazon Live Author Series-Konferenz teilnehmen, um die Auswahl der besten BÃÂÃÂ¼cher des Jahres zu feiern. Besuchen Sie Amazon Live, um dabei zu sein. Weitere Informationen zu den BÃÂÃÂ¼chern auf der Liste der besten BÃÂÃÂ¼cher des Jahres sowie aufschlussreiche Rezensionen neuer BÃÂÃÂ¼cher, Autoreninterviews und handverlesene Zusammenstellungen in beliebten Kategorien finden Sie in der Amazon Book Review unter www.amazon.com/amazonbookreview. AuÃÂÃÂerdem kÃÂÃÂ¶nnen Sie den Empfehlungen und GesprÃÂÃÂ¤chen der Amazon Books Editors unter @amazonbooks auf Facebook, Twitter und Instagram folgen. ÃÂÃÂber Amazon Amazon orientiert sich an vier GrundsÃÂÃÂ¤tzen: Orientierung am Kunden statt an der Konkurrenz, Leidenschaft fÃÂÃÂ¼r Neuerungen, Einsatz fÃÂÃÂ¼r betriebliche Optimierung sowie langfristiges Denken. Unser Ziel ist es, das weltweit kundenorientierteste Unternehmen und der beste Arbeitgeber mit dem sichersten Arbeitsumfeld zu sein. Kundenrezensionen, 1-Klick-EinkÃÂÃÂ¤ufe, persÃÂÃÂ¶nliche Empfehlungen, Prime, Versand durch Amazon, AWS, Kindle Direct Publishing, Kindle, Fire-Tablets, Fire TV, Amazon Echo, Alexa, Just Walk Out Technology, Amazon Studios und The Climate Pledge sind nur einige der Innovationen, die Amazon hervorgebracht hat. FÃÂÃÂ¼r weitere Informationen besuchen Sie amazon.com/about und folgen Sie @AmazonNews. Die Ausgangssprache, in der der Originaltext verÃÂÃÂ¶ffentlicht wird, ist die offizielle und autorisierte Version. ÃÂÃÂbersetzungen werden zur besseren VerstÃÂÃÂ¤ndigung mitgeliefert. Nur die Sprachversion, die im Original verÃÂÃÂ¶ffentlicht wurde, ist rechtsgÃÂÃÂ¼ltig. Gleichen Sie deshalb ÃÂÃÂbersetzungen mit der originalen Sprachversion der VerÃÂÃÂ¶ffentlichung ab.",https://www.businesswire.com/news/home/20221115005597/de/,businesswire.com,5,seattle usabusiness wireheute gaben die redakteure von amazon book ihre auswahl fr die besten bcher de jahres bekannt und whlten gabrielle zevins roman tomorrow tomorrow tomorrow zum besten buch de jahres die jhrliche liste wird von einem team von redakteuren handverlesen die jedes jahr tausende von bchern lesen und ihre empfehlungen auf amazon book review teilen um den kunden zu helfen ihre nchste groartige lektre zu finden neben den besten bchern die diesem jahr erschienen sind haben die herausgeber auch die jeweils besten bcher beliebten kategorien ausgewhlt darunter krimis memoiren liebesromane kinderbcher nach alter geschichte kochbcher und mehr die vollstndige liste der besten bcher de jahres finden sie unter amazoncombestbooks wir hatten diesis jahr eine reiche auswahl tollen bchern sagte sarah gelman redaktionsleiterin bei amazon book aber das sich unser leidenschaftliches sprich vielstimmiges redaktionsteam auf ein lieblingsbuch einigen konnte grenzt ein wunder tomorrow tomorrow tomorrow ist ein wunder ein schlicht und einfach perfektes buch ber die komplexitt menschlicher beziehungen die bedeutung menschlicher verbundenheit die unschuld und den optimismus der jugend unsere reise mit der technologie und die zahlreichen schattierungen der liebe tomorrow tomorrow tomorrow findet auch bei den leserinnen groen anklang eines der von den kindleleserinnen hufigsten angefhrten zitate lautet ist ein spiel marx sagte morgen morgen und wieder morgen e ist die mglichkeit einer unendlichen wiedergeburt einer unendlichen erlsung die vorstellung das man gewinnen kann wenn man weiterspielt kein verlust ist von dauer denn nichts ist von dauer niemals ich habe viele bcher au diesem jahr geliebt daher ist e eine unerwartete ehre das tomorrow tomorrow tomorrow zu amazon best year gewhlt wurde zevin e ist eine bemerkenswerte zeit um schriftstellerin und leserin zu sein der optimismus einer neuen generation steht im mittelpunkt vieler unserer lieblingsgeschichten diesem jahr nicht nur tomorrow tomorrow tomorrow sondern auch solito demon copperhead missing heart und im glad mom died erklrte gelman auch anderen ausgewhlten bchern wie memphis remarkably bright creature und time panic geht e um die kraft von beziehungen und platonischer liebe nachstehend sind die top bcher der amazon book editor fr da jahr nebst einer beschreibung der herausgeberinnen aufgefhrt da von den amazon book editor ausgewhlte topkinderbuch de jahres ist door return von kwame alexander seira wilson amazon editor erklrte ihre wahl mit den worten kwame alexander auergewhnlicher roman ist von der ghanaischen geschichte inspiriert und fliet leicht wie da wasser da durch die trume de jungen protagonisten fliet inmitten der familie der schule und der aufregung ber die erste verliebtheit gert kofis welt au den fugen al ein schrecklicher unfall einen festlichen anlass ein ereignis voller trauer und wut verwandelt und da ist nur ein kleiner vorgeschmack auf da noch kommen wird door return ist ein brillantes werk da die leserinnen mit freude angst trauer hoffnung und liebe fr den mutigen widerstandsfhigen jungen erfllt die autorinnen der drei besten bcher gabrielle zevin javier zamora und johann hari werden november um uhr pdt einer amazon live author serieskonferenz teilnehmen um die auswahl der besten bcher de jahres zu feiern besuchen sie amazon live um dabei zu sein weitere informationen zu den bchern auf der liste der besten bcher de jahres sowie aufschlussreiche rezensionen neuer bcher autoreninterviews und handverlesene zusammenstellungen beliebten kategorien finden sie der amazon book review unter auerdem knnen sie den empfehlungen und gesprchen der amazon book editor unter amazonbooks auf facebook twitter und instagram folgen ber amazon amazon orientiert sich vier grundstzen orientierung kunden statt der konkurrenz leidenschaft fr neuerungen einsatz fr betriebliche optimierung sowie langfristiges denken unser ziel ist e da weltweit kundenorientierteste unternehmen und der beste arbeitgeber mit dem sichersten arbeitsumfeld zu sein kundenrezensionen klickeinkufe persnliche empfehlungen prime versand durch amazon aws kindle direct publishing kindle firetablets fire tv amazon echo alexa walk technology amazon studio und climate pledge sind nur einige der innovationen die amazon hervorgebracht hat fr weitere informationen besuchen sie amazoncomabout und folgen sie amazonnews die ausgangssprache der der originaltext verffentlicht wird ist die offizielle und autorisierte version bersetzungen werden zur besseren verstndigung mitgeliefert nur die sprachversion die im original verffentlicht wurde ist rechtsgltig gleichen sie deshalb bersetzungen mit der originalen sprachversion der verffentlichung ab,-0.998,-0.499,0.1420945455,-0.641094545,Negative Impact
16/11/2022,96.85,98.49,95.54,97.12,97.12,87958800,-0.27,-314.4290963,1.192,0,14.33339876,0.959429757,-0.018638346,3.78,297.711,11183.66016,15265.25,7351.200195,6607.220215,3119.97998,61980.71875,19958,112.1610007,128.4910653,109.4224539,127.2499518,101.763501,124.3250716,79.20193032,35.40085056,-5.116680427,-5.923763693,0.8070832666,5.834286826,86.22840271,9527100500,59.21052632,47.72338265,24.11000061,Amazon Starts Massive Round Of LayoffsÃÂÃÂHere Are The Biggest U.S. Job Cuts This Year,Forbes is tracking the biggest layoffs in the U.S. this year as companies react to fears of a looming recession.,https://www.forbes.com/sites/brianbushard/2022/11/16/amazon-starts-massive-round-of-layoffs-here-are-the-biggest-us-job-cuts-this-year/,forbes.com,8,forbes tracking biggest layoff u year company react fear looming recession,-0.7579,-0.60632,0.1323111765,-0.738631176,Negative Impact
17/11/2022,95.37,96.97,94.03,94.85,94.85,82617900,-0.27,-314.4290963,1.192,0,14.33339876,0.959429757,-0.018638346,3.78,297.711,11144.95996,15223.95996,7346.5,6576.120117,3115.429932,61750.60156,19884.59961,111.4616005,128.2122528,108.8509851,126.9275642,100.7435009,122.5704234,78.9165784,39.83855469,-4.965795121,-5.732169979,0.7663748575,5.105001722,86.57963467,9444482600,47.26313541,50.91304912,23.93000031,Duke Energy collaborates with AWS to develop smart grid solutions to better serve customers and drive its clean energy transition,Duke Energy will build new smart grid software and services on AWS and expand its Intelligent Grid Services ÃÂÃÂ a suite of custom-built applications that help the utility anticipate future energy demand and identify where and how to update the power grid. AWS will build out the cloud technologies needed to support these critical grid-planning solutions.,https://www.prnewswire.com/news-releases/duke-energy-collaborates-with-aws-to-develop-smart-grid-solutions-to-better-serve-customers-and-drive-its-clean-energy-transition-301681703.html,prnewswire.com,5,duke energy build new smart grid software service aws expand intelligent grid service suite custombuilt application help utility anticipate future energy demand identify update power grid aws build cloud technology needed support critical gridplanning solution,0.9337,0.46685,0.091375,0.375475,Positive Impact
18/11/2022,95.95,95.99,92.48,94.14,94.14,72428200,-0.27,-314.4290963,1.192,0,14.33339876,0.959429757,-0.018638346,3.78,297.711,11146.05957,15309.76953,7385.5,6644.459961,3097.23999,61663.48047,19980.90039,110.6790004,127.9887253,108.2740837,126.6013198,99.48450089,119.640667,79.32833481,40.08600107,-4.847627984,-5.55526158,0.7076335955,5.060715267,86.923842,9372054400,44.20094627,50.22486933,23.12000084,CEO Andrew Jassy tells Amazon workers that layoffs will continue into 2023,"ÃÂÃÂIt's not lost on me or any of the leaders who make these decisions that these aren't just roles we're eliminating, but rather, people with emotions, ambitions, and responsibilities whose lives will be impacted.ÃÂÃÂ",https://nypost.com/2022/11/18/ceo-andrew-jassy-tells-amazon-workers-that-layoffs-will-continue-into-2023/,nypost.com,5,lost leader make decision arent role eliminating rather people emotion ambition responsibility whose life impacted,-0.3182,-0.1591,0.080589,-0.239689,Negative Impact
21/11/2022,93.97,95.02,90.59,92.46,92.46,84330300,-0.27,-314.4290963,1.192,0,14.33339876,0.959429757,-0.018638346,3.78,297.711,11024.50977,15278.25977,7376.899902,6634.450195,3085.043945,61144.83984,19977.09961,109.7992004,127.6628278,107.6539235,126.2616052,98.11650085,116.0530559,80.17994584,44.28609111,-4.833820389,-5.410973342,0.5771529528,4.768572126,87.26116518,9287724100,36.77453689,42.74620619,22.36000061,Judge orders Amazon to stop retaliations against organizers,"A former employee, Gerald Bryson, was fired in April 2020, weeks after participating in a protest over working conditions during the early days of the COVID-19 pandemic.",https://www.foxbusiness.com/economy/judge-orders-amazon-stop-retaliations-against-organizers,foxbusiness.com,5,former employee gerald bryson fired april week participating protest working condition early day covid pandemic,-0.6808,-0.3404,0.1911227778,-0.531522778,Negative Impact
22/11/2022,92.62,93.35,90.87,93.20,93.20,62192000,-0.27,-314.4290963,1.192,0,14.33339876,0.959429757,-0.018638346,3.78,297.711,11174.41016,15481.75977,7452.799805,6657.529785,3088.943115,61418.96094,20220,109.1268004,127.3391503,107.0871028,125.932634,96.74650078,111.3233127,82.16968885,51.5900968,-4.708885031,-5.27055568,0.5616706483,4.536429269,87.59174189,9349916100,40.90398968,40.62649095,21.29000092,"Investors Heavily Search Amazon.com, Inc. (AMZN): Here is What You Need to Know","Amazon (AMZN) has received quite a bit of attention from Zacks.com users lately. Therefore, it is wise to be aware of the facts that can impact the stock's prospects.",https://www.zacks.com/stock/news/2020860/investors-heavily-search-amazon-com-inc-amzn-here-is-what-you-need-to-know,zacks.com,8,amazon amzn received quite bit attention zackscom user lately therefore wise aware fact impact stock prospect,0.7184,0.57472,0.028370625,0.546349375,Positive Impact
23/11/2022,93.24,94.58,92.83,94.13,94.13,59414700,-0.27,-314.4290963,1.192,0,14.33339876,0.959429757,-0.018638346,3.78,297.711,11285.32031,15545.51953,7465.200195,6679.089844,3096.906982,61510.57813,20282.30078,108.4384003,127.0027328,106.578981,125.6161898,95.67000046,107.2344178,84.10558307,57.53038969,-4.483150638,-5.113074671,0.6299240332,4.341429029,87.91570707,9409330800,46.09372406,41.25741688,20.35000038,Amazon plans to pour $1 billion annually on theater movies,"Amazon.com Inc. AMZN, +1.02% will spend more than $1 billion annually on 12 to 15 movies that initially play in theaters, according to a Bloomberg report Wednesday. The ambitious outlay, believed to be the most by an internet company on theater-first movies, comes as Amazon dukes it out with video-streaming rivals Walt Disney Co. DIS, +2.11% , Apple Inc. AAPL, +0.47% , and Netflix Inc. NFLX, +1.07% who are plowing billions of dollars a year to create movie and episodic content.",https://www.marketwatch.com/story/amazon-plans-to-pour-1-billion-annually-on-theater-movies-2022-11-23,marketwatch.com,8,amazoncom inc amzn spend billion annually movie initially play theater according bloomberg report wednesday ambitious outlay believed internet company theaterfirst movie come amazon duke videostreaming rival walt disney co dis apple inc aapl netflix inc nflx plowing billion dollar year create movie episodic content,0.8074,0.64592,0.2639776923,0.3819423077,Positive Impact
25/11/2022,93.79,94.43,93.07,93.41,93.41,35088600,-0.27,-314.4290963,1.192,0,14.33339876,0.959429757,-0.018638346,3.78,297.711,11226.36035,15605.66992,7486.700195,6712.47998,3101.689941,62293.64063,20383.80078,107.7810004,126.6638353,106.0625506,125.2957302,94.79250069,103.8672571,85.71774426,53.90549608,-4.312638558,-4.952987449,0.6403488907,4.124286107,88.23319295,9374242200,42.07590227,43.02453867,20.5,Amazon workers strike in the US and 30 other countries on Black Friday in global 'Make Amazon Pay' campaign,Protests and warehouse strikes come as Amazon faces unionization efforts across the world from Staten Island to Japan.,https://www.businessinsider.com/make-amazon-pay-warehouse-strike-protest-black-friday-2022-11,businessinsider.com,7,protest warehouse strike come amazon face unionization effort across world staten island japan,-0.2023,-0.14161,0.1997688889,-0.341378889,Negative Impact
28/11/2022,93.93,96.40,93.43,93.95,93.95,74943100,-0.27,-314.4290963,1.192,0,14.33339876,0.959429757,-0.018638346,3.78,297.711,11049.5,15370.44043,7474,6665.200195,3078.550049,62504.80078,20220.5,107.1894003,126.3385678,105.5875485,124.9838324,94.31950035,102.4389,86.20010072,55.48076683,-4.086823207,-4.7797546,0.6929313935,4.119286128,88.54432911,9449185300,45.08925796,44.4196281,22.20999908,Antitrust Reframed: What It Means For These Mergers,"Regulators and politicians are currently attempting to unravel over 40 years of antitrust precedent and replace it with an early twentieth-century approach. The new approach would reframe antitrust policy and enforcement as a political and social tool, in addition to an economic one.",https://seekingalpha.com/article/4560851-antitrust-reframed-what-it-means-for-these-mergers,seekingalpha.com,6,regulator politician currently attempting unravel year antitrust precedent replace early twentiethcentury approach new approach would reframe antitrust policy enforcement political social tool addition economic one,0,0,0.345254375,-0.345254375,Negative Impact
29/11/2022,94.04,94.41,91.44,92.42,92.42,65567300,-0.27,-314.4290963,1.192,0,14.33339876,0.959429757,-0.018638346,3.78,297.711,10983.78027,15433.45996,7512,6668.970215,3149.75,62681.83984,20277.40039,106.5446002,126.0342003,105.0711739,124.6598141,93.81850014,101.0118833,86.62511694,53.79116655,-3.985380048,-4.62087969,0.6354996415,4.082143511,88.84924254,9383618000,36.55131748,41.2388259,21.88999939,7 Stocks to Buy That Will Make You a Multi-Millionaire,"The stock market took a beating this year, especially tech stocks, with many of them down significantly. Then again, with margins declining and interest rates rising, investors are no longer willing to pay a premium and have retreated to defensive stocks.",https://investorplace.com/2022/11/7-stocks-to-buy-that-will-make-you-a-multi-millionaire/,investorplace.com,6,stock market took beating year especially tech stock many significantly margin declining interest rate rising investor longer willing pay premium retreated defensive stock,-0.0772,-0.04632,0.4157216129,-0.462041613,Negative Impact
30/11/2022,92.47,96.54,91.53,96.54,96.54,102805800,-0.27,-314.4290963,1.192,0,14.33339876,0.959429757,-0.018638346,3.78,297.711,11468,15780.01953,7573.100098,6738.549805,3151.340088,63099.64844,20453.30078,106.0316002,125.7410653,104.7366181,124.380015,93.80600014,100.9784803,86.63351993,66.01971938,-3.531823166,-4.403068385,0.871245219,4.146429334,89.14805771,9486423800,45.07577662,42.23878402,20.57999992,Amazon Is Signaling its India Fatigue,"Closing small subsidiaries doesn't at first look like a major defeat. But the exit from wholesale e-commerce means, for now at least, Amazon is conceding to Walmart-backed Flipkart and Reliance in ÃÂÃÂkirana-tech.",https://www.wsj.com/articles/amazon-is-signaling-its-india-fatigue-11669811065,wsj.com,9,closing small subsidiary doesnt first look like major defeat exit wholesale ecommerce mean least amazon conceding walmartbacked flipkart reliance kiranatech,-0.6836,-0.61524,0.2830838462,-0.898323846,Negative Impact
01/12/2022,96.99,97.23,94.92,95.50,95.50,68488000,-0.27,-314.4290963,1.192,0,14.33339876,0.959429757,-0.018638346,4.1,296.797,11482.4502,15761.12012,7558.5,6753.970215,3165.469971,63284.19141,20525.5,105.5708002,125.4360128,104.3743978,124.0926517,93.975,101.1394895,86.81051048,47.54455205,-3.219186672,-4.166292042,0.9471053709,3.415000916,89.44089658,9417935800,37.19698454,39.60802621,19.84000015,Amazon's cloud unit wants to widen appeal of cashier-less tech,"Amazon.com Inc hopes to interest a wider range of industries in the technology it developed for cashier-less checkout at brick-and-mortar shops, a vice president said.",https://www.reuters.com/technology/amazons-cloud-unit-wants-widen-appeal-cashier-less-tech-2022-12-01/,reuters.com,10,amazoncom inc hope interest wider range industry technology developed cashierless checkout brickandmortar shop vice president said,0.7096,0.7096,0.2683346154,0.4412653846,Positive Impact
02/12/2022,94.48,95.36,93.78,94.13,94.13,72496400,-0.27,-314.4290963,1.192,0,14.33339876,0.959429757,-0.018638346,4.1,296.797,11461.5,15767.01953,7556.200195,6742.25,3156.139893,62868.5,20485.69922,105.1072002,125.1161603,103.9726566,123.7945158,94.21649971,101.034727,87.39827246,33.53114921,-3.046845629,-3.94240276,0.8955571305,3.212143489,89.72787866,9345439400,26.81817945,36.36364687,19.05999947,These Were the Five Best and Worst Performing Mega-Cap Stocks in November 2022,"While 2022 has been a dismal year for investors so far, November has offered some respite.",https://247wallst.com/investing/2022/12/02/these-were-the-five-best-and-worst-performing-mega-cap-stocks-in-november-2022/,247wallst.com,5,dismal year investor far november offered respite,-0.6124,-0.3062,0.1280930769,-0.434293077,Negative Impact
05/12/2022,93.05,94.06,90.82,91.01,91.01,71535500,-0.27,-314.4290963,1.192,0,14.33339876,0.959429757,-0.018638346,4.1,296.797,11239.94043,15474.79004,7567.5,6696.959961,3211.810059,62834.60156,20242.30078,104.6518002,124.7979478,103.4643172,123.4683017,94.21799965,101.0332416,87.40275773,32.22433908,-3.125987208,-3.779119649,0.6531324414,3.198571886,90.00912111,9273903900,3.181861005,22.39900833,20.75,ÃÂÃÂTis The Season For Retail Tech To Shine,"Let technology shine this holiday season Retailers are always looking for ways to ensure retail experiences are easy, enjoyable and efficient for shoppers and shop-floor workers alike.",https://www.forbes.com/sites/jillstandish/2022/12/05/tis-the-season-for-retail-tech-to-shine/,forbes.com,8,let technology shine holiday season retailer always looking way ensure retail experience easy enjoyable efficient shopper shopfloor worker alike,0.9169,0.73352,0.164855,0.568665,Positive Impact
06/12/2022,90.5,91.04,87.90,88.25,88.25,75503600,-0.27,-314.4290963,1.192,0,14.33339876,0.959429757,-0.018638346,4.1,296.797,11014.88965,15328.45996,7521.399902,6687.790039,3212.530029,62626.35938,19990.19922,104.1138002,124.4761903,102.8676773,123.1178709,94.10399971,101.2473659,86.96063354,27.10919351,-3.372540043,-3.697803728,0.325263685,2.962142944,103.7900009,9198400300,3.304991456,11.1016773,22.17000008,IMDb Announces the Top Stars and Top Breakout Stars of 2022 and Presents a STARmeter Award to Emma DÃÂÃÂArcy,"SEATTLE--(BUSINESS WIRE)--IMDb (www.imdb.com), the worldÃÂÃÂs most popular and authoritative source for information on movies, TV shows, and celebrities, today unveiled the Top 10 Stars and Top 10 Breakout Stars of 2022. Rather than base its annual rankings on small statistical samplings, reviews of professional critics, or box-office performance, IMDb determines its definitive Top 10 lists using data from IMDbPro STARmeter rankings, which are based on the actual page views of the more than 200 million monthly visitors to IMDb. IMDb also announced today that this yearÃÂÃÂs Top Breakout Star, Emma DÃÂÃÂArcy, accepted an IMDb ÃÂÃÂBreakout StarÃÂÃÂ STARmeter Award. Ana de Armas is this yearÃÂÃÂs most popular star, marking her fifth time on the year-end list of Top Stars. IMDb Top 10 Breakout Stars of 2022* *Among the group of stars who charted on the IMDb annual Top 100 list for the first time in their careers in 2022, these 10 stars consistently ranked highest on the IMDbPro STARmeter chart throughout the year. IMDbPro STARmeter rankings are based on the actual page views of the more than 200 million monthly visitors to IMDb. Emma DÃÂÃÂArcy received an IMDb ÃÂÃÂBreakout StarÃÂÃÂ STARmeter Award for their performance as Queen Rhaenyra Targaryen in House of the Dragon, which ranks as one of the Most Popular TV Shows on IMDb this year. DÃÂÃÂArcy has been a strong performer this year on the IMDbPro STARmeter chart, spending three weeks in the No. 1 spot and an additional eight weeks in the Top 10. DÃÂÃÂArcy also ranked No. 2 on the overall Top Stars of 2022 list, and is followed by House of the Dragon co-star Milly Alcock, who plays the younger version of Rhaenyra Targaryen. STARmeter rankings are determined by the page views of the more than 200 million monthly visitors to IMDb worldwide. Previous IMDb STARmeter Award recipients include RegÃÂÃÂ©-Jean Page, Eiza GonzÃÂÃÂ¡lez, Alexander SkarsgÃÂÃÂ¥rd, Priyanka Chopra Jonas, John David Washington, Anya Chalotra, and DÃÂÃÂArcyÃÂÃÂs House of the Dragon co-star, Olivia Cooke. Learn more about IMDb STARmeter Awards at imdb.com/starmeterawards. Speaking exclusively to IMDb, DÃÂÃÂArcy expressed, ÃÂÃÂI feel so grateful to the fans of House of the Dragon for welcoming me and the rest of the cast into what is their universe. I have been amazed and very humbled by the love with which us Westerosi newcomers have been met! I have never before had the privilege of sharing a loved character with a fanbaseÃÂÃÂit felt like borrowing a treasured possession from a friend. I am so grateful to have been trusted with it.ÃÂÃÂ DÃÂÃÂArcy also shared the story behind their first IMDb credit, the 2018 series Wanderlust, which also starred Toni Collette and Zawe Ashton. ÃÂÃÂWanderlust was my first proper experience of acting on camera. I had never been inside a studio before, I had never seen a call sheet before! I couldnÃÂÃÂt believe the snacks were free!? I remember trying to ration my questions in an effort to mask my inexperience. I was very lucky on that showÃÂÃÂthe whole team was kind, caring, and patient. They looked after me beautifully. And in a way, it was the perfect project to support a transition from theatre to screen. Nick Payne originally wrote Wanderlust as a stage play, which was then adapted and extended for television. I knew that play well and adored it! So despite the newness of the medium, the world of the story was wonderfully familiar.ÃÂÃÂ IMDb Top 10 Stars of 2022* *The 10 stars who consistently ranked highest on the IMDbPro STARmeter chart throughout 2022. IMDbPro STARmeter rankings are based on the actual page views of the more than 200 million monthly visitors to IMDb. While six of this yearÃÂÃÂs Breakout Stars also trended in the overall Top Stars of the year list, fan favorites including Julia Garner, Millie Bobby Brown, and Lily James joined Ana de Armas, who have all previously ranked in the IMDb year-end lists. De Armas also topped the list in 2020. Entertainment fans particularly gravitated towards talent from popular series Stranger Things and House of the Dragon, with stars from those fan-favorite series landing half of the spots on the year-end lists. IMDb users can view this yearÃÂÃÂs Top 100 Stars of the Year gallery here: https://imdb.to/3B2U7KY ÃÂÃÂFans and professionals around the world once again turned to IMDb this year to discover and learn more about the emerging and established stars of fan-favorite titles,ÃÂÃÂ said Col Needham, founder and CEO of IMDb. ÃÂÃÂWe congratulate these top stars on their breakthrough career moments and thank the global community of entertainment professionals, companies, and other trusted contributors who submitted millions of updates to IMDb this year, helping us reach customers across more devices, services, locations, and languages than ever before.ÃÂÃÂ For comparison purposes, the IMDb 2021 year-end Top 10 lists are available at http://www.imdb.com/best-of/2021. The IMDb Best of 2022 section (www.imdb.com/best-of) features a variety of year-end Top 10 lists, more of which will be unveiled in the coming weeks, as well as retrospective photo galleries, trailers, original videos (including an ÃÂÃÂIn MemoriamÃÂÃÂ video), and other year-end coverage. Additional insight into trending movies, TV shows, and celebrities, with rankings updated weekly, is available to IMDbPro members throughout the year on both the site and apps for iPhone, iPad, and Android. IMDbPro includes comprehensive information and tools designed to help entertainment industry professionals achieve success throughout all stages of their career. IMDbPro offers members the following: detailed contact and representation information; more than 25,000 in-development film and TV titles not available on IMDb; tools to manage and showcase their IMDb profile, including selecting their primary images and the credits they are best ÃÂÃÂknown forÃÂÃÂ; IMDbPro Track, which allows members to receive personalized entertainment industry news and updates on the people and film and TV projects they want to follow; and a convenient tool that generates custom digital assets to promote their work on social media and other platforms. To become a member today, visit www.imdbpro.com. About IMDb IMDb is the world's most popular and authoritative source for information on movies, TV shows, and celebrities. Products and services to help fans decide what to watch and where to watch it include: the IMDb website for desktop and mobile devices; apps for iOS and Android; and X-Ray on Prime Video. IMDb also offers a free streaming channel, IMDb TV, and produces IMDb original video series and podcasts. For entertainment industry professionals, IMDb provides IMDbPro and Box Office Mojo. IMDb licenses information from its vast and authoritative database to third-party businesses worldwide; learn more at developer.imdb.com. IMDb is an Amazon company. For more information, visit imdb.com/press and follow @IMDb.",https://www.businesswire.com/news/home/20221205005789/en/IMDb-Announces-the-Top-Stars-and-Top-Breakout-Stars-of-2022-and-Presents-a-STARmeter-Award-to-Emma-D%E2%80%99Arcy,businesswire.com,5,seattlebusiness wireimdb world popular authoritative source information movie tv show celebrity today unveiled top star top breakout star rather base annual ranking small statistical sampling review professional critic boxoffice performance imdb determines definitive top list using data imdbpro starmeter ranking based actual page view million monthly visitor imdb imdb also announced today year top breakout star emma darcy accepted imdb breakout star starmeter award ana de armas year popular star marking fifth time yearend list top star imdb top breakout star among group star charted imdb annual top list first time career star consistently ranked highest imdbpro starmeter chart throughout year imdbpro starmeter ranking based actual page view million monthly visitor imdb emma darcy received imdb breakout star starmeter award performance queen rhaenyra targaryen house dragon rank one popular tv show imdb year darcy strong performer year imdbpro starmeter chart spending three week spot additional eight week top darcy also ranked overall top star list followed house dragon costar milly alcock play younger version rhaenyra targaryen starmeter ranking determined page view million monthly visitor imdb worldwide previous imdb starmeter award recipient include regjean page eiza gonzlez alexander skarsgrd priyanka chopra jonas john david washington anya chalotra darcys house dragon costar olivia cooke learn imdb starmeter award imdbcomstarmeterawards speaking exclusively imdb darcy expressed feel grateful fan house dragon welcoming rest cast universe amazed humbled love u westerosi newcomer met never privilege sharing loved character fanbaseit felt like borrowing treasured possession friend grateful trusted darcy also shared story behind first imdb credit series wanderlust also starred toni collette zawe ashton wanderlust first proper experience acting camera never inside studio never seen call sheet couldnt believe snack free remember trying ration question effort mask inexperience lucky showthe whole team kind caring patient looked beautifully way perfect project support transition theatre screen nick payne originally wrote wanderlust stage play adapted extended television knew play well adored despite newness medium world story wonderfully familiar imdb top star star consistently ranked highest imdbpro starmeter chart throughout imdbpro starmeter ranking based actual page view million monthly visitor imdb six year breakout star also trended overall top star year list fan favorite including julia garner millie bobby brown lily james joined ana de armas previously ranked imdb yearend list de armas also topped list entertainment fan particularly gravitated towards talent popular series stranger thing house dragon star fanfavorite series landing half spot yearend list imdb user view year top star year gallery fan professional around world turned imdb year discover learn emerging established star fanfavorite title said col needham founder ceo imdb congratulate top star breakthrough career moment thank global community entertainment professional company trusted contributor submitted million update imdb year helping u reach customer across device service location language ever comparison purpose imdb yearend top list available imdb best section feature variety yearend top list unveiled coming week well retrospective photo gallery trailer original video including memoriam video yearend coverage additional insight trending movie tv show celebrity ranking updated weekly available imdbpro member throughout year site apps iphone ipad android imdbpro includes comprehensive information tool designed help entertainment industry professional achieve success throughout stage career imdbpro offer member following detailed contact representation information indevelopment film tv title available imdb tool manage showcase imdb profile including selecting primary image credit best known imdbpro track allows member receive personalized entertainment industry news update people film tv project want follow convenient tool generates custom digital asset promote work social medium platform become member today visit imdb imdb world popular authoritative source information movie tv show celebrity product service help fan decide watch watch include imdb website desktop mobile device apps io android xray prime video imdb also offer free streaming channel imdb tv produce imdb original video series podcasts entertainment industry professional imdb provides imdbpro box office mojo imdb license information vast authoritative database thirdparty business worldwide learn developerimdbcom imdb amazon company information visit imdbcompress follow imdb,0.9995,0.49975,0.22047,0.27928,Positive Impact
07/12/2022,88.34,89.89,87.48,88.46,88.46,68086900,-0.27,-314.4290963,1.192,0,14.33339876,0.959429757,-0.018638346,4.1,296.797,10958.5498,15311.79004,7489.200195,6660.589844,3199.620117,62410.67969,19973.19922,103.5948001,124.1675028,102.3026703,122.7730164,94.0279995,101.3852495,86.67074947,30.08277932,-3.51052265,-3.660347513,0.1498248622,2.891428266,103.4722009,9266487200,10.05123823,5.512696897,22.68000031,French watchdog orders Amazon to pay $3.5 mln in penalties,"A French watchdog has ordered U.S. e-commerce giant Amazon.com to pay 3.3 million euros ($3.5 million) in penalties for failing to modify contractual provisions related to third-party sellers by the deadline it set, the watchdog said on Wednesday.",https://www.reuters.com/technology/french-watchdog-orders-amazon-pay-35-mln-penalties-2022-12-07/,reuters.com,10,french watchdog ordered u ecommerce giant amazoncom pay million euro million penalty failing modify contractual provision related thirdparty seller deadline set watchdog said wednesday,-0.7717,-0.7717,0.1979435294,-0.969643529,Negative Impact
08/12/2022,89.24,90.86,87.88,90.35,90.35,73305900,-0.27,-314.4290963,1.192,0,14.33339876,0.959429757,-0.018638346,4.1,296.797,11082,15399.94043,7472.200195,6647.310059,3197.350098,62570.67969,19969.19922,103.0416,123.8951178,101.8339381,122.4503993,94.23849945,100.8484489,87.62855003,39.46628491,-3.427853544,-3.613848719,0.1859951753,2.88357108,102.832513,9339793100,29.43584736,14.26402568,22.29000092,"Nasdaq Suffers Worst Start To December Since 1975: Will Santa Visit The Market Or Will The Grinch Hold Strong? - Tesla (NASDAQ:TSLA), Amazon.com (NASDAQ:AMZN)","The Nasdaq Composite Index was bouncing up almost 1% higher on Thursday, in relief, after suffering its worst first week of December since 1975, plunging 4.4% between the Nov. 30 closing price and the session finish on Wednesday.",https://www.benzinga.com/trading-ideas/long-ideas/22/12/30012256/nasdaq-suffers-worst-start-to-december-since-1975-will-santa-visit-the-market-or-will-th?SNAPI,benzinga.com,5,nasdaq composite index bouncing almost higher thursday relief suffering worst first week december since plunging nov closing price session finish wednesday,-0.6557,-0.32785,0.1904714286,-0.518321429,Negative Impact
09/12/2022,88.9,90.30,88.63,89.09,89.09,67398500,-0.27,-314.4290963,1.192,0,14.33339876,0.959429757,-0.018638346,4.1,296.797,11004.62012,15291.0498,7476.600098,6677.640137,3206.949951,62181.67188,19947.09961,102.5273999,123.5837778,101.3341757,122.118455,93.8614994,100.7513018,86.97169702,38.47556886,-3.424533433,-3.575985662,0.1514522286,2.755714417,102.2184126,9272394600,16.51274852,18.66661137,22.82999992,"How Amazon, Lowe's And Mastercard Can Potentially 6X Your Retirement Income","High-yield aristocrats are a great way to generate generous, safe, and growing yield today. But if you want to truly retire in safety and splendor, you need to maximize long-term retirement income over decades.",https://seekingalpha.com/article/4563290-amazon-lowes-mastercard-delivering-retirement-income,seekingalpha.com,6,highyield aristocrat great way generate generous safe growing yield today want truly retire safety splendor need maximize longterm retirement income decade,0.9682,0.58092,0.22912,0.3518,Positive Impact
12/12/2022,89.21,90.58,87.87,90.55,90.55,61999800,-0.27,-314.4290963,1.192,0,14.33339876,0.959429757,-0.018638346,4.1,296.797,11143.74023,15468.66992,7446,6650.549805,3179.040039,62130.57031,20019.69922,102.0784,123.2675853,100.911267,121.8043411,93.34949951,99.55982263,87.1391764,45.59705742,-3.266438413,-3.514076212,0.247637799,2.632857186,101.6288763,9334394400,31.48717636,25.81192408,25,IMDb Announces Top 10 Movies and Series of 2022,"SEATTLE--(BUSINESS WIRE)--IMDb (www.imdb.com), the worldÃÂÃÂs most popular and authoritative source for movie, TV, and celebrity content, today unveiled the Top 10 Movies and Series of 2022. Rather than base its annual rankings on small statistical samplings or reviews from professional critics, IMDb determines its list of the most popular movies and TV series by the actual page views of the more than 200 million monthly visitors to IMDb. This exclusive and definitive data is derived from the IMDbPro movie and TV rankings, which are updated weekly throughout the year. IMDb Top 10 Movies of 2022* *Among the movies released in the U.S. in 2022, these 10 were consistently most popular with IMDb users, as determined by the actual page views of the more than 200 million monthly visitors to IMDb worldwide. This exclusive and definitive data is derived from IMDbPro movie rankings, which are updated weekly throughout the year. IMDb users can add these and other titles to their IMDb Watchlist at https://www.imdb.com/watchlist. IMDb users can also rate movies theyÃÂÃÂve seen from each filmÃÂÃÂs IMDb title page to help other users discover and decide what to watch. IMDb Top 10 TV and Streaming Series of 2022* *The 10 TV and streaming series that released new episodes in 2022 and consistently ranked highest on the proprietary weekly TV rankings on IMDbPro throughout the year. IMDbPro rankings are based on the actual page views of the more than 200 million monthly visitors to IMDb worldwide. IMDb users can add these and other titles to their IMDb Watchlist at https://www.imdb.com/watchlist. IMDb users can also rate series theyÃÂÃÂve seen from each showÃÂÃÂs IMDb title page to help other users discover and decide what to watch. ÃÂÃÂIMDb congratulates these 20 movies and series for breaking through and resonating with our customers around the world in what was truly another electrifying year for entertainment,ÃÂÃÂ said Nikki Santoro, chief operating officer of IMDb. ÃÂÃÂIt is exciting to see Stranger Things earn the coveted #1 spot on our list of the most popular series of 2022 as determined by IMDb customer page views after consistently landing top spots our annual lists, with previous rankings at #2 in 2016, #5 in 2017, and #3 in 2019. We canÃÂÃÂt wait to see what happens next to these fan-favorite characters in Hawkins, Indiana.ÃÂÃÂ For comparison purposes, the IMDb 2021 year-end Top 10 lists are available at http://www.imdb.com/best-of/2021. The IMDb Best of 2022 section (www.imdb.com/best-of) features a variety of year-end Top 10 lists, more of which will be unveiled in the coming weeks, as well as retrospective photo galleries, trailers, original videos (including an ÃÂÃÂIn MemoriamÃÂÃÂ video), and other year-end coverage. Additional insight into trending movies, TV shows, and celebrities, with rankings updated weekly, is available to IMDbPro members throughout the year on both the site and apps for iPhone, iPad, and Android. IMDbPro includes comprehensive information and tools designed to help entertainment industry professionals achieve success throughout all stages of their career. IMDbPro offers members the following: detailed contact and representation information; more than 25,000 in-development film and TV titles not available on IMDb; tools to manage and showcase their IMDb profile, including selecting their primary images and the credits they are best ÃÂÃÂknown for;ÃÂÃÂ IMDbPro Track, which allows members to receive personalized entertainment industry news and updates on the people and film and TV projects they want to follow; and a convenient tool that generates custom digital assets to promote their work on social media and other platforms. To become a member today, visit www.imdbpro.com. About IMDb IMDb is the world's most popular and authoritative source for information on movies, TV shows, and celebrities. Products and services to help fans decide what to watch and where to watch it include: the IMDb website for desktop and mobile devices; apps for iOS and Android; and X-Ray on Prime Video. IMDb also offers a free streaming channel, IMDb TV, and produces IMDb original video series and podcasts. For entertainment industry professionals, IMDb provides IMDbPro and Box Office Mojo. IMDb licenses information from its vast and authoritative database to third-party businesses worldwide; learn more at developer.imdb.com. IMDb is an Amazon company. For more information, visit imdb.com/press and follow @IMDb.",https://www.businesswire.com/news/home/20221212005134/en/IMDb-Announces-Top-10-Movies-and-Series-of-2022,businesswire.com,5,seattlebusiness wireimdb world popular authoritative source movie tv celebrity content today unveiled top movie series rather base annual ranking small statistical sampling review professional critic imdb determines list popular movie tv series actual page view million monthly visitor imdb exclusive definitive data derived imdbpro movie tv ranking updated weekly throughout year imdb top movie among movie released u consistently popular imdb user determined actual page view million monthly visitor imdb worldwide exclusive definitive data derived imdbpro movie ranking updated weekly throughout year imdb user add title imdb watchlist imdb user also rate movie theyve seen film imdb title page help user discover decide watch imdb top tv streaming series tv streaming series released new episode consistently ranked highest proprietary weekly tv ranking imdbpro throughout year imdbpro ranking based actual page view million monthly visitor imdb worldwide imdb user add title imdb watchlist imdb user also rate series theyve seen show imdb title page help user discover decide watch imdb congratulates movie series breaking resonating customer around world truly another electrifying year entertainment said nikki santoro chief operating officer imdb exciting see stranger thing earn coveted spot list popular series determined imdb customer page view consistently landing top spot annual list previous ranking cant wait see happens next fanfavorite character hawkins indiana comparison purpose imdb yearend top list available imdb best section feature variety yearend top list unveiled coming week well retrospective photo gallery trailer original video including memoriam video yearend coverage additional insight trending movie tv show celebrity ranking updated weekly available imdbpro member throughout year site apps iphone ipad android imdbpro includes comprehensive information tool designed help entertainment industry professional achieve success throughout stage career imdbpro offer member following detailed contact representation information indevelopment film tv title available imdb tool manage showcase imdb profile including selecting primary image credit best known imdbpro track allows member receive personalized entertainment industry news update people film tv project want follow convenient tool generates custom digital asset promote work social medium platform become member today visit imdb imdb world popular authoritative source information movie tv show celebrity product service help fan decide watch watch include imdb website desktop mobile device apps io android xray prime video imdb also offer free streaming channel imdb tv produce imdb original video series podcasts entertainment industry professional imdb provides imdbpro box office mojo imdb license information vast authoritative database thirdparty business worldwide learn developerimdbcom imdb amazon company information visit imdbcompress follow imdb,0.9978,0.4989,0.3081533333,0.1907466667,Positive Impact
13/12/2022,95.23,96.25,90.52,92.49,92.49,100212000,-0.27,-314.4290963,1.192,0,14.33339876,0.959429757,-0.018638346,4.1,296.797,11256.80957,15562.54004,7502.899902,6744.97998,3176.330078,62533.30078,20023.5,101.6106,122.9622203,100.5810211,121.5126561,93.04949951,98.77502054,87.32397848,48.44910585,-2.950593003,-3.40137957,0.4507865673,2.865000589,101.0629214,9434606400,51.38455904,33.12816131,22.54999924,Here's why Amazon is Citi's top internet stock idea,"The internet sector faces ÃÂÃÂmultiple challenges,ÃÂÃÂ but that's not to say there isn't ÃÂÃÂample opportunityÃÂÃÂ in this part of the market.",https://www.marketwatch.com/story/heres-why-amazon-is-citis-top-internet-stock-idea-11670934950,marketwatch.com,8,internet sector face multiple challenge thats say isnt ample opportunity part market,-0.2575,-0.206,0.2584005,-0.4644005,Negative Impact
14/12/2022,92.5,93.46,89.87,91.58,91.58,70298000,-0.27,-314.4290963,1.192,0,14.33339876,0.959429757,-0.018638346,4.1,296.797,11170.88965,15494.98047,7495.899902,6730.790039,3176.530029,62677.91016,19891.69922,101.0204001,122.6644103,100.22804,121.2148187,92.68149948,97.71748526,87.6455137,44.42501789,-2.742103057,-3.269524268,0.5274212102,2.996428898,100.5196046,9364308400,42.0512664,41.6410006,21.13999939,"Leisure Group: Soccer, Strippers, & Gambling",The Zack's Leisure & Entertainment Group has multiple stocks with strong catalysts and high Zack's Rankings.,https://www.zacks.com/commentary/2028755/leisure-group-soccer-strippers-gambling,zacks.com,8,zacks leisure entertainment group multiple stock strong catalyst high zacks ranking,0.7269,0.58152,0.1805042857,0.4010157143,Positive Impact
15/12/2022,89.89,89.97,87.47,88.45,88.45,84802900,-0.27,-314.4290963,1.192,0,14.33339876,0.959429757,-0.018638346,4.1,296.797,10810.53027,15182.28027,7426.200195,6522.77002,3168.649902,61799.03125,19600.59961,100.3704001,122.3463978,99.76615592,120.8888006,92.24799919,97.16654258,87.3294558,40.18985967,-2.797194195,-3.175058253,0.3778640577,3.19285747,99.99802058,9279505500,10.04093763,34.49225436,22.82999992,Amazon Games und Crystal Dynamics schlieÃÂÃÂen einen Vertrag ÃÂÃÂ¼ber die Entwicklung und VerÃÂÃÂ¶ffentlichung des nÃÂÃÂ¤chsten groÃÂÃÂen Teils der legendÃÂÃÂ¤ren Tomb Raider-Serie,"SEATTLE--(BUSINESS WIRE)--Amazon Games und Crystal Dynamics gaben heute bekannt, dass sie eine Vereinbarung getroffen haben, nach der Crystal Dynamics einen neuen plattformÃÂÃÂ¼bergreifenden Tomb Raider-Titel entwickeln wird, wobei Amazon Games sie tatkrÃÂÃÂ¤ftig unterstÃÂÃÂ¼tzt und das Spiel zudem weltweit verÃÂÃÂ¶ffentlicht. Das noch unbenannte neue Tomb Raider-Spiel ist ein erzÃÂÃÂ¤hlerisches Einzelspieler-Abenteuer, das die Geschichte von Lara Croft in der Tomb Raider-Serie fortsetzt. Es enthÃÂÃÂ¤lt alle Elemente, die Tomb Raider zu einer der beliebtesten Spielreihen gemacht haben. Der Spieler ÃÂÃÂ¼bernimmt die Kontrolle ÃÂÃÂ¼ber die selbstbewusste und multidimensionale Heldin Lara Croft in einer Umgebung, die Erkundung und kreative Wegfindung erfordert, mit kniffligen RÃÂÃÂ¤tseln, die es zu lÃÂÃÂ¶sen gilt, und einer Vielzahl von Gegnern, die besiegt werden mÃÂÃÂ¼ssen. Crystal Dynamics nutzt die Leistung und die innovative Technologie der Unreal Engine 5, um das Storytelling im bisher grÃÂÃÂ¶ÃÂÃÂten und umfangreichsten Tomb Raider-Spiel auf die nÃÂÃÂ¤chste Stufe zu heben. Der Titel befindet sich derzeit in einer frÃÂÃÂ¼hen Entwicklungsphase, und weitere Details werden zu einem spÃÂÃÂ¤teren Zeitpunkt bekannt gegeben. ÃÂÃÂTomb Raider ist eine der beliebtesten IPs der UnterhaltungsgeschichteÃÂÃÂ, so Christoph Hartmann, VP von Amazon Games. ÃÂÃÂAmazon Games hat es sich zur Aufgabe gemacht, den Spielern Spiele hÃÂÃÂ¶chster QualitÃÂÃÂ¤t von den besten Entwicklern ÃÂÃÂ¼ber alle mÃÂÃÂ¶glichen Plattformen und Genres hinweg bereitzustellen, und wir fÃÂÃÂ¼hlen uns geehrt, mit diesem geschichtstrÃÂÃÂ¤chtigen Entwickler und Franchise zusammenzuarbeiten. Unser Team freut sich unglaublich darauf, mit dem talentierten und visionÃÂÃÂ¤ren Team von Crystal Dynamics zusammenzuarbeiten, um Spielern auf der ganzen Welt das nÃÂÃÂ¤chste Kapitel der Lara Croft-Saga zu prÃÂÃÂ¤sentieren.ÃÂÃÂ ÃÂÃÂCrystal Dynamics hat nach der ÃÂÃÂbernahme durch Embracer die auÃÂÃÂergewÃÂÃÂ¶hnliche MÃÂÃÂ¶glichkeit, eine Publishing-Beziehung fÃÂÃÂ¼r Tomb Raider neu zu definierenÃÂÃÂ, sagt Scot Amos, Head of Studio bei Crystal Dynamics. ÃÂÃÂMit Amazon Games haben wir ein Team gefunden, das unsere kreative Vision, unsere Ambitionen und unsere Werte fÃÂÃÂ¼r ein Lara-Croft-Universum ÃÂÃÂ¼ber das gesamte Spektrum der MÃÂÃÂ¶glichkeiten hinweg teilt. Sie sind einzigartig positioniert, um eine Publishing- und Entwicklungskooperationen neu zu definieren, und wir freuen uns darauf, diesen neuen Weg gemeinsam zu beschreiten, angefangen mit der Entwicklung des bisher grÃÂÃÂ¶ÃÂÃÂten und besten Tomb Raider-Spiels.ÃÂÃÂ Crystal Dynamics hat in den letzten drei Jahrzehnten Dutzende von preisgekrÃÂÃÂ¶nten Titeln entwickelt und verÃÂÃÂ¶ffentlicht, darunter weltweit beliebte Franchises wie Legacy of Kain und Tomb Raider. Das Tomb Raider-Franchise umfasst mehr als 20 Videospiele, begeistert mehr als 170 Millionen Menschen auf der ganzen Welt1 und hat sich seit der VerÃÂÃÂ¶ffentlichung des ersten Teils im Jahr 1996 mehr als 95 Millionen Mal verkauft. Die jÃÂÃÂ¼ngste Survivor-Trilogie, bestehend aus Tomb Raider, (2013), Rise of the Tomb Raider (2015) und Shadow of the Tomb Raider (2018), wurde mit mehr als 200 ÃÂÃÂBest ofÃÂÃÂ-Auszeichnungen und Nominierungen bedacht. Die Vereinbarung mit Crystal Dynamics stellt eine weitere Erweiterung der AAA-Publishing-BemÃÂÃÂ¼hungen von Amazon Games dar, zu denen auch Lost Ark von Smilegate RPG und das kÃÂÃÂ¼rzlich angekÃÂÃÂ¼ndigte Blue Protocol von Bandai Namco Online Inc. gehÃÂÃÂ¶ren. Der kommende Tomb Raider-Titel wird der erste erzÃÂÃÂ¤hlerische Einzelspielertitel von Amazon Games sein, nachdem die Multiplayer-Titel New World und Lost Ark bereits erfolgreich waren. FÃÂÃÂ¼r weitere Informationen und um auf dem Laufenden zu bleiben, besuchen Sie amazongames.com. ÃÂÃÂber Amazon Games Wir bei Amazon Games haben den Ehrgeiz, aufregende neue Erlebnisse zu schaffen, die die Gemeinschaft in und um unsere Spiele fÃÂÃÂ¶rdern. Unser Team aus Veteranen der Spielebranche arbeitet mit Prime Gaming, Twitch, Amazon Retail, Amazon Web Services (AWS) und noch weiteren zusammen, um ÃÂÃÂ¼ber den Tellerrand zu blicken und unseren Spielern fesselnde Erlebnisse zu bieten. Amazon Games entwickelt mit seinen Studios und Teams in Seattle, Orange County, San Diego und Montreal AAA-Multiplayer-Spiele, die auf Original-IPs basieren, darunter New World. Amazon Games verÃÂÃÂ¶ffentlicht zudem erstklassige Spiele von Drittverlegern, allen voran Lost Ark von Smilegate RPG und Blue Protocol von Bandai Namco Online. ÃÂÃÂber Crystal Dynamics Crystal Dynamics hat in seinem 30-jÃÂÃÂ¤hrigen, preisgekrÃÂÃÂ¶nten Abenteuer mehr als 30 Spiele entwickelt und verÃÂÃÂ¶ffentlicht. Zu den beliebten Franchises des Unternehmens gehÃÂÃÂ¶ren Legacy of Kain und TOMB RAIDER, das sich weltweit mehr als 95 Millionen Mal verkauft hat. Die Protagonistin von TOMB RAIDER ÃÂÃÂ die Heldin Lara Croft ÃÂÃÂ ist seit mehr als 25 Jahren eine kulturelle Ikone, die in mehr als 20 Spielen auftrat und praktisch alle Bereiche der Unterhaltung unauslÃÂÃÂ¶schlich geprÃÂÃÂ¤gt hat. Der Hauptsitz von Crystal Dynamics befindet sich in San Mateo (Kalifornien), zudem haben sie zwei weitere Studios: Crystal Northwest in Bellevue (Washington) und Crystal Southwest in Austin (Texas). Die Website von Crystal Dynamics ist zu finden unter https://crystald.com/ ÃÂÃÂber TOMB RAIDER Das TOMB RAIDER-Videospiel-Franchise, das kÃÂÃÂ¼rzlich sein 25-jÃÂÃÂ¤hriges JubilÃÂÃÂ¤um feierte, hat sich weltweit ÃÂÃÂ¼ber 95 Millionen Mal verkauft. Die PopularitÃÂÃÂ¤t des Franchise hat zu einer Reihe von Blockbuster-Filmen gefÃÂÃÂ¼hrt, die auf dem Originalspiel Tomb Raider und dem Reboot von 2013 basieren. Die Protagonistin Lara Croft ist seit ÃÂÃÂ¼ber zwei Jahrzehnten eine globale Ikone der Gegenwart. Der jÃÂÃÂ¼ngste Teil der weltberÃÂÃÂ¼hmten Franchise, Shadow of the Tomb Raider, erhielt zahlreiche ÃÂÃÂBest ofÃÂÃÂ-Nominierungen und Auszeichnungen und ist der krÃÂÃÂ¶nende Abschluss der Originalgeschichte von Lara Croft. All dies macht TOMB RAIDER weiterhin zu einem Markenzeichen fÃÂÃÂ¼r Action-Abenteuer. TOMB RAIDER ÃÂÃÂ weiterfÃÂÃÂ¼hrende Links: Offizielle Webseite, Twitter, Discord, YouTube, Instagram, Facebook 1 NRG Global Study, Mai 2022",https://www.businesswire.com/news/home/20221214006071/de/,businesswire.com,5,seattlebusiness wireamazon game und crystal dynamic gaben heute bekannt das sie eine vereinbarung getroffen haben nach der crystal dynamic einen neuen plattformbergreifenden tomb raidertitel entwickeln wird wobei amazon game sie tatkrftig untersttzt und da spiel zudem weltweit verffentlicht da noch unbenannte neue tomb raiderspiel ist ein erzhlerisches einzelspielerabenteuer da die geschichte von lara croft der tomb raiderserie fortsetzt e enthlt alle elemente die tomb raider zu einer der beliebtesten spielreihen gemacht haben der spieler bernimmt die kontrolle ber die selbstbewusste und multidimensionale heldin lara croft einer umgebung die erkundung und kreative wegfindung erfordert mit kniffligen rtseln die e zu lsen gilt und einer vielzahl von gegnern die besiegt werden mssen crystal dynamic nutzt die leistung und die innovative technologie der unreal engine um da storytelling im bisher grten und umfangreichsten tomb raiderspiel auf die nchste stufe zu heben der titel befindet sich derzeit einer frhen entwicklungsphase und weitere detail werden zu einem spteren zeitpunkt bekannt gegeben tomb raider ist eine der beliebtesten ip der unterhaltungsgeschichte christoph hartmann vp von amazon game amazon game hat e sich zur aufgabe gemacht den spielern spiele hchster qualitt von den besten entwicklern ber alle mglichen plattformen und genre hinweg bereitzustellen und wir fhlen un geehrt mit diesem geschichtstrchtigen entwickler und franchise zusammenzuarbeiten unser team freut sich unglaublich darauf mit dem talentierten und visionren team von crystal dynamic zusammenzuarbeiten um spielern auf der ganzen welt da nchste kapitel der lara croftsaga zu prsentieren crystal dynamic hat nach der bernahme durch embracer die auergewhnliche mglichkeit eine publishingbeziehung fr tomb raider neu zu definieren sagt scot amos head studio bei crystal dynamic mit amazon game haben wir ein team gefunden da unsere kreative vision unsere ambitionen und unsere werte fr ein laracroftuniversum ber da gesamte spektrum der mglichkeiten hinweg teilt sie sind einzigartig positioniert um eine publishing und entwicklungskooperationen neu zu definieren und wir freuen un darauf diesen neuen weg gemeinsam zu beschreiten angefangen mit der entwicklung de bisher grten und besten tomb raiderspiels crystal dynamic hat den letzten drei jahrzehnten dutzende von preisgekrnten titeln entwickelt und verffentlicht darunter weltweit beliebte franchise wie legacy kain und tomb raider da tomb raiderfranchise umfasst mehr al videospiele begeistert mehr al millionen menschen auf der ganzen welt und hat sich seit der verffentlichung de ersten teils im jahr mehr al millionen mal verkauft die jngste survivortrilogie bestehend au tomb raider rise tomb raider und shadow tomb raider wurde mit mehr al best ofauszeichnungen und nominierungen bedacht die vereinbarung mit crystal dynamic stellt eine weitere erweiterung der aaapublishingbemhungen von amazon game dar zu denen auch lost ark von smilegate rpg und da krzlich angekndigte blue protocol von bandai namco online inc gehren der kommende tomb raidertitel wird der erste erzhlerische einzelspielertitel von amazon game sein nachdem die multiplayertitel new world und lost ark bereits erfolgreich waren fr weitere informationen und um auf dem laufenden zu bleiben besuchen sie amazongamescom ber amazon game wir bei amazon game haben den ehrgeiz aufregende neue erlebnisse zu schaffen die die gemeinschaft und um unsere spiele frdern unser team au veteranen der spielebranche arbeitet mit prime gaming twitch amazon retail amazon web service aws und noch weiteren zusammen um ber den tellerrand zu blicken und unseren spielern fesselnde erlebnisse zu bieten amazon game entwickelt mit seinen studio und team seattle orange county san diego und montreal aaamultiplayerspiele die auf originalips basieren darunter new world amazon game verffentlicht zudem erstklassige spiele von drittverlegern allen voran lost ark von smilegate rpg und blue protocol von bandai namco online ber crystal dynamic crystal dynamic hat seinem jhrigen preisgekrnten abenteuer mehr al spiele entwickelt und verffentlicht zu den beliebten franchise de unternehmens gehren legacy kain und tomb raider da sich weltweit mehr al millionen mal verkauft hat die protagonistin von tomb raider die heldin lara croft ist seit mehr al jahren eine kulturelle ikone die mehr al spielen auftrat und praktisch alle bereiche der unterhaltung unauslschlich geprgt hat der hauptsitz von crystal dynamic befindet sich san mateo kalifornien zudem haben sie zwei weitere studio crystal northwest bellevue washington und crystal southwest austin texas die website von crystal dynamic ist zu finden unter ber tomb raider da tomb raidervideospielfranchise da krzlich sein jhriges jubilum feierte hat sich weltweit ber millionen mal verkauft die popularitt de franchise hat zu einer reihe von blockbusterfilmen gefhrt die auf dem originalspiel tomb raider und dem reboot von basieren die protagonistin lara croft ist seit ber zwei jahrzehnten eine globale ikone der gegenwart der jngste teil der weltberhmten franchise shadow tomb raider erhielt zahlreiche best ofnominierungen und auszeichnungen und ist der krnende abschluss der originalgeschichte von lara croft dy macht tomb raider weiterhin zu einem markenzeichen fr actionabenteuer tomb raider weiterfhrende link offizielle webseite twitter discord youtube instagram facebook nrg global study mai,-0.9949,-0.49745,0.1437891304,-0.64123913,Negative Impact
16/12/2022,88.27,89.35,86.73,87.86,87.86,146144100,-0.27,-314.4290963,1.192,0,14.33339876,0.959429757,-0.018638346,4.1,296.797,10705.41016,15018.16992,7332.100098,6452.629883,3167.85791,61337.80859,19443.30078,99.72160004,122.0462053,99.29924787,120.5601558,91.8984993,97.0274359,86.76956269,37.9786895,-2.855545146,-3.111155632,0.2556104857,3.166428702,99.24633942,9133361400,10.7618786,20.95136088,22.62000084,"Amazon failed to record warehouse injuries, U.S. agency says","Amazon.com Inc failed to properly record work-related injuries and illnesses at six warehouses in five states, the U.S. Department of Labor said on Friday as part of an ongoing investigation into the company's safety policies.",https://www.reuters.com/technology/amazon-failed-record-warehouse-injuries-us-agency-says-2022-12-16/,reuters.com,10,amazoncom inc failed properly record workrelated injury illness six warehouse five state u department labor said friday part ongoing investigation company safety policy,-0.7184,-0.7184,0.1691725,-0.8875725,Negative Impact
19/12/2022,87.51,87.63,84.51,84.92,84.92,83531500,-0.27,-314.4290963,1.192,0,14.33339876,0.959429757,-0.018638346,4.1,296.797,10546.03027,14938.03027,7361.299805,6473.290039,3107.120117,61806.19141,19200.80078,99.12880005,121.7426003,98.73535572,120.2055274,91.43749924,97.32018015,85.55481832,35.9760687,-3.103249987,-3.109574503,0.006324515744,3.193571363,98.24503253,9049829900,3.223238942,8.00868506,22.42000008,Why Amazon.com Stock Is Still Falling,A Wall Street analyst warns that things could get even worse for the e-commerce and cloud giant next year.,https://www.fool.com/investing/2022/12/19/why-amazoncom-stock-is-still-falling/,fool.com,7,wall street analyst warns thing could get even worse ecommerce cloud giant next year,-0.5423,-0.37961,0.2447,-0.62431,Negative Impact
20/12/2022,85.33,86.61,84.33,85.19,85.19,74348300,-0.27,-314.4290963,1.192,0,14.33339876,0.959429757,-0.018638346,4.1,296.797,10547.11035,15000.62012,7370.600098,6450.430176,3073.77002,61702.28906,19306.90039,98.55920013,121.4812852,98.2041654,119.8571142,91.0739994,97.55833288,84.58966593,25.20752513,-3.240417257,-3.135743054,-0.104674203,2.998571123,96.87152949,9124178200,6.66667061,6.883929385,21.47999954,Unreliable Contrarianism,"It appears to us at Smead Capital Management that investors are behaving in a way that will damage their capital and cause them to suffer stock market failure. In 2022, as the favorite tech stocks of the last ten years got trounced, individual investors poured $100 billion into mutual funds and ETFs dominated by ownership of the very stocks which have created the most damage to their results.",https://www.gurufocus.com/news/1914004/unreliable-contrarianism,gurufocus.com,5,appears u smead capital management investor behaving way damage capital cause suffer stock market failure favorite tech stock last ten year got trounced individual investor poured billion mutual fund etf dominated ownership stock created damage result,-0.8481,-0.42405,0.2549517391,-0.679001739,Negative Impact
21/12/2022,86.18,87.23,85.21,86.77,86.77,59267200,-0.27,-314.4290963,1.192,0,14.33339876,0.959429757,-0.018638346,4.1,296.797,10709.37012,15219.5498,7497.299805,6580.240234,3068.409912,61067.23828,19571.09961,98.05040009,121.2350628,97.75576662,119.5278891,90.75249939,97.42780481,84.07719397,31.37003149,-3.184917236,-3.14557789,-0.039339346,2.979285104,95.36654617,9183445400,20.46975828,10.11988928,20.06999969,"LONG-TERM AMAZON INVESTOR ALERT: Kaskela Law LLC Announces Stockholder Investigation of Amazon.com, Inc. (AMZN) and Encourages Long-Term Investors to Contact the Firm","PHILADELPHIA , Dec. 21, 2022 /PRNewswire/ -- Kaskela Law LLC announces that it is investigating Amazon.com, Inc. (""Amazon"") (NASDAQ: AMZN) on behalf of the Company's long-term investors. According to a recently filed complaint, certain of Amazon's current and former senior executive officers are alleged to have breached their fiduciary duties by ""knowingly and/or recklessly causing the Company to store the biometric information of its employees, users, and its cloud-based clients' users, including minors, without informing them of these practices and without securing users' written consent, and to fail to develop a written policy available to the public that set a retention schedule and guidelines for users to permanently destroy biometric identifiers when the initial purpose for collection was satisfied"" in direct violation of state privacy laws.",https://www.prnewswire.com/news-releases/long-term-amazon-investor-alert-kaskela-law-llc-announces-stockholder-investigation-of-amazoncom-inc-amzn-and-encourages-long-term-investors-to-contact-the-firm-301707787.html,prnewswire.com,5,philadelphia dec prnewswire kaskela law llc announces investigating amazoncom inc amazon nasdaq amzn behalf company longterm investor according recently filed complaint certain amazon current former senior executive officer alleged breached fiduciary duty knowingly andor recklessly causing company store biometric information employee user cloudbased client user including minor without informing practice without securing user written consent fail develop written policy available public set retention schedule guideline user permanently destroy biometric identifier initial purpose collection satisfied direct violation state privacy law,-0.7321,-0.36605,0.1477626667,-0.513812667,Negative Impact
22/12/2022,85.52,85.68,82.25,83.79,83.79,81431300,-0.27,-314.4290963,1.192,0,14.33339876,0.959429757,-0.018638346,4.1,296.797,10476.12012,15081.53027,7469.299805,6517.970215,3054.429932,60826.21875,19349.69922,97.46820007,120.9576177,97.20808954,119.1722883,90.23549957,97.39358964,83.0774095,29.35303692,-3.342859417,-3.185034195,-0.157825221,3.179284777,94.04216085,9102014100,11.00000654,12.71214514,21.96999931,"Why Alphabet, Amazon, and Microsoft Stocks All Fell Thursday",Key economic data suggests the battle with inflation rages on.,https://www.fool.com/investing/2022/12/22/why-alphabet-amazon-and-microsoft-stocks-all-fell/,fool.com,7,key economic data suggests battle inflation rage,-0.7351,-0.51457,0.06848444444,-0.583054444,Negative Impact
23/12/2022,83.25,85.78,82.93,85.25,85.25,57433700,-0.27,-314.4290963,1.192,0,14.33339876,0.959429757,-0.018638346,4.1,296.797,10497.86035,15188.4502,7473,6504.899902,3045.865967,59845.28906,19506.69922,96.9226001,120.6497802,96.73914485,118.8347531,89.82749939,97.1520098,82.50298898,37.68177328,-3.312040863,-3.210435529,-0.101605334,3.146427699,92.39125833,9159447800,21.42857143,17.63277875,20.87000084,Better Buy for 2023: Disney vs. Amazon,"Disney and Amazon have suffered major declines over the last 12 months, but things could be looking up in 2023.",https://www.fool.com/investing/2022/12/23/better-buy-for-2023-disney-vs-amazon/,fool.com,7,disney amazon suffered major decline last month thing could looking,-0.3612,-0.25284,0.28232,-0.53516,Negative Impact
27/12/2022,84.97,85.35,83.00,83.04,83.04,57284000,-0.27,-314.4290963,1.192,0,14.33339876,0.959429757,-0.018638346,4.1,296.797,10353.23047,15218.25977,7473,6550.660156,3095.570068,60927.42969,19506.69922,96.44540009,120.3373577,96.20192352,118.4785864,89.28199959,96.93161464,81.63238454,38.58957423,-3.426447441,-3.253637911,-0.17280953,3.089999063,90.97148217,9102163800,5.642863682,12.69048055,21.64999962,Michael Farr: These are 2023's top stock picks for what could be a rocky year,Lower lows could be ahead for investors. Here are Michael Farr's picks for the new year.,https://www.cnbc.com/2022/12/27/michael-farr-these-are-2023s-top-stock-picks-for-what-could-be-a-rocky-year.html,cnbc.com,9,lower low could ahead investor michael farrs pick new year,-0.5106,-0.45954,0.1619858333,-0.621525833,Negative Impact
28/12/2022,82.8,83.48,81.69,81.82,81.82,58228600,-0.27,-314.4290963,1.192,0,14.33339876,0.959429757,-0.018638346,4.1,296.797,10213.29004,15037.32031,7497.200195,6510.490234,3087.399902,60910.28125,19284.09961,95.80600006,120.0371927,95.63792651,118.1138243,88.75199966,96.93632754,80.56767179,36.07382464,-3.574356425,-3.317781614,-0.256574811,3.045713697,89.75047466,9043935200,0.8928384287,9.321424513,22.13999939,Better E-Commerce Stock: Amazon vs. Shopify,"After a disappointing 2022, both Amazon and Shopify are looking for a rebound in 2023.",https://www.fool.com/investing/2022/12/28/better-e-commerce-stock-amazon-vs-shopify/,fool.com,7,disappointing amazon shopify looking rebound,-0.3612,-0.25284,0.2233041176,-0.476144118,Negative Impact
29/12/2022,82.87,84.55,82.55,84.18,84.18,54995900,-0.27,-314.4290963,1.192,0,14.33339876,0.959429757,-0.018638346,4.1,296.797,10478.08984,15241.20996,7512.700195,6573.470215,3073.699951,61133.87891,19485.90039,95.16240005,119.7212602,95.18859607,117.7761743,88.13399963,95.6842808,80.58371847,37.30975157,-3.461243968,-3.346474085,-0.114769883,3.027856554,88.46079911,9098931100,17.10163655,7.879112886,21.44000053,3 Best Retail Stocks You'll Regret Not Buying in 2023,"Invest in Chico's FAS (CHS), Shoe Carnival (SCVL) and Texas Roadhouse (TXRH) that not only have made the most of the holiday shopping season but also are poised to gain next year on solid spending trends.",https://www.zacks.com/stock/news/2033359/3-best-retail-stocks-you-ll-regret-not-buying-in-2023,zacks.com,8,invest chico fa chs shoe carnival scvl texas roadhouse txrh made holiday shopping season also poised gain next year solid spending trend,0.8271,0.66168,0.158529,0.503151,Positive Impact
30/12/2022,83.12,84.05,82.47,84.00,84.00,62401200,-0.27,-314.4290963,1.192,0,14.33339876,0.959429757,-0.018638346,4.1,296.797,10466.48047,15184.30957,7451.700195,6473.759766,3089.26001,60840.73828,19384.90039,94.54100006,119.3757402,94.74982759,117.440093,87.55899963,94.47201609,80.64598317,39.04434508,-3.34753772,-3.346686812,-0.000850908,3.027142116,87.37747164,9036529900,15.86537051,11.28661516,21.67000008,Farewell 2022: Another Dismal Week in the Books,The much-needed rally that would have spared Wall Street from a dismal end to 2022 never really came to be.,https://www.schaeffersresearch.com/content/news/2022/12/30/farewell-2022-another-dismal-week-in-the-books,schaeffersresearch.com,5,muchneeded rally would spared wall street dismal end never really came,-0.6124,-0.3062,0.2346944444,-0.540894444,Negative Impact
03/01/2023,85.46,86.96,84.21,85.82,85.82,76706000,2.95,51.45734626,1.192,0,19.59190606,0.6717572755,0.1507120743,4.33,299.17,10386.98047,15154.4502,7554.100098,6623.890137,3116.51001,61294.19922,19443.80078,93.95240005,119.0186452,94.39963826,117.1254652,87.14349976,93.35714928,80.92985023,39.97455358,-3.07511789,-3.292373027,0.2172551375,3.044999259,81.69000244,9113235900,28.36537051,20.44412585,22.89999962,Amazon: Conviction Buy Cheaper Than 2018,"Amazon is bigger and badder than ever before, but the stock trades lower than it did in 2018. The e-commerce segment continues to generate operating losses as the company faces inflationary pressures and works through excess inventories.",https://seekingalpha.com/article/4567503-amazon-conviction-buy-cheaper-than-2018,seekingalpha.com,6,amazon bigger badder ever stock trade lower ecommerce segment continues generate operating loss company face inflationary pressure work excess inventory,-0.6124,-0.36744,0.09941928571,-0.466859286,Negative Impact
04/01/2023,86.55,86.98,83.36,85.14,85.14,68885100,2.95,51.45734626,1.192,0,19.59190606,0.6717572755,0.1507120743,4.33,299.17,10458.75977,15350.2998,7585.200195,6776.430176,3123.52002,60657.44922,19588.80078,93.26880005,118.6380927,94.03651517,116.8072019,86.84999962,92.84536921,80.85463003,33.54231889,-2.88088451,-3.210075324,0.3291908139,2.89428493,81.79540237,9044350800,29.31179212,24.51417771,22.01000023,"Amazon Reportedly Cutting 17,000 Jobs As Major Layoffs Continue Into 2023",Forbes is tracking the biggest layoffs in the U.S. as companies react to fears of a looming recession.,https://www.forbes.com/sites/brianbushard/2023/01/04/amazon-reportedly-cutting-17000-jobs-as-major-layoffs-continue-into-2023/,forbes.com,8,forbes tracking biggest layoff u company react fear looming recession,-0.7579,-0.60632,0.02126580645,-0.627585806,Negative Impact
05/01/2023,85.33,85.42,83.07,83.12,83.12,67930800,2.95,51.45734626,1.192,0,19.59190606,0.6717572755,0.1507120743,4.33,299.17,10305.24023,15225.40039,7633.5,6761.5,3155.219971,60353.26953,19506.80078,92.53480011,118.2462352,93.60841664,116.4720058,86.59349976,92.77280648,80.41419303,31.95392287,-2.857016101,-3.139463479,0.2824473782,2.805713654,82.00278641,8976420000,17.27053763,24.98256675,22.45999908,"2023 has barely started and Amazon, Salesforce, and Vimeo have already announced over 25,000 job cuts",The rash of layoffs come after tech companies hired aggressively during the pandemic. But fears of a recession in 2023 have put the brakes on growth.,https://www.businessinsider.com/new-year-big-tech-sector-layoffs-amazon-salesforce-vimeo-recession-2023-1,businessinsider.com,7,rash layoff come tech company hired aggressively pandemic fear recession put brake growth,-0.8126,-0.56882,0.12081,-0.68963,Negative Impact
06/01/2023,83.03,86.40,81.43,86.08,86.08,83303400,2.95,51.45734626,1.192,0,19.59190606,0.6717572755,0.1507120743,4.33,299.17,10569.29004,15539.74023,7699.5,6860.950195,3157.639893,59900.37109,19814.5,91.84440018,117.8521901,93.31318469,116.1695978,86.47449989,92.59383665,80.35516313,44.90761445,-2.56963191,-3.025497166,0.4558652557,2.867142269,86.98000336,9059723400,58.71215405,35.09816127,21.12999916,"Amazon Plans To Cut 18,000 Jobs, What To Expect?",Amazon's stock (NASDAQ: AMZN) has lost approximately 51% in 2022 as compared to the 25% drop in the S&P500 index over the same period.,https://www.forbes.com/sites/greatspeculations/2023/01/06/amazon-plans-to-cut-18000-jobs-what-to-expect/,forbes.com,8,amazon stock nasdaq amzn lost approximately compared drop sp index period,-0.4019,-0.32152,0.2244069231,-0.545926923,Negative Impact
09/01/2023,87.46,89.48,87.08,87.36,87.36,65266100,2.95,51.45734626,1.192,0,19.59190606,0.6717572755,0.1507120743,4.33,299.17,10635.65039,15514.44043,7724.899902,6907.359863,3176.080078,60747.30859,19857.09961,91.27840012,117.4719501,93.07972649,115.8829352,86.325,92.18633556,80.46366444,48.95659395,-2.213081636,-2.86301406,0.6499324236,2.922857012,81.43000031,9124989500,73.66457214,49.88242127,21.96999931,Amazon: Sell? A Bit Too Late,"Unless a company is in existential threat, selling after a 55% fall from high is generally a little too late. Amazon is not an existential threat. Far from it.",https://seekingalpha.com/article/4568684-amazon-stock-too-late-to-sell,seekingalpha.com,6,unless company existential threat selling fall high generally little late amazon existential threat far,-0.749,-0.4494,0.1352590909,-0.584659091,Negative Impact
10/01/2023,87.57,90.19,87.29,89.87,89.87,67756600,2.95,51.45734626,1.192,0,19.59190606,0.6717572755,0.1507120743,4.33,299.17,10742.62988,15608.16992,7694.5,6869.140137,3169.51001,60115.48047,19898.90039,90.85660019,117.1030526,92.95385497,115.6241,86.36400032,92.31253182,80.41546882,60.51850072,-1.708284737,-2.632068195,0.9237834584,2.890714373,81.43000031,9192746100,96.34703634,76.24125418,20.57999992,"Concerns over a 'white collar recession' grow as Goldman Sachs, Morgan Stanley, Amazon and others cut jobs","With Goldman Sachs beginning layoffs this week, many are worried that the worst is yet to come for professionals across all industries as the Federal Reserve battles inflation.",https://www.foxbusiness.com/media/concerns-over-white-collar-recession-grow-goldman-sachs-morgan-stanley-amazon-others-cut-jobs,foxbusiness.com,5,goldman sachs beginning layoff week many worried worst yet come professional across industry federal reserve battle inflation,-0.836,-0.418,0.2046244444,-0.622624444,Negative Impact
11/01/2023,90.93,95.26,90.93,95.09,95.09,103126200,2.95,51.45734626,1.192,0,19.59190606,0.6717572755,0.1507120743,4.33,299.17,10931.66992,15749.08984,7725,6924.189941,3161.840088,60105.5,20025.09961,90.69020004,116.7546351,93.03762522,115.4197806,86.59099998,93.4836916,79.69830837,67.38061918,-0.876911213,-2.281036799,1.404125586,3.112857274,81.78040039,9295872300,98.77074638,89.59411828,21.09000015,5 Reasons U.S. Markets Will Be Higher in 2023,"Today, we will dive into data that suggests that markets are ready to reward bulls.",https://www.zacks.com/commentary/2037961/5-reasons-u-s-markets-will-be-higher-in-2023,zacks.com,8,today dive data suggests market ready reward bull,0.7351,0.58808,0.2403114286,0.3477685714,Positive Impact
12/01/2023,96.93,97.19,93.50,95.27,95.27,85254800,2.95,51.45734626,1.192,0,19.59190606,0.6717572755,0.1507120743,4.33,299.17,11001.09961,15859.5498,7794,6975.680176,3163.449951,59958.03125,20211.19922,90.54679993,116.3860326,93.1251692,115.2192852,86.72999992,94.21062861,79.24937123,65.69424707,-0.201197901,-1.865069019,1.663871118,3.230714525,82.5891765,9381127100,87.81722374,94.31166882,18.82999992,Amazon employees think the company is lowering the bar with a streamlined interview process,"Some Amazon employees got to skip the retailer's famed ""bar-raiser"" interview ÃÂÃÂ which some insiders worry led to an influx of lower-quality hires.",https://www.businessinsider.com/amazon-employees-worry-about-bar-raising-process-changes-2023-1,businessinsider.com,7,amazon employee got skip retailer famed barraiser interview insider worry led influx lowerquality hire,-0.296,-0.2072,0.2223933333,-0.429593333,Negative Impact
13/01/2023,94.18,98.37,94.12,98.12,98.12,85549400,2.95,51.45734626,1.192,0,19.59190606,0.6717572755,0.1507120743,4.33,299.17,11079.16016,15918.37012,7844.100098,7023.5,3195.310059,60261.17969,20360.09961,90.57339996,116.0300576,93.32104503,115.0491431,87.05699997,95.88136983,78.2326301,76.58627728,0.5578508828,-1.380485039,1.938335922,3.211429051,83.75724257,9466676500,98.52420328,95.03739113,18.35000038,New Investor? Buy These Two Growth Stocks,"These established, fast-growing companies continue to have long-term potential.",https://www.fool.com/investing/2023/01/13/new-investor-buy-these-two-growth-stocks/,fool.com,7,established fastgrowing company continue longterm potential,0,0,0.29445125,-0.29445125,Negative Impact
17/01/2023,98.68,98.89,95.73,96.05,96.05,72755000,2.95,51.45734626,1.192,0,19.59190606,0.6717572755,0.1507120743,4.33,299.17,11095.11035,15883.55957,7851,7077.160156,3224.23999,60655.71875,20457.5,90.65199997,115.6788026,93.42806299,114.860097,87.43700027,97.12612387,77.74787668,69.59362121,0.9810617679,-0.908175677,1.889237445,3.233571734,85.21851859,9393921500,83.73426984,90.02523229,19.36000061,WWE streaming on Netflix or Amazon? One analyst says it's possible,"World Wrestling Entertainment Inc.'s search for a buyer or some other business arrangement has ÃÂÃÂa reasonable probability of successÃÂÃÂ that could draw the interest of streaming giants like Netflix Inc. NFLX, -1.86% and Amazon.com Inc. AMZN, -2.15% , Wells Fargo analysts said Tuesday.",https://www.marketwatch.com/story/wwe-streaming-on-netflix-or-amazon-one-analyst-says-its-possible-11673988552,marketwatch.com,8,world wrestling entertainment inc search buyer business arrangement reasonable probability success could draw interest streaming giant like netflix inc nflx amazoncom inc amzn well fargo analyst said tuesday,0.9201,0.73608,0.1494671429,0.5866128571,Positive Impact
18/01/2023,97.25,99.32,95.38,95.46,95.46,79570400,2.95,51.45734626,1.192,0,19.59190606,0.6717572755,0.1507120743,4.33,299.17,10957.00977,15649.12988,7830.700195,7083.390137,3224.409912,61045.73828,20376.19922,90.77519989,115.3411152,93.50774676,114.6670612,87.8170002,98.15066906,77.48333134,73.93985544,1.254391213,-0.475662299,1.730053512,3.347143446,86.85909628,9314351100,78.42369624,86.89405645,20.34000015,"Big Tech braces for dismal profits, more job cuts","Keen to buttress margins and appease investor concerns at a time of slowing sales growth, big U.S. technology firms are expected to whittle away at their bloated workforce and costs through the next few months, reversing pandemic-era excesses, analysts said.",https://www.reuters.com/technology/big-tech-braces-dismal-profits-more-job-cuts-2023-01-18/,reuters.com,10,keen buttress margin appease investor concern time slowing sale growth big u technology firm expected whittle away bloated workforce cost next month reversing pandemicera excess analyst said,0.7351,0.7351,0.109364,0.625736,Positive Impact
19/01/2023,94.74,95.44,92.86,93.68,93.68,69002700,2.95,51.45734626,1.192,0,19.59190606,0.6717572755,0.1507120743,4.33,299.17,10852.26953,15569.62988,7747.299805,6951.870117,3240.280029,60858.42969,20341.40039,90.82919983,114.9917152,93.5145018,114.4582347,88.25500031,98.81184045,77.69816016,72.37735964,1.312248953,-0.118080049,1.430329002,3.405000414,88.60362276,9245348400,68.47401016,76.87732541,20.52000046,2 Former Pandemic Darlings Poised to Lead Again,"Easy money, stimulus, and a new generation of investors led to the rise and fall of many pandemic darlings. In today's article, Andrew Rocco investigates two that may have turnaround potential.",https://www.zacks.com/commentary/2041425/2-former-pandemic-darlings-poised-to-lead-again,zacks.com,8,easy money stimulus new generation investor led rise fall many pandemic darling today article andrew rocco investigates two may turnaround potential,0.7717,0.61736,0.2445960714,0.3727639286,Positive Impact
20/01/2023,93.86,97.35,93.20,97.25,97.25,67481500,2.95,51.45734626,1.192,0,19.59190606,0.6717572755,0.1507120743,4.33,299.17,11140.42969,15777.5498,7770.600098,6995.990234,3264.810059,60621.76953,20503.19922,90.96359985,114.6362327,93.66099192,114.2870085,88.85800018,100.037081,77.67891933,73.58354408,1.627410988,0.2310181584,1.396392829,3.506428855,90.10391553,9312829900,88.42929142,78.44233261,19.85000038,"Here are the layoff severance packages Google, Microsoft, Amazon and other tech giants have promised",Laid-off employees across the tech sector enter an uncertain job market. Here's what their previous employers have offered to tide them over.,https://www.cnbc.com/2023/01/20/google-amazon-microsoft-meta-twitter-severance-packages-compared.html,cnbc.com,9,laidoff employee across tech sector enter uncertain job market here previous employer offered tide,-0.296,-0.2664,0.12722375,-0.39362375,Negative Impact
23/01/2023,97.56,97.78,95.86,97.52,97.52,76501100,2.95,51.45734626,1.192,0,19.59190606,0.6717572755,0.1507120743,4.33,299.17,11364.41016,15880.08984,7784.700195,7032.02002,3264.810059,60941.67188,20631.59961,91.11439972,114.3035577,93.81232544,114.1201725,89.39550018,101.1697681,77.62123226,74.31654473,1.877325009,0.5602795285,1.317045481,3.521428789,91.39416732,9389331000,89.93849573,82.2805991,19.80999947,"Microsoft, Amazon results to highlight softening cloud business",Slower cloud spending by inflation-hit businesses is expected to stall the sales momentum at Amazon.com Inc and Microsoft Corp and add to the troubles of the sector that laid off thousands this month.,https://www.reuters.com/technology/microsoft-amazon-results-highlight-softening-cloud-business-2023-01-23/,reuters.com,10,slower cloud spending inflationhit business expected stall sale momentum amazoncom inc microsoft corp add trouble sector laid thousand month,-0.5423,-0.5423,0.1341883333,-0.676488333,Negative Impact
24/01/2023,96.93,98.09,96.00,96.32,96.32,66929500,2.95,51.45734626,1.192,0,19.59190606,0.6717572755,0.1507120743,4.33,299.17,11334.26953,15868.21973,7757.399902,7050.47998,3264.810059,60978.75,20629.59961,91.31799973,113.9913777,93.91066561,113.9430564,90.02200012,101.8735877,78.17041255,69.31567849,1.956006323,0.8394248875,1.116581436,3.459285736,92.50378385,9322401500,83.23085465,87.19954727,19.20000076,AWS fÃÂÃÂ¼hrt zweite Infrastrukturregion in Australien ein,"SEATTLE--(BUSINESS WIRE)--Amazon Web Services (AWS), ein Unternehmen von Amazon.com, Inc. (NASDAQ: AMZN), gab heute die EinfÃÂÃÂ¼hrung seiner zweiten AWS-Infrastrukturregion in Australien bekannt: die Region AWS Asien-Pazifik (Melbourne). Ab heute stehen Entwicklern, Startups, Unternehmern und Unternehmen sowie Regierungs-, Bildungs- und Non-Profit-Organisationen noch mehr AuswahlmÃÂÃÂ¶glichkeiten zur VerfÃÂÃÂ¼gung, um ihre Anwendungen von AWS-Rechenzentren in Australien aus zu betreiben und Endnutzer zu bedienen. AWS plant, bis 2037 durch die Region AWS Asien-Pazifik (Melbourne) schÃÂÃÂ¤tzungsweise 4,5 Milliarden US-Dollar (ungefÃÂÃÂ¤hr 6,8 Milliarden australische Dollar) in Australien zu investieren. Weitere Informationen ÃÂÃÂ¼ber AWS Global Infrastructure finden Sie unter aws.amazon.com/about-aws/global-infrastructure. ÃÂÃÂAustralien hat eine starke Tradition technischer Innovationen. Die EinfÃÂÃÂ¼hrung der zweiten AWS-Region in Australien bietet noch mehr StabilitÃÂÃÂ¤t und ermÃÂÃÂ¶glicht es mehr Kunden, cloudbasierte Anwendungen zu entwickeln, die wiederum die wirtschaftliche Entwicklung im ganzen Land fÃÂÃÂ¶rdernÃÂÃÂ, so Prasad Kalyanaraman, Vice President of Infrastructure Services bei AWS. ÃÂÃÂDie Region AWS Asien-Pazifik (Melbourne) ergÃÂÃÂ¤nzt unsere fortlaufende Infrastrukturerweiterung und unsere Investitionen in Australien seit der EinfÃÂÃÂ¼hrung der Region AWS Asien-Pazifik (Sydney) im Jahr 2012. Wir sind stolz, durch die Schaffung lokaler ArbeitsplÃÂÃÂ¤tze, die Entwicklung von Cloud-Kompetenzen und die Schaffung von Wachstumschancen und MÃÂÃÂ¶glichkeiten der Zusammenarbeit mit unseren lokalen Kunden und AWS-Partnern unsere Investitionen zu vertiefen.ÃÂÃÂ ÃÂÃÂWir wissen, wie wichtig Unternehmen in Victoria der Zugang zu einer sicheren Cloud-Infrastruktur ist. Die Bereitstellung von mehr AuswahlmÃÂÃÂ¶glichkeiten wird der Wirtschaft einen Schub geben, die Innovationsleistung unterstÃÂÃÂ¼tzten und bei der Schaffung neuer lokaler ArbeitsplÃÂÃÂ¤tze helfenÃÂÃÂ, so der Minister fÃÂÃÂ¼r Handel und Investment von Victoria, Tim Pallas. Mit der EinfÃÂÃÂ¼hrung der Region AWS Asien-Pazifik (Melbourne) hat AWS 99 Availability Zones in 31 geografischen Regionen und plant die EinfÃÂÃÂ¼hrung von 12 weiteren Availability Zones und vier weiteren AWS-Regionen in Kanada, Israel, Neuseeland und Thailand. Die AWS-Regionen setzen sich aus Availability Zones zusammen, die Infrastruktur an separaten und unterschiedlichen geografischen Standorten bereitstellen. Die Region AWS Asien-Pazifik (Melbourne) besteht aus drei Availability Zones und ergÃÂÃÂ¤nzt die bestehende Region AWS Asien-Pazifik (Sydney), die im November 2012 eingefÃÂÃÂ¼hrt wurde. Die Availability Zones liegen weit genug voneinander entfernt, sodass die GeschÃÂÃÂ¤ftskontinuitÃÂÃÂ¤t der Kunden unterstÃÂÃÂ¼tzt wird, jedoch auch nahe genug beieinander, um niedrige Latenzzeiten fÃÂÃÂ¼r HochverfÃÂÃÂ¼gbarkeitsanwendungen bereitzustellen, die mehrere Availability Zones nutzen. Jede Availability Zone wird separat mit Strom versorgt, gekÃÂÃÂ¼hlt und physisch gesichert und ist ÃÂÃÂ¼ber redundante Netzwerke mit extrem niedriger Latenzzeit verbunden. AWS-Kunden, denen es auf hohe VerfÃÂÃÂ¼gbarkeit ankommt, kÃÂÃÂ¶nnen ihre Anwendungen so entwickeln, dass sie in mehreren Availability Zones laufen, wodurch eine noch grÃÂÃÂ¶ÃÂÃÂere Fehlertoleranz erreicht wird. Die EinfÃÂÃÂ¼hrung der Region AWS Asien-Pazifik (Melbourne) wird es lokalen Kunden mit Anforderungen an die Datenresidenz ermÃÂÃÂ¶glichen, ihre Daten sicher in Australien zu speichern, und ihnen gleichzeitig eine noch geringere Latenzzeit bieten, um die ProduktivitÃÂÃÂ¤t zu steigern, die GeschÃÂÃÂ¤ftsablÃÂÃÂ¤ufe effizienter zu machen und die Echtzeit-Anwendungsleistung zu verbessern. Kunden erhalten darÃÂÃÂ¼ber hinaus Zugang zu fortschrittlichen AWS-Technologien, die sie bei ihrer Innovationsarbeit unterstÃÂÃÂ¼tzen, darunter Rechenleistung, Speicher, Netzwerke, GeschÃÂÃÂ¤ftsanwendungen, Entwicklertools, Datenanalytik, Sicherheit, maschinelles Lernen und kÃÂÃÂ¼nstliche Intelligenz. AWS hat ferner eine Studie ÃÂÃÂ¼ber die wirtschaftlichen Auswirkungen herausgegeben, laut der die projizierten Ausgaben des Unternehmens fÃÂÃÂ¼r den Bau und Betrieb der neuen Region jÃÂÃÂ¤hrlich mehr als 2.500 VollzeitarbeitsplÃÂÃÂ¤tze bei externen Unternehmen schaffen werden, wobei die geplanten Investitionen in Australien bis 2037 auf 4,5 Milliarden US-Dollar (ungefÃÂÃÂ¤hr 6,8 Milliarden australische Dollar) beziffert werden. Die Investitionen umfassen Kapitalausgaben fÃÂÃÂ¼r den Bau von Rechenzentren, operative Kosten im Zusammenhang mit laufenden Versorgungs- und Anlagenkosten sowie die Beschaffung von GÃÂÃÂ¼tern und Dienstleistungen von regionalen Unternehmen. Diese Jobs in Sektoren wie Bau, Anlagenwartung, Technik, Telekommunikation und weitere Jobs in der breiteren Wirtschaft des Landes werden Teil der Lieferkette von AWS in Australien sein. Der Bau und Betrieb der Region AWS Asien-Pazifik (Melbourne) soll bis 2037 geschÃÂÃÂ¤tzte 10,6 Milliarden US-Dollar (ungefÃÂÃÂ¤hr 15,9 Milliarden australische Dollar) zu Australiens Bruttoinlandsprodukt beitragen. Kunden begrÃÂÃÂ¼ÃÂÃÂen die Region AWS Asien-Pazifik (Melbourne) Hunderttausende Organisationen in Australien schlieÃÂÃÂen sich den Millionen aktiver Kunden an, die AWS in mehr als 190 LÃÂÃÂ¤ndern auf der ganzen Welt nutzen. Unternehmen in Australien entscheiden sich fÃÂÃÂ¼r AWS, um Innovationsarbeit zu betreiben und die MarkteinfÃÂÃÂ¼hrungszeit zu verkÃÂÃÂ¼rzen. Zu den Kunden, die AWS nutzen, gehÃÂÃÂ¶ren Airtasker, Animal Logic, ANZ Bank, Atlassian, Canva, Cochlear, Commonwealth Bank of Australia, JimÃÂÃÂs Group, Kmart, Lion, Lovisa, National Australia Bank, Optus, PEXA Group, Pizza Hut, Smiling Mind, Swimming Australia, Target, Telstra, Ticketek, Woodside Energy und Youfoodz. Kunden des ÃÂÃÂ¶ffentlichen Sektors in Australien greifen auf AWS zurÃÂÃÂ¼ck, um Kostenersparnisse zu erzielen und um ihre Dienstleistungen fÃÂÃÂ¼r australische BÃÂÃÂ¼rger und BÃÂÃÂ¼rgerinnen zu verbessern. Zu diesen Kunden gehÃÂÃÂ¶ren FrontierSI, Melbourne Genomics Health Alliance, Royal Melbourne Institute of Technology (RMIT), University of Melbourne und Victorian Land Registry Services. Australische Startups, darunter Brighte, FloodMapp, FrankieOne, Illuvium, Law On Earth, Littlepay, Mr Yum, Omniscient Neurotechnology (o8t), Reejig und Swoop Aero, bauen ihr GeschÃÂÃÂ¤ft mithilfe von AWS auf, um auf nationaler und internationaler Ebene rasch expandieren zu kÃÂÃÂ¶nnen. ANZ Bank stellt mehr als 8,5 Millionen Privat- und Firmenkunden Banking- und finanzielle Produkte und Dienstleistungen zur VerfÃÂÃÂ¼gung und ist in ÃÂÃÂ¼ber 32 MÃÂÃÂ¤rkten tÃÂÃÂ¤tig. ÃÂÃÂWir beabsichtigen, unsere gezielten AWS-Workloads und -Anwendungen vom ersten Tag an in der Region AWS Asien-Pazifik (Melbourne) einzusetzen und mÃÂÃÂ¶chten sie zu unserem langfristigen AWS-Hauptstandort machenÃÂÃÂ, so Gerard Florian, Group Executive of Technology bei ANZ. ÃÂÃÂDie geringere Latenz und hÃÂÃÂ¶here Leistung, die wir von der neuen AWS-Region in Melbourne erwarten, werden uns dabei helfen, unser Kundenerlebnis zu verbessern und unsere Cloud-Annahme zu beschleunigen.ÃÂÃÂ Littlepay ist ein in Melbourne ansÃÂÃÂ¤ssiges Finanztechnologieunternehmen, das mit mehr als 250 Transport- und MobilitÃÂÃÂ¤tsanbietern zusammenarbeitet, um kontaktloses Zahlen in lokalen Bussen, Stadtnetzen und ÃÂÃÂ¶ffentlichen Transportsystemen im Land zu ermÃÂÃÂ¶glichen. ÃÂÃÂWir sind bestrebt, auf der ganzen Welt ein universelles Zahlungserlebnis zu schaffen, was eine erstklassige Infrastruktur erfordert, die mit uns wachsen kannÃÂÃÂ, erklÃÂÃÂ¤rte Amin Shayan, CEO von Littlepay. ÃÂÃÂUm unseren Kunden eine nahtlose Erfahrung zu bieten, erfassen und verarbeiten wir mittels AWS monatlich ÃÂÃÂ¼ber eine Million Transaktionen in Echtzeit und gewinnen dabei Erkenntnisse, die es uns ermÃÂÃÂ¶glichen, unsere Dienstleistungen zu verbessern. Wir freuen uns ÃÂÃÂ¼ber die EinfÃÂÃÂ¼hrung der zweiten AWS-Region in Australien, da sie uns Zugang zu fortschrittlichen Technologien wie maschinelles Lernen und kÃÂÃÂ¼nstliche Intelligenz gibt, bei geringerer Latenz, so dass das Pendeln einfacher und angenehmer wird.ÃÂÃÂ PEXA Group betreibt Australiens fÃÂÃÂ¼hrende digitale Settlement-Plattform fÃÂÃÂ¼r Immobilien, die HauskÃÂÃÂ¤ufern und -verkÃÂÃÂ¤ufern eine effiziente, zuverlÃÂÃÂ¤ssige und sichere Abwicklung bietet. ÃÂÃÂOperative StabilitÃÂÃÂ¤t steht im Zentrum unseres Engagements gegenÃÂÃÂ¼ber Kunden und unserer regulatorischen Normen. PEXA rÃÂÃÂ¤umt ihr deshalb oberste strategische PrioritÃÂÃÂ¤t einÃÂÃÂ, so Eglantine Etiemble, Chief Technology Officer bei PEXA Group. ÃÂÃÂDie EinfÃÂÃÂ¼hrung der zweiten AWS-Region in Australien versetzt uns in die Lage, Anwendungen ÃÂÃÂ¼ber mehrere Regionen hinweg sicher einzusetzen, und so die VerfÃÂÃÂ¼gbarkeit und Leistung unserer PEXA-Plattform zu verbessern und es wÃÂÃÂ¶chentlich mehr als 20.000 Familien zu ermÃÂÃÂ¶glichen, ihre HauskÃÂÃÂ¤ufe frÃÂÃÂ¼her abzuwickeln.ÃÂÃÂ RMIT ist eine ÃÂÃÂ¶ffentliche ForschungsuniversitÃÂÃÂ¤t mit mehr als 96.000 Studenten weltweit. ÃÂÃÂDie EinfÃÂÃÂ¼hrung einer AWS-Region in Melbourne gibt uns zusÃÂÃÂ¤tzliche KapazitÃÂÃÂ¤t, um Wissenschaftlern, Studenten und Akademikern dabei zu helfen, Forschung auf Weltklasseniveau und im Interesse der Gesellschaft zu betreiben,ÃÂÃÂ sagte Professor Calum Drummond, stellvertretender Vice Chancellor Forschung und Innovation und Vice President bei RMIT. ÃÂÃÂVor Kurzem haben wir AWS Cloud Supercomputing bei RMIT eingefÃÂÃÂ¼hrt, bekannt unter der Bezeichnung RACE. Wissenschaftler bei RMIT nutzen RACE, um Batterietechnologien, Photonik und die raumbezogene Wissenschaft voranzubringen. Die geringere Latenz und der hohe Durchsatz der AWS-Region in Melbourne, kombiniert mit unserem privaten Glasfasernetz mit hoher Bandbreite, werden es Wissenschaftlern und Studenten ermÃÂÃÂ¶glichen, Innovationsarbeit jenseits der Grenzen traditioneller Vor-Ort-Rechenzentren zu betreiben.ÃÂÃÂ Auch in Australien ansÃÂÃÂ¤ssige AWS-Partner begrÃÂÃÂ¼ÃÂÃÂen die Region AWS Asien-Pazifik (Melbourne) Das AWS Partner Network (APN) umfasst Zehntausende von unabhÃÂÃÂ¤ngigen Softwareanbietern (Independent Software Vendors, ISVs) und Systemintegratoren (Systems Integrators, SIs) auf der ganzen Welt. AWS-Partner entwickeln innovative LÃÂÃÂ¶sungen und Services auf AWS und das APN hilft ihnen dabei, indem es Kunden geschÃÂÃÂ¤ftliche, technische, Marketing- und MarkteinfÃÂÃÂ¼hrungsunterstÃÂÃÂ¼tzung bietet. AWS ISVs, SIs und Beratungspartner unterstÃÂÃÂ¼tzen Unternehmen und Kunden des ÃÂÃÂ¶ffentlichen Sektors bei der Migration zu AWS, bei der Bereitstellung unternehmenskritischer Anwendungen sowie einer breiten Palette von ÃÂÃÂberwachungs-, Automatisierungs- und Verwaltungsservices fÃÂÃÂ¼r die Cloud-Umgebungen der Kunden. Einige Beispiele fÃÂÃÂ¼r in Australien ansÃÂÃÂ¤ssige AWS-Partner sind Cevo, CMD Solutions, DiUS, IntelligenceBank, Local Measure, NCS, Stax, Unleash live, Urban.io und Versent. Die vollstÃÂÃÂ¤ndige Liste der AWS-Partner finden Sie unter aws.amazon.com/partners. Cevo ist ein AWS Advanced Consulting Partner, der australischen Unternehmen, darunter David Jones, Insignia Financial, MYOB und JimÃÂÃÂs Group, Cloud-Services wie Migration, Datenanalysen und Managed Services bereitstellt. ÃÂÃÂDie Zusammenarbeit mit AWS hat es uns ermÃÂÃÂ¶glicht, unser Team in den letzten 12 Monaten um mehr als 60 Berater zu erweitern, um die gestiegene Nachfrage der Kunden nach dem Einsatz stark regulierter Cloud-Umgebungen zu befriedigenÃÂÃÂ, so James Lewis, CEO bei Cevo. ÃÂÃÂIm Zuge der wachsenden Akzeptanz der Cloud beobachten wir, wie immer mehr Kunden, insbesondere im Finanz-, Regierungs- und Einzelhandelssektor, zur Cloud ÃÂÃÂ¼bergehen, um auf fortschrittliche Modernisierungs- und Analysefunktionen zurÃÂÃÂ¼ckzugreifen und sich neue kundenorientierte Dienstleistungen vorzustellen, diese zu entwickeln und zu schaffen. Mit der Region AWS Asien-Pazifik (Melbourne) kÃÂÃÂ¶nnen wir Kunden das Experimentieren im groÃÂÃÂen MaÃÂÃÂstab ermÃÂÃÂ¶glichen und ihnen gleichzeitig versichern, dass ihre Daten in Australien sicher gespeichert sind.ÃÂÃÂ Engagement fÃÂÃÂ¼r Nachhaltigkeit Amazon hat sich im Rahmen von The Climate Pledge dazu verpflichtet, im gesamten Unternehmen bis 2040 eine Netto-Null-Emission zu erreichen und ist auf dem Weg, seinen Betrieb bis 2025 zu 100 % mit erneuerbarer Energie zu versorgen, fÃÂÃÂ¼nf Jahre vor dem ursprÃÂÃÂ¼nglichen Ziel von 2030. Amazon ist der weltweit grÃÂÃÂ¶ÃÂÃÂte gewerbliche Abnehmer von erneuerbaren Energien und hat Ende 2021 einen Anteil von 85 % erneuerbarer Energien in seinem gesamten Unternehmen erreicht. Ferner wird AWS bis 2030 eine positive Wasserbilanz erzielen, das heiÃÂÃÂt mehr Wasser an Gemeinden zurÃÂÃÂ¼ckgeben als es in seinem direkten GeschÃÂÃÂ¤ftsbetrieb verbraucht. Amazon unterhÃÂÃÂ¤lt in Australien drei Projekte fÃÂÃÂ¼r erneuerbare Energien, darunter ein Windpark in Hawkesdale, Victoria, und zwei Solarparks in New South Wales, in Gunnedah und Suntop. Es wird erwartet, dass diese drei Investments in erneuerbare Energien, wenn sie einmal in Betrieb sind, jÃÂÃÂ¤hrlich 717.000 Megawatt-Stunden an erneuerbarer Energie erzeugen, was dem jÃÂÃÂ¤hrlichen Stromverbrauch von nahezu 115.000 australischen Haushalten entspricht. Amazon verfÃÂÃÂ¼gt derzeit ÃÂÃÂ¼ber 57 Projekte fÃÂÃÂ¼r erneuerbare Energie in der Asien-Pazifik-Region. ÃÂÃÂber Amazon Web Services Amazon Web Services bietet seit ÃÂÃÂ¼ber 15 Jahren das umfassendste und am weitesten verbreitete Cloud-Angebot der Welt. AWS hat seine Services kontinuierlich erweitert, um praktisch jede Cloud-Arbeitslast zu unterstÃÂÃÂ¼tzen. Heute verfÃÂÃÂ¼gt AWS ÃÂÃÂ¼ber mehr als 200 voll funktionsfÃÂÃÂ¤hige Services fÃÂÃÂ¼r Rechenleistung, Speicher, Datenbanken, Netzwerke, Analytik, maschinelles Lernen und kÃÂÃÂ¼nstliche Intelligenz (KI), Internet der Dinge (IoT), Mobiles, Sicherheit, Hybrid, Virtual und Augmented Reality (VR und AR), Medien sowie Anwendungsentwicklung, -bereitstellung und -verwaltung aus 99 Availability Zones in 31 geografischen Regionen. Es sind 12 weitere Availability Zones und vier weitere AWS-Regionen in Kanada, Israel, Neuseeland und Thailand geplant. Millionen von Kunden, darunter die am schnellsten wachsenden Startups, die grÃÂÃÂ¶ÃÂÃÂten Konzerne und fÃÂÃÂ¼hrende RegierungsbehÃÂÃÂ¶rden, vertrauen bei der Bereitstellung ihrer Infrastruktur auf AWS, um agiler zu werden und Kosten zu senken. Weitere Informationen ÃÂÃÂ¼ber AWS finden Sie unter aws.amazon.com. ÃÂÃÂber Amazon Amazon verfolgt vier Prinzipien: Kundenbesessenheit statt Wettbewerbsorientierung, Leidenschaft fÃÂÃÂ¼r Erfindungen, Engagement fÃÂÃÂ¼r operative Exzellenz und langfristiges Denken. Amazon hat es sich zum Ziel gesetzt, das kundenorientierteste Unternehmen der Welt, der beste Arbeitgeber der Welt und der sicherste Arbeitsplatz der Welt zu sein. Kundenrezensionen, 1-Click-Shopping, personalisierte Empfehlungen, Prime, Fulfillment by Amazon, AWS, Kindle Direct Publishing, Kindle, Career Choice, Fire-Tablets, Fire TV, Amazon Echo, Alexa, Just Walk Out-Technologie, Amazon Studios und The Climate Pledge sind nur einige der innovativen Entwicklungen von Amazon. Weitere Informationen finden Sie unter amazon.com/about and folgen Sie @AmazonNews. Die Ausgangssprache, in der der Originaltext verÃÂÃÂ¶ffentlicht wird, ist die offizielle und autorisierte Version. ÃÂÃÂbersetzungen werden zur besseren VerstÃÂÃÂ¤ndigung mitgeliefert. Nur die Sprachversion, die im Original verÃÂÃÂ¶ffentlicht wurde, ist rechtsgÃÂÃÂ¼ltig. Gleichen Sie deshalb ÃÂÃÂbersetzungen mit der originalen Sprachversion der VerÃÂÃÂ¶ffentlichung ab.",https://www.businesswire.com/news/home/20230123005701/de/,businesswire.com,5,seattlebusiness wireamazon web service aws ein unternehmen von amazoncom inc nasdaq amzn gab heute die einfhrung seiner zweiten awsinfrastrukturregion australien bekannt die region aws asienpazifik melbourne ab heute stehen entwicklern startup unternehmern und unternehmen sowie regierungs bildungs und nonprofitorganisationen noch mehr auswahlmglichkeiten zur verfgung um ihre anwendungen von awsrechenzentren australien au zu betreiben und endnutzer zu bedienen aws plant bi durch die region aws asienpazifik melbourne schtzungsweise milliarden usdollar ungefhr milliarden australische dollar australien zu investieren weitere informationen ber aws global infrastructure finden sie unter awsamazoncomaboutawsglobalinfrastructure australien hat eine starke tradition technischer innovationen die einfhrung der zweiten awsregion australien bietet noch mehr stabilitt und ermglicht e mehr kunden cloudbasierte anwendungen zu entwickeln die wiederum die wirtschaftliche entwicklung im ganzen land frdern prasad kalyanaraman vice president infrastructure service bei aws die region aws asienpazifik melbourne ergnzt unsere fortlaufende infrastrukturerweiterung und unsere investitionen australien seit der einfhrung der region aws asienpazifik sydney im jahr wir sind stolz durch die schaffung lokaler arbeitspltze die entwicklung von cloudkompetenzen und die schaffung von wachstumschancen und mglichkeiten der zusammenarbeit mit unseren lokalen kunden und awspartnern unsere investitionen zu vertiefen wir wissen wie wichtig unternehmen victoria der zugang zu einer sicheren cloudinfrastruktur ist die bereitstellung von mehr auswahlmglichkeiten wird der wirtschaft einen schub geben die innovationsleistung untersttzten und bei der schaffung neuer lokaler arbeitspltze helfen der minister fr handel und investment von victoria tim pallas mit der einfhrung der region aws asienpazifik melbourne hat aws availability zone geografischen regionen und plant die einfhrung von weiteren availability zone und vier weiteren awsregionen kanada israel neuseeland und thailand die awsregionen setzen sich au availability zone zusammen die infrastruktur separaten und unterschiedlichen geografischen standorten bereitstellen die region aws asienpazifik melbourne besteht au drei availability zone und ergnzt die bestehende region aws asienpazifik sydney die im november eingefhrt wurde die availability zone liegen weit genug voneinander entfernt sodass die geschftskontinuitt der kunden untersttzt wird jedoch auch nahe genug beieinander um niedrige latenzzeiten fr hochverfgbarkeitsanwendungen bereitzustellen die mehrere availability zone nutzen jede availability zone wird separat mit strom versorgt gekhlt und physisch gesichert und ist ber redundante netzwerke mit extrem niedriger latenzzeit verbunden awskunden denen e auf hohe verfgbarkeit ankommt knnen ihre anwendungen entwickeln das sie mehreren availability zone laufen wodurch eine noch grere fehlertoleranz erreicht wird die einfhrung der region aws asienpazifik melbourne wird e lokalen kunden mit anforderungen die datenresidenz ermglichen ihre daten sicher australien zu speichern und ihnen gleichzeitig eine noch geringere latenzzeit bieten um die produktivitt zu steigern die geschftsablufe effizienter zu machen und die echtzeitanwendungsleistung zu verbessern kunden erhalten darber hinaus zugang zu fortschrittlichen awstechnologien die sie bei ihrer innovationsarbeit untersttzen darunter rechenleistung speicher netzwerke geschftsanwendungen entwicklertools datenanalytik sicherheit maschinelles lernen und knstliche intelligenz aws hat ferner eine studie ber die wirtschaftlichen auswirkungen herausgegeben laut der die projizierten ausgaben de unternehmens fr den bau und betrieb der neuen region jhrlich mehr al vollzeitarbeitspltze bei externen unternehmen schaffen werden wobei die geplanten investitionen australien bi auf milliarden usdollar ungefhr milliarden australische dollar beziffert werden die investitionen umfassen kapitalausgaben fr den bau von rechenzentren operative kosten im zusammenhang mit laufenden versorgungs und anlagenkosten sowie die beschaffung von gtern und dienstleistungen von regionalen unternehmen diese job sektoren wie bau anlagenwartung technik telekommunikation und weitere job der breiteren wirtschaft de landes werden teil der lieferkette von aws australien sein der bau und betrieb der region aws asienpazifik melbourne soll bi geschtzte milliarden usdollar ungefhr milliarden australische dollar zu australiens bruttoinlandsprodukt beitragen kunden begren die region aws asienpazifik melbourne hunderttausende organisationen australien schlieen sich den millionen aktiver kunden die aws mehr al lndern auf der ganzen welt nutzen unternehmen australien entscheiden sich fr aws um innovationsarbeit zu betreiben und die markteinfhrungszeit zu verkrzen zu den kunden die aws nutzen gehren airtasker animal logic anz bank atlassian canva cochlear commonwealth bank australia jims group kmart lion lovisa national australia bank optus pexa group pizza hut smiling mind swimming australia target telstra ticketek woodside energy und youfoodz kunden de ffentlichen sektors australien greifen auf aws zurck um kostenersparnisse zu erzielen und um ihre dienstleistungen fr australische brger und brgerinnen zu verbessern zu diesen kunden gehren frontiersi melbourne genomics health alliance royal melbourne institute technology rmit university melbourne und victorian land registry service australische startup darunter brighte floodmapp frankieone illuvium law earth littlepay mr yum omniscient neurotechnology ot reejig und swoop aero bauen ihr geschft mithilfe von aws auf um auf nationaler und internationaler ebene rasch expandieren zu knnen anz bank stellt mehr al millionen privat und firmenkunden banking und finanzielle produkte und dienstleistungen zur verfgung und ist ber mrkten ttig wir beabsichtigen unsere gezielten awsworkloads und anwendungen vom ersten tag der region aws asienpazifik melbourne einzusetzen und mchten sie zu unserem langfristigen awshauptstandort machen gerard florian group executive technology bei anz die geringere latenz und hhere leistung die wir von der neuen awsregion melbourne erwarten werden un dabei helfen unser kundenerlebnis zu verbessern und unsere cloudannahme zu beschleunigen littlepay ist ein melbourne ansssiges finanztechnologieunternehmen da mit mehr al transport und mobilittsanbietern zusammenarbeitet um kontaktloses zahlen lokalen bussen stadtnetzen und ffentlichen transportsystemen im land zu ermglichen wir sind bestrebt auf der ganzen welt ein universelles zahlungserlebnis zu schaffen eine erstklassige infrastruktur erfordert die mit un wachsen kann erklrte amin shayan ceo von littlepay um unseren kunden eine nahtlose erfahrung zu bieten erfassen und verarbeiten wir mittels aws monatlich ber eine million transaktionen echtzeit und gewinnen dabei erkenntnisse die e un ermglichen unsere dienstleistungen zu verbessern wir freuen un ber die einfhrung der zweiten awsregion australien da sie un zugang zu fortschrittlichen technologien wie maschinelles lernen und knstliche intelligenz gibt bei geringerer latenz das da pendeln einfacher und angenehmer wird pexa group betreibt australiens fhrende digitale settlementplattform fr immobilien die hauskufern und verkufern eine effiziente zuverlssige und sichere abwicklung bietet operative stabilitt steht im zentrum unseres engagement gegenber kunden und unserer regulatorischen norman pexa rumt ihr deshalb oberste strategische prioritt ein eglantine etiemble chief technology officer bei pexa group die einfhrung der zweiten awsregion australien versetzt un die lage anwendungen ber mehrere regionen hinweg sicher einzusetzen und die verfgbarkeit und leistung unserer pexaplattform zu verbessern und e wchentlich mehr al familien zu ermglichen ihre hauskufe frher abzuwickeln rmit ist eine ffentliche forschungsuniversitt mit mehr al studenten weltweit die einfhrung einer awsregion melbourne gibt un zustzliche kapazitt um wissenschaftlern studenten und akademikern dabei zu helfen forschung auf weltklasseniveau und im interesse der gesellschaft zu betreiben sagte professor calum drummond stellvertretender vice chancellor forschung und innovation und vice president bei rmit vor kurzem haben wir aws cloud supercomputing bei rmit eingefhrt bekannt unter der bezeichnung race wissenschaftler bei rmit nutzen race um batterietechnologien photonik und die raumbezogene wissenschaft voranzubringen die geringere latenz und der hohe durchsatz der awsregion melbourne kombiniert mit unserem privaten glasfasernetz mit hoher bandbreite werden e wissenschaftlern und studenten ermglichen innovationsarbeit jenseits der grenzen traditioneller vorortrechenzentren zu betreiben auch australien ansssige awspartner begren die region aws asienpazifik melbourne da aws partner network apn umfasst zehntausende von unabhngigen softwareanbietern independent software vendor isvs und systemintegratoren system integrator si auf der ganzen welt awspartner entwickeln innovative lsungen und service auf aws und da apn hilft ihnen dabei indem e kunden geschftliche technische marketing und markteinfhrungsuntersttzung bietet aws isvs si und beratungspartner untersttzen unternehmen und kunden de ffentlichen sektors bei der migration zu aws bei der bereitstellung unternehmenskritischer anwendungen sowie einer breiten palette von berwachungs automatisierungs und verwaltungsservices fr die cloudumgebungen der kunden einige beispiele fr australien ansssige awspartner sind cevo cmd solution dius intelligencebank local measure nc stax unleash live urbanio und versent die vollstndige liste der awspartner finden sie unter awsamazoncompartners cevo ist ein aws advanced consulting partner der australischen unternehmen darunter david jones insignia financial myob und jims group cloudservices wie migration datenanalysen und managed service bereitstellt die zusammenarbeit mit aws hat e un ermglicht unser team den letzten monaten um mehr al berater zu erweitern um die gestiegene nachfrage der kunden nach dem einsatz stark regulierter cloudumgebungen zu befriedigen james lewis ceo bei cevo im zuge der wachsenden akzeptanz der cloud beobachten wir wie immer mehr kunden insbesondere im finanz regierungs und einzelhandelssektor zur cloud bergehen um auf fortschrittliche modernisierungs und analysefunktionen zurckzugreifen und sich neue kundenorientierte dienstleistungen vorzustellen diese zu entwickeln und zu schaffen mit der region aws asienpazifik melbourne knnen wir kunden da experimentieren im groen mastab ermglichen und ihnen gleichzeitig versichern das ihre daten australien sicher gespeichert sind engagement fr nachhaltigkeit amazon hat sich im rahmen von climate pledge dazu verpflichtet im gesamten unternehmen bi eine nettonullemission zu erreichen und ist auf dem weg seinen betrieb bi zu mit erneuerbarer energie zu versorgen fnf jahre vor dem ursprnglichen ziel von amazon ist der weltweit grte gewerbliche abnehmer von erneuerbaren energien und hat ende einen anteil von erneuerbarer energien seinem gesamten unternehmen erreicht ferner wird aws bi eine positive wasserbilanz erzielen da heit mehr wasser gemeinden zurckgeben al e seinem direkten geschftsbetrieb verbraucht amazon unterhlt australien drei projekte fr erneuerbare energien darunter ein windpark hawkesdale victoria und zwei solarparks new south wale gunnedah und suntop e wird erwartet das diese drei investment erneuerbare energien wenn sie einmal betrieb sind jhrlich megawattstunden erneuerbarer energie erzeugen dem jhrlichen stromverbrauch von nahezu australischen haushalten entspricht amazon verfgt derzeit ber projekte fr erneuerbare energie der asienpazifikregion ber amazon web service amazon web service bietet seit ber jahren da umfassendste und weitesten verbreitete cloudangebot der welt aws hat seine service kontinuierlich erweitert um praktisch jede cloudarbeitslast zu untersttzen heute verfgt aws ber mehr al voll funktionsfhige service fr rechenleistung speicher datenbanken netzwerke analytik maschinelles lernen und knstliche intelligenz ki internet der dinge iot mobile sicherheit hybrid virtual und augmented reality vr und ar medien sowie anwendungsentwicklung bereitstellung und verwaltung au availability zone geografischen regionen e sind weitere availability zone und vier weitere awsregionen kanada israel neuseeland und thailand geplant millionen von kunden darunter die schnellsten wachsenden startup die grten konzerne und fhrende regierungsbehrden vertrauen bei der bereitstellung ihrer infrastruktur auf aws um agiler zu werden und kosten zu senken weitere informationen ber aws finden sie unter awsamazoncom ber amazon amazon verfolgt vier prinzipien kundenbesessenheit statt wettbewerbsorientierung leidenschaft fr erfindungen engagement fr operative exzellenz und langfristiges denken amazon hat e sich zum ziel gesetzt da kundenorientierteste unternehmen der welt der beste arbeitgeber der welt und der sicherste arbeitsplatz der welt zu sein kundenrezensionen clickshopping personalisierte empfehlungen prime fulfillment amazon aws kindle direct publishing kindle career choice firetablets fire tv amazon echo alexa walk outtechnologie amazon studio und climate pledge sind nur einige der innovativen entwicklungen von amazon weitere informationen finden sie unter amazoncomabout folgen sie amazonnews die ausgangssprache der der originaltext verffentlicht wird ist die offizielle und autorisierte version bersetzungen werden zur besseren verstndigung mitgeliefert nur die sprachversion die im original verffentlicht wurde ist rechtsgltig gleichen sie deshalb bersetzungen mit der originalen sprachversion der verffentlichung ab,-0.9996,-0.4998,0.1284051613,-0.628205161,Negative Impact
25/01/2023,92.56,97.24,91.52,97.18,97.18,94261600,2.95,51.45734626,1.192,0,19.59190606,0.6717572755,0.1507120743,4.33,299.17,11313.36035,15889.26953,7744.899902,7043.879883,3264.810059,60205.05859,20599.59961,91.32899979,113.6883552,94.03887481,113.7762598,90.61850014,102.6582094,78.57879089,72.00293129,2.063964595,1.084332829,0.9796317658,3.609285627,99.31999969,9416663100,88.03801307,87.06912115,19.07999992,"Who is Gautam Adani, Hindenburg Research's Latest Target?","Forwarding its reputation as the ÃÂÃÂGrim ReaperÃÂÃÂ of enterprises of dubious reputation, notorious short-seller Hindenburg Research blasted Indian conglomerate Adani Group for having ÃÂÃÂ",https://investorplace.com/2023/01/who-is-gautam-adani-hindenburg-researchs-latest-target/,investorplace.com,6,forwarding reputation grim reaper enterprise dubious reputation notorious shortseller hindenburg research blasted indian conglomerate adani group,-0.8442,-0.50652,-0.01016875,-0.49635125,Negative Impact
26/01/2023,98.24,99.49,96.92,99.22,99.22,68523600,2.95,51.45734626,1.192,0,19.59190606,0.6717572755,0.1507120743,4.33,299.17,11512.41016,15985.87012,7761.100098,7095.990234,3264.810059,60205.05859,20700.5,91.29759979,113.4121527,94.24205624,113.6314214,91.42750015,103.4974445,79.3575558,79.40102281,2.287761438,1.325018551,0.962742887,3.625,91.51999664,9485186700,98.50500177,89.92462316,18.72999954,"Got $1,000? Here Are 3 Remarkable Stocks to Buy","These stocks suffered last year, but they're ripe for a rebound.",https://www.fool.com/investing/2023/01/26/got-1000-here-are-3-remarkable-stocks-to-buy/,fool.com,7,stock suffered last year theyre ripe rebound,-0.4939,-0.34573,0.15489625,-0.50062625,Negative Impact
27/01/2023,99.53,103.49,99.53,102.24,102.24,87775600,2.95,51.45734626,1.192,0,19.59190606,0.6717572755,0.1507120743,4.33,299.17,11621.70996,15962.58008,7765.200195,7097.209961,3264.810059,59330.89844,20714.5,91.37259979,113.1677428,94.55570101,113.5180739,92.44850006,104.5511672,80.34583294,79.44606248,2.677940902,1.595603021,1.082337881,3.574999673,91.51999664,9572962300,92.38269164,92.97523549,18.51000023,Amazon to start charging delivery fees on Fresh grocery orders under $150,"Amazon said it is adding fees to some orders so that it can keep prices low, according to a notice sent to customers.",https://www.cnbc.com/2023/01/27/amazon-to-charge-delivery-fees-on-fresh-grocery-orders-under-150.html,cnbc.com,9,amazon said adding fee order keep price low according notice sent customer,-0.1027,-0.09243,0.2134975,-0.3059275,Negative Impact
30/01/2023,101.09,101.74,99.01,100.55,100.55,70691900,2.95,51.45734626,1.192,0,19.59190606,0.6717572755,0.1507120743,4.33,299.17,11393.80957,15818.90039,7784.899902,7082.009766,3269.320068,59500.41016,20572.09961,91.4047998,112.9165553,94.79077168,113.3890384,93.2670002,105.2285309,81.30546947,73.68044305,2.818304818,1.84014338,0.9781614376,3.562856402,91.99879669,9502270400,81.85188046,90.91319129,19.94000053,"Big Week Ahead for Q4 Earnings, Econ Data",Following another solid week of gains -- which is sizing up to be one of the strongest January trading months in years -- pre-market futures are selling off some.,https://www.zacks.com/stock/news/2046364/big-week-ahead-for-q4-earnings-econ-data,zacks.com,8,following another solid week gain sizing one strongest january trading month year premarket future selling,0.7845,0.6276,0.2764666667,0.3511333333,Positive Impact
31/01/2023,101.16,103.35,101.14,103.13,103.13,66527300,2.95,51.45734626,1.192,0,19.59190606,0.6717572755,0.1507120743,4.33,299.17,11584.5498,16036.38965,7771.700195,7082.419922,3255.669922,59549.89844,20767.40039,91.52499969,112.6545002,95.11780013,113.2869584,94.22350006,106.1241866,82.32281356,73.74642304,3.101970616,2.092508828,1.009461789,3.555713109,92.45844474,9568797700,97.13375255,90.45610821,19.39999962,"Russian court fines Amazon's Twitch $57,000 over Ukraine content","A Russian court on Tuesday fined streaming service Twitch 4 million roubles ($57,000) for failing to remove what it said were ""fakes"" about Russia's military campaign in Ukraine, the Interfax news agency reported.",https://www.reuters.com/technology/russian-court-fines-amazons-twitch-57000-over-ukraine-content-2023-01-31/,reuters.com,10,russian court tuesday fined streaming service twitch million rouble failing remove said fake russia military campaign ukraine interfax news agency reported,-0.7506,-0.7506,0.1451392308,-0.895739231,Negative Impact
01/02/2023,102.53,106.24,101.24,105.15,105.15,80450100,2.95,51.45734626,1.192,0,19.59190606,0.6717572755,0.1507120743,4.57,300.84,11816.32031,16121.25,7761.100098,7077.109863,3284.919922,59708.07813,20751.09961,91.73099976,112.4217178,95.51121979,113.2059936,95.19000015,107.3539008,83.02609948,70.34791221,3.450005749,2.364008212,1.085997537,3.527856009,92.89970686,9649247800,92.59513419,90.5269224,17.87000084,Polish competition watchdog accuses Amazon EU of misleading consumers,"Poland's competition watchdog has accused e-commerce firm Amazon's European unit of misleading sales and delivery practices, the Office of Competition and Consumer Protection (UOKiK) said on Wednesday.",https://www.reuters.com/technology/polish-competition-watchdog-accuses-amazon-eu-misleading-consumers-2023-02-01/,reuters.com,10,poland competition watchdog accused ecommerce firm amazon european unit misleading sale delivery practice office competition consumer protection uokik said wednesday,-0.4939,-0.4939,0.09405333333,-0.587953333,Negative Impact
02/02/2023,110.25,114.00,108.88,112.91,112.91,158154200,2.95,51.45734626,1.192,0,19.59190606,0.6717572755,0.1507120743,4.57,300.84,12200.82031,16122.58008,7820.200195,7166.27002,3285.669922,59932.23828,20740.40039,92.10639984,112.2223428,96.19352504,113.2030484,96.57850037,110.1683544,82.98864633,77.30651628,4.302398052,2.75168618,1.550711872,3.896427155,93.70012432,9807402000,95.15126257,94.96004977,18.72999954,"Amazon still grasping for success with supermarkets, CEO says","Amazon.com Inc , the online retailer long feared to disrupt the grocery sector, believes it has fallen short.",https://www.reuters.com/business/retail-consumer/amazon-still-grasping-success-with-supermarkets-ceo-says-2023-02-03/,reuters.com,10,amazoncom inc online retailer long feared disrupt grocery sector belief fallen short,-0.6908,-0.6908,0.1500202632,-0.840820263,Negative Impact
03/02/2023,105.26,108.78,102.52,103.39,103.39,144374800,2.95,51.45734626,1.192,0,19.59190606,0.6717572755,0.1507120743,4.57,300.84,12006.9502,15999.40039,7901.799805,7233.939941,3263.409912,60841.87891,20758.30078,92.32499985,111.9487153,96.47573972,113.1054062,97.5920002,109.9205836,85.26341678,56.7616083,4.161766062,3.033702157,1.128063906,4.334999084,95.32411438,9663027200,52.80249544,80.18296406,18.32999992,Amazon cut jobs in 2022 for the first time since the dot-com bust 20 years ago,"Amazon.com Inc. had a bad year in 2022, with the e-commerce and cloud giant recording its biggest loss ever. Its employees had a bad year, too: For the first time in 20 years, the company shrank its workforce.",https://www.marketwatch.com/story/amazon-cut-jobs-in-2022-for-the-first-time-since-the-dot-com-bust-20-years-ago-11675436384,marketwatch.com,8,amazoncom inc bad year ecommerce cloud giant recording biggest loss ever employee bad year first time year company shrank workforce,-0.8519,-0.68152,0.09659527778,-0.778115278,Negative Impact
06/02/2023,102.93,103.95,100.65,102.18,102.18,81945200,2.95,51.45734626,1.192,0,19.59190606,0.6717572755,0.1507120743,4.57,300.84,11887.4502,15895.36035,7836.700195,7137.100098,3238.699951,60506.89844,20628.90039,92.50459991,111.6896253,96.69943622,112.9966957,98.39700012,109.6129145,87.18108573,58.04250641,3.907632627,3.208488251,0.6991443764,4.344999041,96.81818523,9581082000,47.41993803,65.12456535,19.43000031,"Amazon scales back cargo flying as demand cools, contractor says",Air Transport Services Group said Amazon will be flying less in response to slowing consumer demand and a worsening economic outlook.,https://www.cnbc.com/2023/02/06/amazon-dials-back-air-cargo-service-as-demand-cools-contractor-says-.html,cnbc.com,9,air transport service group said amazon flying less response slowing consumer demand worsening economic outlook,-0.4215,-0.37935,0.2589761538,-0.638326154,Negative Impact
07/02/2023,101.17,102.41,98.08,102.11,102.11,119501300,2.95,51.45734626,1.192,0,19.59190606,0.6717572755,0.1507120743,4.57,300.84,12113.79004,16021.62012,7864.700195,7132.350098,3248.090088,60286.03906,20725,92.66419998,111.4586953,96.91161521,112.8883703,99.13450012,109.1726105,89.09638976,58.8454423,3.658409787,3.298472558,0.3599372294,4.37285614,114,9461580700,47.10855154,49.11032834,18.65999985,Amazon's Stock Falls as Revenue Growth Fails Assuage Investor Concerns,Amazon reported fiscal-year 2022 fourth-quarter earnings that disappointed shareholders.,https://www.fool.com/investing/2023/02/07/amazons-stock-falls-as-revenue-growth-fails-assuag/,fool.com,7,amazon reported fiscalyear fourthquarter earnings disappointed shareholder,-0.34,-0.238,0.1571657143,-0.395165714,Negative Impact
08/02/2023,102.04,102.67,98.78,100.05,100.05,75878300,2.95,51.45734626,1.192,0,19.59190606,0.6717572755,0.1507120743,4.57,300.84,11910.51953,15934.71973,7885.200195,7119.830078,3232.110107,60663.78906,20679.5,92.79699997,111.2371952,97.03468925,112.7606254,99.64350014,108.6867063,90.60029394,58.41035761,3.257128159,3.290203678,-0.03307552,4.464999063,113.6816,9385702400,37.9448627,44.15778409,19.62999916,U.S. Treasury urges financial firms to examine cloud services,"U.S. Treasury Department officials are urging the financial sector to address potential challenges in using cloud computing services, warning in a report on Wednesday that failure to do so could leave them and their customers vulnerable.",https://www.reuters.com/technology/us-treasury-urges-financial-firms-examine-cloud-services-2023-02-08/,reuters.com,10,u treasury department official urging financial sector address potential challenge using cloud computing service warning report wednesday failure could leave customer vulnerable,-0.6908,-0.6908,0.02463214286,-0.715432143,Negative Impact
09/02/2023,101.32,101.78,97.57,98.24,98.24,64622500,2.95,51.45734626,1.192,0,19.59190606,0.6717572755,0.1507120743,4.57,300.84,11789.58008,15828.59961,7911.200195,7188.359863,3270.379883,60806.21875,20597.80078,92.88279999,110.9980252,97.08195625,112.6161415,99.80100021,108.6171611,90.9848393,51.37080872,2.761227572,3.184408457,-0.423180885,4.469284603,113.3695681,9321079900,29.8932394,38.31555121,20.70999908,Is Amazon Stock Still a Buy After Jumping 19% in 2023?,"The tech giant seems to be on shaky ground following its latest report, but investors shouldn't lose hope.",https://www.fool.com/investing/2023/02/09/is-amazon-stock-still-a-buy-after-jumping-19/,fool.com,7,tech giant seems shaky ground following latest report investor shouldnt lose hope,-0.2612,-0.18284,0.2310533333,-0.413893333,Negative Impact
10/02/2023,97.56,98.82,96.23,97.61,97.61,52740100,2.95,51.45734626,1.192,0,19.59190606,0.6717572755,0.1507120743,4.57,300.84,11718.12012,15910.69043,7882.5,7129.72998,3260.669922,60682.69922,20612.09961,92.98660004,110.7891202,97.10266387,112.4668267,99.91800041,108.5409685,91.29503233,50.12339455,2.2909783,3.005722425,-0.714744126,4.517141615,112.7375853,9268339800,27.09076093,31.64295434,20.53000069,Will the Nasdaq ETF Lose Shine on Weak Tech Earnings?,Will a slew of weak earnings reports from the tech titans take shine away from the Nasdaq ETF?,https://www.zacks.com/stock/news/2052949/will-the-nasdaq-etf-lose-shine-on-weak-tech-earnings,zacks.com,8,slew weak earnings report tech titan take shine away nasdaq etf,-0.4404,-0.35232,0.10863,-0.46095,Negative Impact
13/02/2023,97.85,99.68,96.91,99.54,99.54,52841500,2.95,51.45734626,1.192,0,19.59190606,0.6717572755,0.1507120743,4.57,300.84,11891.79004,16052.25,7947.600098,7208.589844,3284.159912,60431.83984,20702.19922,93.04660004,110.5959851,97.19824572,112.3382016,99.98900032,108.5729298,91.40507083,54.32795899,2.050401506,2.814658242,-0.764256736,4.565713065,111.7471304,9321181300,35.67617026,30.88672353,20.34000015,Amazon CEO doubles down on grocery store business - FT,"Amazon.com Inc Chief Executive Andy Jassy has vowed to double down on the ecommerce giant's struggling grocery store business, the Financial Times reported on Monday.",https://www.reuters.com/technology/amazon-ceo-doubles-down-grocery-store-business-ft-2023-02-13/,reuters.com,10,amazoncom inc chief executive andy jassy vowed double ecommerce giant struggling grocery store business financial time reported monday,-0.4215,-0.4215,0.1378253333,-0.559325333,Negative Impact
14/02/2023,98.41,100.92,97.52,99.70,99.70,56202900,2.95,51.45734626,1.192,0,19.59190606,0.6717572755,0.1507120743,4.57,300.84,11960.15039,16025.11035,7953.899902,7213.810059,3293.280029,61032.26172,20704.80078,93.13059998,110.3715026,97.29635361,112.2124483,100.1715,108.5556953,91.78730477,53.45205092,1.851312232,2.62198904,-0.770676808,4.399998801,110.8161028,9377384200,19.52726082,27.43139734,18.90999985,"Livestream shopping took China by storm. Now Amazon, TikTok and YouTube are betting the QVC-style pitches will take off in the U.S.","Despite huge success in China, livestream shopping has caught on slowly in the U.S., but Amazon, TikTok and YouTube are making big bets that's about to change.",https://www.cnbc.com/2023/02/14/us-livestream-shopping-a-target-of-tiktok-amazon-live-and-youtube.html,cnbc.com,9,despite huge success china livestream shopping caught slowly u amazon tiktok youtube making big bet thats change,-0.504,-0.4536,0.07020666667,-0.523806667,Negative Impact
15/02/2023,99.09,101.17,98.45,101.16,101.16,47957600,2.95,51.45734626,1.192,0,19.59190606,0.6717572755,0.1507120743,4.57,300.84,12070.58984,16016.08984,7997.799805,7300.859863,3280.48999,61275.08984,20720.40039,93.2712001,110.2558952,97.4478693,112.1024737,100.4565002,108.5487885,92.364212,52.70044897,1.790700803,2.455731392,-0.665030589,4.410713196,109.9409368,9425341800,27.74339469,27.64894192,18.22999954,"Key Republican subpoenas Alphabet, Amazon, Apple, Meta and Microsoft for info on alleged collusion with the government to suppress speech","Jordan wants to ""understand how and to what extent the Executive Branch coerced and colluded with companies and other intermediaries to censor speech.""",https://www.cnbc.com/2023/02/15/jim-jordan-subpoenas-alphabet-amazon-apple-meta-and-microsoft-.html,cnbc.com,9,jordan want understand extent executive branch coerced colluded company intermediary censor speech,-0.6369,-0.57321,0.129775,-0.702985,Negative Impact
16/02/2023,99.21,100.63,98.10,98.15,98.15,56339200,2.95,51.45734626,1.192,0,19.59190606,0.6717572755,0.1507120743,4.57,300.84,11855.83008,15873.78027,8012.5,7366.160156,3249.030029,61319.51172,20606.40039,93.41400009,110.1241452,97.47540389,111.9636431,100.6800003,108.2117479,93.14825273,44.30521314,1.482692239,2.261123562,-0.778431322,4.324285235,109.1182808,9369002600,10.80471881,19.3584581,20.17000008,Amazon and Other Quality Stocks Have Been Hit Hard. They Could Be Buys.,"Some quality stocks are on sale, a perfect opportunity for investors interested in names that might have a particularly bright future.",https://www.barrons.com/articles/amazon-quality-stocks-buys-1f0ef60b,barrons.com,9,quality stock sale perfect opportunity investor interested name might particularly bright future,0.908,0.8172,0.1633928571,0.6538071429,Positive Impact
17/02/2023,97.8,97.94,95.65,97.20,97.20,60029400,2.95,51.45734626,1.192,0,19.59190606,0.6717572755,0.1507120743,4.57,300.84,11787.26953,15840.16016,8004.399902,7347.720215,3224.02002,61002.57031,20515.19922,93.59300003,109.9888776,97.46460362,111.8167412,100.6775002,108.2140734,93.14092689,45.2374114,1.14869437,2.038637723,-0.889943354,4.272142683,108.3449842,9308973200,8.446842241,15.66498525,20.02000046,"Amazon.com, Inc. (AMZN) is Attracting Investor Attention: Here is What You Should Know","Amazon (AMZN) has received quite a bit of attention from Zacks.com users lately. Therefore, it is wise to be aware of the facts that can impact the stock's prospects.",https://www.zacks.com/stock/news/2055830/amazon-com-inc-amzn-is-attracting-investor-attention-here-is-what-you-should-know,zacks.com,8,amazon amzn received quite bit attention zackscom user lately therefore wise aware fact impact stock prospect,0.7184,0.57472,0.2480225,0.3266975,Positive Impact
21/02/2023,95.34,95.61,94.27,94.58,94.58,56580400,2.95,51.45734626,1.192,0,19.59190606,0.6717572755,0.1507120743,4.57,300.84,11492.2998,15572.51953,7977.799805,7308.649902,3306.52002,60672.71875,20252.59961,93.71540009,109.8321352,97.35148198,111.6452313,100.5305004,108.4322281,92.62877272,37.85857435,0.6649221336,1.763894605,-1.098972472,4.281428746,107.3293856,9252392800,1.571237381,6.940932809,22.87000084,Amazon Web Services pairs with Hugging Face to target AI developers,"Amazon Web Services (AWS), the cloud computing arm of Amazon.com Inc , on Tuesday said it is collaborating with startup Hugging Face, a software development hub, to make it easier to carry out artificial intelligence work (AI) in Amazon's cloud.",https://www.reuters.com/technology/amazon-web-services-pairs-with-hugging-face-target-ai-developers-2023-02-21/,reuters.com,10,amazon web service aws cloud computing arm amazoncom inc tuesday said collaborating startup hugging face software development hub make easier carry artificial intelligence work ai amazon cloud,0.8779,0.8779,0.1395441667,0.7383558333,Positive Impact
22/02/2023,95.1,97.01,94.80,95.79,95.79,59534100,2.95,51.45734626,1.192,0,19.59190606,0.6717572755,0.1507120743,4.57,300.84,11507.07031,15530.83008,7930.600098,7299.259766,3291.149902,59744.98047,20193.30078,93.82420013,109.7290502,97.29024743,111.4874679,100.5040005,108.4684894,92.5395115,36.39535157,0.3748449852,1.486084681,-1.111239696,4.097857339,106.0234467,9311926900,7.704024399,5.907368007,22.29000092,Amazon Closes Health Clinic Deal in Bet on Physicians for Healthcare Growth,The e-commerce giant struck the $3.9 billion deal for One Medical as CVS and Walgreens also forge expansions based on clinicians.,https://www.wsj.com/articles/amazon-closes-purchase-of-one-medical-network-of-health-clinics-9ac7993c,wsj.com,9,ecommerce giant struck billion deal one medical cv walgreens also forge expansion based clinician,-0.25,-0.225,0.2803130769,-0.505313077,Negative Impact
23/02/2023,96.12,96.43,93.67,95.82,95.82,48467000,2.95,51.45734626,1.192,0,19.59190606,0.6717572755,0.1507120743,4.57,300.84,11590.40039,15584.92969,7907.700195,7317.430176,3287.47998,59605.80078,20188.19922,93.9588002,109.6342877,97.23259066,111.3315727,100.4360004,108.5419509,92.33004996,17.9602545,0.1456978914,1.218007323,-1.072309432,3.662857601,104.8481017,9360393900,14.22899695,7.83475291,21.13999939,2 M&A Deals Trading at Wide Spreads: A Game of Regulatory Risk,"Regulatory risk is king in the mergers and acquisitions (M&A) world as of late, both in the US and abroad. The Biden administration's aggressive antitrust stance and China's heavy scrutiny of semiconductor deals means that regulatory risk could kill an otherwise perfect M&A deal, which is why you see the spreads widening on otherwise sound deals.",https://www.marketbeat.com/originals/2-m-and-a-deals-trading-at-wide-spreads-a-game-of-regulatory-risk/?SNAPI,marketbeat.com,5,regulatory risk king merger acquisition world late u abroad biden administration aggressive antitrust stance china heavy scrutiny semiconductor deal mean regulatory risk could kill otherwise perfect deal see spread widening otherwise sound deal,-0.7003,-0.35015,0.227045,-0.577195,Negative Impact
24/02/2023,93.53,94.14,92.32,93.50,93.50,57053800,2.95,51.45734626,1.192,0,19.59190606,0.6717572755,0.1507120743,4.57,300.84,11394.94043,15464.45996,7878.700195,7187.27002,3267.159912,59463.92969,20219.19922,94.01780014,109.5578427,97.08621455,111.1541441,100.1500004,108.8205687,91.47943207,24.60195488,-0.220564883,0.930292882,-1.150857765,3.170714242,103.5067292,9303340100,10.14617871,10.69306669,21.67000008,Best Stock to Buy Now: Palantir vs. Amazon vs.,The three stocks offer investors high risk with high return potential.,https://www.fool.com/investing/2023/02/24/best-stock-to-buy-now-palantir-stock-vs-amazon-sto/,fool.com,7,three stock offer investor high risk high return potential,-0.2732,-0.19124,0.277256,-0.468496,Negative Impact
27/02/2023,94.28,94.78,93.14,93.76,93.76,47470300,2.95,51.45734626,1.192,0,19.59190606,0.6717572755,0.1507120743,4.57,300.84,11466.98047,15492.92969,7935.100098,7295.549805,3258.030029,59288.35156,20260.09961,94.04320023,109.4823477,96.95577485,110.981068,99.7260006,108.7868192,90.66518203,27.26782876,-0.484268426,0.6473806204,-1.131649046,3.052143097,101.9405871,9350810400,13.91306912,12.76274826,20.95000076,The Top Guru Stock Picks of the 4th Quarter,"The fourth quarter of 2022 was the light at the end of the tunnel for equity markets as they recouped some of their losses from the rest of the year. The S&P 500 climbed 7.6% for the quarter to end the year with a loss of 18.11%, while the Nasdaq narrowed its loss to 0.8% for the quarter to end the year down 32.5% and the Dow Jones Industrial Average popped 15.3% for a full-year drawdown of just 8.7%.",https://www.gurufocus.com/news/1958725/the-top-guru-stock-picks-of-the-4th-quarter,gurufocus.com,5,fourth quarter light end tunnel equity market recouped loss rest year sp climbed quarter end year loss nasdaq narrowed loss quarter end year dow jones industrial average popped fullyear drawdown,-0.7096,-0.3548,0.1407777778,-0.495577778,Negative Impact
28/02/2023,93.14,94.69,92.92,94.23,94.23,43959300,2.95,51.45734626,1.192,0,19.59190606,0.6717572755,0.1507120743,4.57,300.84,11455.54004,15428.96973,7876.299805,7267.930176,3279.610107,58962.12109,20221.19922,94.09620026,109.4266377,96.84888185,110.8143908,99.41000061,108.7851912,90.03481003,29.17548933,-0.647862063,0.3883320838,-1.036194147,2.869286128,100.5937049,9394769700,18.45414438,14.17113074,20.70000076,"Buy Amazon Stock When S&P 500 Hits 3,500",The withdrawal of liquidity from the system will take a new turn when the TGA runs out of funds and Congress raises the national debt ceiling. The expected recession will be difficult for retailers as the consumer is now the weakest since 2005.,https://seekingalpha.com/article/4582509-buy-amazon-stock-when-s-and-p-500-hits-3500,seekingalpha.com,6,withdrawal liquidity system take new turn tga run fund congress raise national debt ceiling expected recession difficult retailer consumer weakest since,-0.875,-0.525,0.149845,-0.674845,Negative Impact
01/03/2023,93.87,94.68,91.59,92.17,92.17,52299500,2.95,51.45734626,1.192,0,19.59190606,0.6717572755,0.1507120743,4.65,301.836,11379.48047,15436.2998,7914.899902,7234.25,3312.350098,59411.07813,20259.80078,94.17060028,109.3528352,96.66539622,110.6288744,98.86200066,108.5960497,89.12795164,29.17547756,-0.93298157,0.124069353,-1.057050923,2.812143598,99.43538615,9342470200,5.691871365,12.68636162,20.57999992,Amazon Ring CEO steps down five years after acquisition,"Ring CEO Jamie Siminoff will transition into the role of chief inventor on March 22, and be replaced by a former Discord and Microsoft executive.",https://www.cnbc.com/2023/03/01/amazon-ring-ceo-steps-down-five-years-after-acquisition.html,cnbc.com,9,ring ceo jamie siminoff transition role chief inventor march replaced former discord microsoft executive,-0.4019,-0.36171,0.1295811765,-0.491291176,Negative Impact
02/03/2023,91.41,92.23,90.39,92.13,92.13,55509400,2.95,51.45734626,1.192,0,19.59190606,0.6717572755,0.1507120743,4.65,301.836,11462.98047,15524.51953,7944,7284.220215,3310.649902,58909.35156,20337.19922,94.25600021,109.2482102,96.48753743,110.444806,98.21100044,107.915861,88.50613988,32.18659665,-1.148924487,-0.130529415,-1.018395072,2.642858233,98.18012378,9286960800,16.14098387,13.42899987,19.59000015,AWS startet Infrastrukturregion in Malaysia,"SEATTLE--(BUSINESS WIRE)--Amazon Web Services (AWS), ein Unternehmen von Amazon.com, Inc. (NASDAQ: AMZN), hat heute PlÃÂÃÂ¤ne fÃÂÃÂ¼r den Start einer AWS-Infrastrukturregion in Malaysia angekÃÂÃÂ¼ndigt. Die neue AWS-Region wird Entwicklern, Startups, ExistenzgrÃÂÃÂ¼ndern und Unternehmen sowie Regierungs-, Bildungs- und gemeinnÃÂÃÂ¼tzigen Organisationen eine grÃÂÃÂ¶ÃÂÃÂere Auswahl fÃÂÃÂ¼r die AusfÃÂÃÂ¼hrung ihrer Anwendungen und die Betreuung von Endbenutzern aus Rechenzentren in Malaysia bieten. Als Teil seines Engagements in der Region plant AWS, bis 2037 in Malaysia Investitionen in HÃÂÃÂ¶he von 6 Milliarden US-Dollar (ca. 25,5 Milliarden MYR) zu tÃÂÃÂ¤tigen. Weitere Informationen ÃÂÃÂ¼ber AWS Global Infrastructure finden Sie unter aws.amazon.com/about-aws/global-infrastructure. ÃÂÃÂAWS hat sich zu der bisher grÃÂÃÂ¶ÃÂÃÂten internationalen Technologieinvestition in Malaysia entschlossen, die unsere Vision von Malaysia Madani, einer hochqualifizierten, innovativen, wohlhabenden und nachhaltigen Wirtschaft, voranbringen wirdÃÂÃÂ, sagte Datuk Seri Anwar Ibrahim, Premierminister von Malaysia. ÃÂÃÂDer Zugang zu AWS-Infrastrukturen von Weltklasse, fortschrittlichen Technologien und Cloud-FÃÂÃÂ¤higkeitsprogrammen in Malaysia wird lokalen Unternehmen jeder GrÃÂÃÂ¶ÃÂÃÂe die MÃÂÃÂ¶glichkeit erÃÂÃÂ¶ffnen, global zu expandieren, hochqualifizierte ArbeitskrÃÂÃÂ¤fte heranzubilden, neue ArbeitsplÃÂÃÂ¤tze zu schaffen und langfristiges Wirtschaftswachstum zu erzielen. Die heutige AnkÃÂÃÂ¼ndigung ist ein klares Bekenntnis zur UnterstÃÂÃÂ¼tzung der FÃÂÃÂ¼hrungsrolle Malaysias in der globalen digitalen Wirtschaft. Wir freuen uns darauf, unsere Zusammenarbeit mit AWS zu vertiefen, um die Ambitionen unseres Landes in Bezug auf Cloud First voranzutreiben.ÃÂÃÂ ÃÂÃÂDie neue AWS-Region spiegelt unser tiefgreifendes und langfristiges Engagement fÃÂÃÂ¼r Kunden und Organisationen in Malaysia wider sowie unser Engagement, die betrÃÂÃÂ¤chtliche und schnell wachsende Nachfrage nach Cloud-Services in ganz SÃÂÃÂ¼dostasien zu bedienen. Wir sind stolz darauf, die digitale Transformation Malaysias mit dem hÃÂÃÂ¶chsten MaÃÂÃÂ an Sicherheit und ZuverlÃÂÃÂ¤ssigkeit zu unterstÃÂÃÂ¼tzen, das die AWS-Cloud-Infrastruktur zu bieten hatÃÂÃÂ, sagte Prasad Kalyanaraman, Vice President of Infrastructure Services bei AWS. ÃÂÃÂWir freuen uns darauf, malaysischen Institutionen, Start-ups und Unternehmen dabei zu helfen, Cloud-gestÃÂÃÂ¼tzte Anwendungen bereitzustellen, um die wirtschaftliche Entwicklung im ganzen Land voranzutreiben und die Schaffung von ArbeitsplÃÂÃÂ¤tzen, Qualifizierungs- und BildungsmÃÂÃÂ¶glichkeiten in den Gebieten rund um unsere Rechenzentren zu fÃÂÃÂ¶rdern.ÃÂÃÂ Die neue AWS-Region wird beim Start aus drei Availability Zones bestehen und die bestehenden 99 Availability Zones in 31 geografischen Regionen weltweit ergÃÂÃÂ¤nzen. Mit der heutigen AnkÃÂÃÂ¼ndigung plant AWS die EinfÃÂÃÂ¼hrung von 15 weiteren Availability Zones und fÃÂÃÂ¼nf weiteren AWS-Regionen in Kanada, Israel, Malaysia, Neuseeland und Thailand. AWS-Regionen bestehen aus Availability Zones, die die Infrastruktur an getrennten und unterschiedlichen geografischen Standorten platzieren. Diese sind weit genug voneinander entfernt, um das Risiko, dass ein einzelnes Ereignis die GeschÃÂÃÂ¤ftskontinuitÃÂÃÂ¤t der Kunden beeintrÃÂÃÂ¤chtigt, deutlich zu verringern, und dennoch nahe genug, um niedrige Latenzzeiten fÃÂÃÂ¼r HochverfÃÂÃÂ¼gbarkeitsanwendungen zu bieten, die mehrere Availability Zones nutzen. Jede Availability Zone verfÃÂÃÂ¼gt ÃÂÃÂ¼ber eine unabhÃÂÃÂ¤ngige Stromversorgung, KÃÂÃÂ¼hlung und physische Sicherheit und ist ÃÂÃÂ¼ber redundante Netzwerke mit extrem niedriger Latenz verbunden. AWS-Kunden, die Wert auf hohe VerfÃÂÃÂ¼gbarkeit legen, kÃÂÃÂ¶nnen ihre Anwendungen so konzipieren, dass sie in mehreren Availability Zones und ÃÂÃÂ¼ber mehrere Regionen hinweg ausgefÃÂÃÂ¼hrt werden, um eine noch grÃÂÃÂ¶ÃÂÃÂere Fehlertoleranz zu erreichen. Die neue AWS-Region ermÃÂÃÂ¶glicht es Kunden mit DatenresidenzprÃÂÃÂ¤ferenzen, Daten sicher in Malaysia zu speichern, noch niedrigere Latenzzeiten zu erreichen und die Nachfrage nach Cloud-Services in ganz SÃÂÃÂ¼dostasien zu bedienen. Kunden von Startups ÃÂÃÂ¼ber Unternehmen bis hin zu Regierungsorganisationen und gemeinnÃÂÃÂ¼tzigen Organisationen werden in der Lage sein, fortschrittliche Technologien der weltweit fÃÂÃÂ¼hrenden Cloud zu nutzen, um Innovationen voranzutreiben. AWS bietet das breiteste und tiefste Portfolio an Diensten, darunter Analysen, Datenverarbeitung, Datenbanken, Internet der Dinge (Internet of Things, IoT), maschinelles Lernen, mobile Dienste, Speicher und andere Cloud-Technologien. Kunden begrÃÂÃÂ¼ÃÂÃÂen die AWS-Region in Malaysia Organisationen in Malaysia gehÃÂÃÂ¶ren zu den Millionen von aktiven Kunden, die AWS in mehr als 190 LÃÂÃÂ¤ndern auf der ganzen Welt nutzen. Unternehmen in Malaysia entscheiden sich fÃÂÃÂ¼r AWS, um innovativ zu sein, die Kosteneffizienz zu steigern und die MarkteinfÃÂÃÂ¼hrung zu beschleunigen. Zu den Kunden, die AWS nutzen, gehÃÂÃÂ¶ren Astro Malaysia Berhad, Axiata Group, Bank Islam Malaysia, CelcomDigi, Johor Corporation, PayNet und Petroliam Nasional Berhad (PETRONAS). Malaysische Kunden aus dem ÃÂÃÂ¶ffentlichen Sektor nutzen AWS, um Kosteneinsparungen zu erzielen und den BÃÂÃÂ¼rgern vor Ort einen besseren Service zu bieten. Zu diesen Kunden gehÃÂÃÂ¶ren Asia Pacific University of Technology & Innovation, BeEducation, Cybersecurity Malaysia, Department of Statistics Malaysia, Ministry of Higher Education Malaysia, Pos Malaysia und Tenaga Nasional Berhad (TNB). Malaysische Startups und kleine Unternehmen, darunter Baba Products, Carsome, Omesti Berhad und StoreHub, bauen ihre GeschÃÂÃÂ¤fte auf AWS auf, um national und weltweit schnell zu wachsen. PayNet, das nationale Zahlungsnetzwerk und die gemeinsam genutzte zentrale Infrastruktur fÃÂÃÂ¼r das Finanzmarktsegment Malaysias, verwendet AWS fÃÂÃÂ¼r die AusfÃÂÃÂ¼hrung wichtiger Bank-Workloads, einschlieÃÂÃÂlich des unternehmenseigenen bargeldlosen Zahlungssystems MyDebit. ÃÂÃÂAls landesweiter Betreiber einer Echtzeit-Infrastruktur fÃÂÃÂ¼r den Massenzahlungsverkehr nutzen wir AWS, um die von unseren Kunden geforderte ZuverlÃÂÃÂ¤ssigkeit, Sicherheit, Skalierbarkeit und Compliance zu gewÃÂÃÂ¤hrleistenÃÂÃÂ, so Farhan Ahmad, Group CEO bei PayNet. ÃÂÃÂDie EinfÃÂÃÂ¼hrung einer AWS-Region in Malaysia bietet uns einen Zugang zu Cloud-Services mit niedrigeren Latenzzeiten, um unseren Kunden ein nahtloses Zahlungsverfahren zu bieten. Wir sind gespannt, wie diese Entwicklung den Weg fÃÂÃÂ¼r andere Unternehmen in der Region ebnen kann, damit sie schnell Innovationen einfÃÂÃÂ¼hren und neue GeschÃÂÃÂ¤ftschancen nutzen kÃÂÃÂ¶nnen.ÃÂÃÂ PETRONAS, ein globaler Energie- und LÃÂÃÂ¶sungsanbieter mit PrÃÂÃÂ¤senz in ÃÂÃÂ¼ber 50 LÃÂÃÂ¤ndern, ist seit 2014 AWS-Kunde. ÃÂÃÂUnsere Arbeit mit AWS hat unsere digitalen LÃÂÃÂ¶sungen unterstÃÂÃÂ¼tzt und uns ermÃÂÃÂ¶glicht, die Cloud als Beschleunigungsmittel zu nutzen. Wir haben auch Amazons ÃÂÃÂWorking BackwardsÃÂÃÂ-Methode genutzt, um Best Practices fÃÂÃÂ¼r Innovationen im gesamten Konzern zu entwickeln und zu skalieren und so neue Wachstumschancen zu verfolgenÃÂÃÂ, sagte Datuk Tengku Muhammad Taufik, President und Group CEO von PETRONAS. ÃÂÃÂMit dem Start der AWS-Region in Malaysia freuen wir uns darauf, unsere Zusammenarbeit mit AWS weiter zu stÃÂÃÂ¤rken, um skalierbare LÃÂÃÂ¶sungen zu entwickeln, unseren Stakeholdern einen grÃÂÃÂ¶ÃÂÃÂeren Wert zu bieten und einen Beitrag zur Verwirklichung der Vision Malaysias zu leisten, ein regionaler MarktfÃÂÃÂ¼hrer in der digitalen Wirtschaft zu werden.ÃÂÃÂ Pos Malaysia, Malaysias nationaler Post- und Paketdienstleister, verfÃÂÃÂ¼gt ÃÂÃÂ¼ber das grÃÂÃÂ¶ÃÂÃÂte Zustell- und Einzelhandelsnetzwerk des Landes, das mehr als 10 Millionen Adressen beliefert und mehr als 3.500 Verkaufsstellen betreibt. Als Teil der digitalen Transformation des Unternehmens plant Pos Malaysia, den GroÃÂÃÂteil seiner IT-Infrastruktur bis 2023 auf AWS zu migrieren. ÃÂÃÂWÃÂÃÂ¤hrend wir unsere digitale Transformation fortsetzen, um ein besseres Kundenerlebnis zu bieten, hat unsere Zusammenarbeit mit AWS dazu beigetragen, unsere Prozesse zu rationalisieren, die IT-Kosten um 50 % zu senken und die organisatorische FlexibilitÃÂÃÂ¤t zu erhÃÂÃÂ¶henÃÂÃÂ, sagte Sumesh Rahavendra, Chief Strategy and Digital Officer bei Pos Malaysia. ÃÂÃÂWir freuen uns ÃÂÃÂ¼ber den Start einer AWS-Region in Malaysia und darauf, tiefgreifende Analysen und maschinelle Lerninitiativen in unsere AblÃÂÃÂ¤ufe zu integrieren. Dies versetzt uns in die Lage, unsere Produkte und Dienstleistungen weiterzuentwickeln und so Kunden auf der letzten Meile ein LÃÂÃÂ¤cheln zu schenken.ÃÂÃÂ TNB ist der grÃÂÃÂ¶ÃÂÃÂte Stromversorger in Malaysia und betreut landesweit mehr als 9,5 Millionen Gewerbe-, Industrie- und Privatkunden. TNB arbeitet seit 2020 mit AWS zusammen, um seine digitale Transformation zu beschleunigen, die Kundenerfahrung zu verbessern und intelligente EnergielÃÂÃÂ¶sungen zu entwickeln. ÃÂÃÂTNB hat die digitale Transformation und mehr als nur ein Versorgungsunternehmen zu sein, zu seiner Aufgabe gemachtÃÂÃÂ, sagte Azlan bin Ahmad, Chief Information Officer bei TNB. ÃÂÃÂDie Nutzung von erstklassigen AWS-Diensten wie Rechenleistung, maschinelles Lernen und kÃÂÃÂ¼nstliche Intelligenz wird uns dabei helfen, die EinfÃÂÃÂ¼hrung innovativer digitaler Dienste zu beschleunigen, die es den Kunden ermÃÂÃÂ¶glichen, ihren Energieverbrauch einfacher zu verfolgen und zu verwalten. Wir begrÃÂÃÂ¼ÃÂÃÂen die EinfÃÂÃÂ¼hrung einer AWS-Region in Malaysia, die dazu beitragen wird, die Effizienz und AgilitÃÂÃÂ¤t von Branchen zu steigern und Unternehmen dabei zu helfen, eine breitere Auswahl an Diensten bereitzustellen, um das Leben der Einwohner vor Ort zu verbessern.ÃÂÃÂ Malaysische AWS-Partner befÃÂÃÂ¼rworten die neue AWS-Region ebenfalls Das AWS-Partnernetzwerk (AWS Partner Network, APN) umfasst Zehntausende von unabhÃÂÃÂ¤ngigen Softwareanbietern (ISVs) und Systemintegratoren (SIs) auf der ganzen Welt. AWS-Partner entwickeln innovative LÃÂÃÂ¶sungen und Services auf AWS, und das APN hilft ihnen dabei, indem es Kunden geschÃÂÃÂ¤ftliche, technische, Marketing- und MarkteinfÃÂÃÂ¼hrungsunterstÃÂÃÂ¼tzung bietet. ISVs, SIs und Beratungspartner von AWS helfen Kunden aus Unternehmen und dem ÃÂÃÂ¶ffentlichen Sektor bei der Migration zu AWS, bei der Bereitstellung geschÃÂÃÂ¤ftskritischer Anwendungen und bieten eine breite Auswahl an ÃÂÃÂberwachungs-, Automatisierungs- und Verwaltungsservices fÃÂÃÂ¼r die Cloud-Umgebungen der Kunden. Beispiele fÃÂÃÂ¼r in Malaysia ansÃÂÃÂ¤ssige AWS-Partner sind Axrail, eCloudvalley, Exabytes, G-AsiaPacific, GHL, Maxis, Radmik Solutions Sdn Bhd, Silverlake Axis, Tapway, Uberfusion und Wavelet. Die vollstÃÂÃÂ¤ndige Liste der AWS-Partner finden Sie unter aws.amazon.com/partners. Maxis ist Malaysias fÃÂÃÂ¼hrender Anbieter konvergenter LÃÂÃÂ¶sungen und ein AWS Advanced Tier Services Partner. Im Jahr 2019 unterzeichnete Maxis eine strategische Kooperationsvereinbarung mit AWS, um branchenfÃÂÃÂ¼hrende Cloud-Technologien bereitzustellen, die durch 4G ermÃÂÃÂ¶glicht werden, damit Unternehmen ihre ProduktivitÃÂÃÂ¤t, Leistung und Innovation verbessern kÃÂÃÂ¶nnen. ÃÂÃÂMaxis hat das Ziel, der One-Stop-Shop fÃÂÃÂ¼r alle IT- und KonnektivitÃÂÃÂ¤tsdienste in Malaysia zu sein, und wir sehen AWS als einen SchlÃÂÃÂ¼sselfaktor, der uns hilft, dieses Ziel zu erreichenÃÂÃÂ, sagte Goh Seow Eng, CEO von Maxis. ÃÂÃÂWir freuen uns darauf, den Unternehmen in Malaysia einen besseren Zugang zu erstklassigen Cloud-LÃÂÃÂ¶sungen zu bieten, um die Cloud-EinfÃÂÃÂ¼hrung zu beschleunigen und die Unternehmen zu befÃÂÃÂ¤higen, besser fÃÂÃÂ¼r die Industrie 4.0 gerÃÂÃÂ¼stet zu sein, ganz im Einklang mit dem Regierungsziel ÃÂÃÂCloud FirstÃÂÃÂ.ÃÂÃÂ Silverlake Axis ist Anbieter von Unternehmenstechnologie, Software und Dienstleistungen und ein AWS-Softwarepartner. ÃÂÃÂDie Zusammenarbeit von Silverlake Axis mit AWS hat uns dabei geholfen, eine Zukunftsvision fÃÂÃÂ¼r unsere digitale LÃÂÃÂ¶sung zu entwickeln, indem wir 25 Omnichannel-Anwendungen wie Transaktionen, Kredite, Zahlungen und digitales Engagement modernisiert habenÃÂÃÂ, sagte Andrew Tan, Group Managing Director bei Silverlake Axis. ÃÂÃÂWir kÃÂÃÂ¶nnen unseren Kunden nun verschiedene Kombinationen digitaler LÃÂÃÂ¶sungen mit einem Pay-as-you-go-Preismodell anbieten, das eine maÃÂÃÂgeschneiderte und nahtlose Kundenerfahrung ÃÂÃÂ¼ber alle KanÃÂÃÂ¤le und jedes GerÃÂÃÂ¤t hinweg ermÃÂÃÂ¶glicht. Eine AWS-Region in Malaysia wird fÃÂÃÂ¼r die Branche der Technologiedienstleistungen transformativ sein und eine sichere, hochleistungsfÃÂÃÂ¤hige, widerstandsfÃÂÃÂ¤hige und regulierte Infrastruktur fÃÂÃÂ¼r digitale Banking-Workloads oder InsurTech-Unternehmen bieten. Dies wird uns helfen, die EinfÃÂÃÂ¼hrung neuer Funktionen zu beschleunigen und unseren Kunden die MÃÂÃÂ¶glichkeit geben, die Vorteile der Cloud schnell zu nutzen.ÃÂÃÂ Engagement fÃÂÃÂ¼r Nachhaltigkeit Im Rahmen seines Klimaversprechens ÃÂÃÂThe Climate PledgeÃÂÃÂ hat sich Amazon verpflichtet, bis zum Jahr 2040 im gesamten Unternehmen eine Netto-Null-Kohlenstoffbilanz zu erreichen, und ist auf dem Weg, seinen Betrieb bis 2025 zu 100 % mit erneuerbaren Energien zu versorgen - fÃÂÃÂ¼nf Jahre vor dem ursprÃÂÃÂ¼nglichen Ziel fÃÂÃÂ¼r 2030. Im Jahr 2022 stellte Amazon einen neuen Unternehmensrekord fÃÂÃÂ¼r den grÃÂÃÂ¶ÃÂÃÂten Anteil an erneuerbaren Energien auf, den ein einzelnes Unternehmen in einem Jahr angekÃÂÃÂ¼ndigt hat, und ist nach wie vor der grÃÂÃÂ¶ÃÂÃÂte UnternehmenskÃÂÃÂ¤ufer von erneuerbaren Energien - eine Position, die das Unternehmen seit 2020 innehat. Amazon hat jetzt 401 Projekte fÃÂÃÂ¼r erneuerbare Energien weltweit, darunter 164 Wind- und Solarparks und 237 Aufdach-Solarprojekte auf Amazon-Standorten. Sobald sie in Betrieb sind, werden Amazons globale Projekte fÃÂÃÂ¼r erneuerbare Energien voraussichtlich 56.881 Gigawattstunden (GWh) an sauberer Energie pro Jahr erzeugen. DarÃÂÃÂ¼ber hinaus wird AWS bis 2030 eine positive Wasserbilanz haben und mehr Wasser an die Gemeinden zurÃÂÃÂ¼ckgeben, als es fÃÂÃÂ¼r seine direkten TÃÂÃÂ¤tigkeiten verbraucht. ÃÂÃÂber Amazon Web Services Amazon Web Services bietet seit 2006 das umfassendste und am weitesten verbreitete Cloud-Angebot der Welt. AWS hat seine Services kontinuierlich erweitert, um praktisch jede Cloud-Arbeitslast zu unterstÃÂÃÂ¼tzen. Heute verfÃÂÃÂ¼gt AWS ÃÂÃÂ¼ber mehr als 200 voll funktionsfÃÂÃÂ¤hige Services fÃÂÃÂ¼r Rechenleistung, Speicher, Datenbanken, Netzwerke, Analytik, maschinelles Lernen und kÃÂÃÂ¼nstliche Intelligenz (KI), Internet der Dinge (IoT), Mobiles, Sicherheit, Hybrid, Virtual und Augmented Reality (VR und AR), Medien sowie Anwendungsentwicklung, -bereitstellung und -verwaltung aus 99 Availability Zones in 31 geografischen Regionen. Es sind 15 weitere Availability Zones und fÃÂÃÂ¼nf weitere AWS-Regionen in Kanada, Israel, Malaysia, Neuseeland und Thailand geplant. Millionen von Kunden, darunter die am schnellsten wachsenden Startups, die grÃÂÃÂ¶ÃÂÃÂten Konzerne und fÃÂÃÂ¼hrende RegierungsbehÃÂÃÂ¶rden, vertrauen bei der Bereitstellung ihrer Infrastruktur auf AWS, um agiler zu werden und Kosten zu senken. Weitere Informationen ÃÂÃÂ¼ber AWS finden Sie unter aws.amazon.com. ÃÂÃÂber Amazon Amazon verfolgt vier Prinzipien: Kundenbesessenheit statt Wettbewerbsorientierung, Leidenschaft fÃÂÃÂ¼r Erfindungen, Engagement fÃÂÃÂ¼r operative Exzellenz und langfristiges Denken. Amazon hat es sich zum Ziel gesetzt, das kundenorientierteste Unternehmen der Welt, der beste Arbeitgeber der Welt und der sicherste Arbeitsplatz der Welt zu sein. Kundenrezensionen, 1-Click-Shopping, personalisierte Empfehlungen, Prime, Fulfillment by Amazon, AWS, Kindle Direct Publishing, Kindle, Career Choice, Fire-Tablets, Fire TV, Amazon Echo, Alexa, Just Walk Out-Technologie, Amazon Studios und The Climate Pledge sind nur einige der innovativen Entwicklungen von Amazon. FÃÂÃÂ¼r weitere Informationen besuchen Sie amazon.com/about und folgen Sie @AmazonNews. Die Ausgangssprache, in der der Originaltext verÃÂÃÂ¶ffentlicht wird, ist die offizielle und autorisierte Version. ÃÂÃÂbersetzungen werden zur besseren VerstÃÂÃÂ¤ndigung mitgeliefert. Nur die Sprachversion, die im Original verÃÂÃÂ¶ffentlicht wurde, ist rechtsgÃÂÃÂ¼ltig. Gleichen Sie deshalb ÃÂÃÂbersetzungen mit der originalen Sprachversion der VerÃÂÃÂ¶ffentlichung ab.",https://www.businesswire.com/news/home/20230301005842/de/,businesswire.com,5,seattlebusiness wireamazon web service aws ein unternehmen von amazoncom inc nasdaq amzn hat heute plne fr den start einer awsinfrastrukturregion malaysia angekndigt die neue awsregion wird entwicklern startup existenzgrndern und unternehmen sowie regierungs bildungs und gemeinntzigen organisationen eine grere auswahl fr die ausfhrung ihrer anwendungen und die betreuung von endbenutzern au rechenzentren malaysia bieten al teil seine engagement der region plant aws bi malaysia investitionen hhe von milliarden usdollar ca milliarden myr zu ttigen weitere informationen ber aws global infrastructure finden sie unter awsamazoncomaboutawsglobalinfrastructure aws hat sich zu der bisher grten internationalen technologieinvestition malaysia entschlossen die unsere vision von malaysia madani einer hochqualifizierten innovativen wohlhabenden und nachhaltigen wirtschaft voranbringen wird sagte datuk seri anwar ibrahim premierminister von malaysia der zugang zu awsinfrastrukturen von weltklasse fortschrittlichen technologien und cloudfhigkeitsprogrammen malaysia wird lokalen unternehmen jeder gre die mglichkeit erffnen global zu expandieren hochqualifizierte arbeitskrfte heranzubilden neue arbeitspltze zu schaffen und langfristiges wirtschaftswachstum zu erzielen die heutige ankndigung ist ein klares bekenntnis zur untersttzung der fhrungsrolle malaysia der globalen digitalen wirtschaft wir freuen un darauf unsere zusammenarbeit mit aws zu vertiefen um die ambitionen unseres landes bezug auf cloud first voranzutreiben die neue awsregion spiegelt unser tiefgreifendes und langfristiges engagement fr kunden und organisationen malaysia wider sowie unser engagement die betrchtliche und schnell wachsende nachfrage nach cloudservices ganz sdostasien zu bedienen wir sind stolz darauf die digitale transformation malaysia mit dem hchsten sicherheit und zuverlssigkeit zu untersttzen da die awscloudinfrastruktur zu bieten hat sagte prasad kalyanaraman vice president infrastructure service bei aws wir freuen un darauf malaysischen institutionen startup und unternehmen dabei zu helfen cloudgesttzte anwendungen bereitzustellen um die wirtschaftliche entwicklung im ganzen land voranzutreiben und die schaffung von arbeitspltzen qualifizierungs und bildungsmglichkeiten den gebieten rund um unsere rechenzentren zu frdern die neue awsregion wird beim start au drei availability zone bestehen und die bestehenden availability zone geografischen regionen weltweit ergnzen mit der heutigen ankndigung plant aws die einfhrung von weiteren availability zone und fnf weiteren awsregionen kanada israel malaysia neuseeland und thailand awsregionen bestehen au availability zone die die infrastruktur getrennten und unterschiedlichen geografischen standorten platzieren diese sind weit genug voneinander entfernt um da risiko das ein einzelnes ereignis die geschftskontinuitt der kunden beeintrchtigt deutlich zu verringern und dennoch nahe genug um niedrige latenzzeiten fr hochverfgbarkeitsanwendungen zu bieten die mehrere availability zone nutzen jede availability zone verfgt ber eine unabhngige stromversorgung khlung und physische sicherheit und ist ber redundante netzwerke mit extrem niedriger latenz verbunden awskunden die wert auf hohe verfgbarkeit legen knnen ihre anwendungen konzipieren das sie mehreren availability zone und ber mehrere regionen hinweg ausgefhrt werden um eine noch grere fehlertoleranz zu erreichen die neue awsregion ermglicht e kunden mit datenresidenzprferenzen daten sicher malaysia zu speichern noch niedrigere latenzzeiten zu erreichen und die nachfrage nach cloudservices ganz sdostasien zu bedienen kunden von startup ber unternehmen bi hin zu regierungsorganisationen und gemeinntzigen organisationen werden der lage sein fortschrittliche technologien der weltweit fhrenden cloud zu nutzen um innovationen voranzutreiben aws bietet da breiteste und tiefste portfolio diensten darunter analysen datenverarbeitung datenbanken internet der dinge internet thing iot maschinelles lernen mobile dienste speicher und andere cloudtechnologien kunden begren die awsregion malaysia organisationen malaysia gehren zu den millionen von aktiven kunden die aws mehr al lndern auf der ganzen welt nutzen unternehmen malaysia entscheiden sich fr aws um innovativ zu sein die kosteneffizienz zu steigern und die markteinfhrung zu beschleunigen zu den kunden die aws nutzen gehren astro malaysia berhad axiata group bank islam malaysia celcomdigi johor corporation paynet und petroliam nasional berhad petronas malaysische kunden au dem ffentlichen sektor nutzen aws um kosteneinsparungen zu erzielen und den brgern vor ort einen besseren service zu bieten zu diesen kunden gehren asia pacific university technology innovation beeducation cybersecurity malaysia department statistic malaysia ministry higher education malaysia po malaysia und tenaga nasional berhad tnb malaysische startup und kleine unternehmen darunter baba product carsome omesti berhad und storehub bauen ihre geschfte auf aws auf um national und weltweit schnell zu wachsen paynet da nationale zahlungsnetzwerk und die gemeinsam genutzte zentrale infrastruktur fr da finanzmarktsegment malaysia verwendet aws fr die ausfhrung wichtiger bankworkloads einschlielich de unternehmenseigenen bargeldlosen zahlungssystems mydebit al landesweiter betreiber einer echtzeitinfrastruktur fr den massenzahlungsverkehr nutzen wir aws um die von unseren kunden geforderte zuverlssigkeit sicherheit skalierbarkeit und compliance zu gewhrleisten farhan ahmad group ceo bei paynet die einfhrung einer awsregion malaysia bietet un einen zugang zu cloudservices mit niedrigeren latenzzeiten um unseren kunden ein nahtloses zahlungsverfahren zu bieten wir sind gespannt wie diese entwicklung den weg fr andere unternehmen der region ebnen kann damit sie schnell innovationen einfhren und neue geschftschancen nutzen knnen petronas ein globaler energie und lsungsanbieter mit prsenz ber lndern ist seit awskunde unsere arbeit mit aws hat unsere digitalen lsungen untersttzt und un ermglicht die cloud al beschleunigungsmittel zu nutzen wir haben auch amazon working backwardsmethode genutzt um best practice fr innovationen im gesamten konzern zu entwickeln und zu skalieren und neue wachstumschancen zu verfolgen sagte datuk tengku muhammad taufik president und group ceo von petronas mit dem start der awsregion malaysia freuen wir un darauf unsere zusammenarbeit mit aws weiter zu strken um skalierbare lsungen zu entwickeln unseren stakeholdern einen greren wert zu bieten und einen beitrag zur verwirklichung der vision malaysia zu leisten ein regionaler marktfhrer der digitalen wirtschaft zu werden po malaysia malaysia nationaler post und paketdienstleister verfgt ber da grte zustell und einzelhandelsnetzwerk de landes da mehr al millionen adressen beliefert und mehr al verkaufsstellen betreibt al teil der digitalen transformation de unternehmens plant po malaysia den groteil seiner itinfrastruktur bi auf aws zu migrieren whrend wir unsere digitale transformation fortsetzen um ein besseres kundenerlebnis zu bieten hat unsere zusammenarbeit mit aws dazu beigetragen unsere prozesse zu rationalisieren die itkosten um zu senken und die organisatorische flexibilitt zu erhhen sagte sumesh rahavendra chief strategy digital officer bei po malaysia wir freuen un ber den start einer awsregion malaysia und darauf tiefgreifende analysen und maschinelle lerninitiativen unsere ablufe zu integrieren dy versetzt un die lage unsere produkte und dienstleistungen weiterzuentwickeln und kunden auf der letzten meile ein lcheln zu schenken tnb ist der grte stromversorger malaysia und betreut landesweit mehr al millionen gewerbe industrie und privatkunden tnb arbeitet seit mit aws zusammen um seine digitale transformation zu beschleunigen die kundenerfahrung zu verbessern und intelligente energielsungen zu entwickeln tnb hat die digitale transformation und mehr al nur ein versorgungsunternehmen zu sein zu seiner aufgabe gemacht sagte azlan bin ahmad chief information officer bei tnb die nutzung von erstklassigen awsdiensten wie rechenleistung maschinelles lernen und knstliche intelligenz wird un dabei helfen die einfhrung innovativer digitaler dienste zu beschleunigen die e den kunden ermglichen ihren energieverbrauch einfacher zu verfolgen und zu verwalten wir begren die einfhrung einer awsregion malaysia die dazu beitragen wird die effizienz und agilitt von branchen zu steigern und unternehmen dabei zu helfen eine breitere auswahl diensten bereitzustellen um da leben der einwohner vor ort zu verbessern malaysische awspartner befrworten die neue awsregion ebenfalls da awspartnernetzwerk aws partner network apn umfasst zehntausende von unabhngigen softwareanbietern isvs und systemintegratoren si auf der ganzen welt awspartner entwickeln innovative lsungen und service auf aws und da apn hilft ihnen dabei indem e kunden geschftliche technische marketing und markteinfhrungsuntersttzung bietet isvs si und beratungspartner von aws helfen kunden au unternehmen und dem ffentlichen sektor bei der migration zu aws bei der bereitstellung geschftskritischer anwendungen und bieten eine breite auswahl berwachungs automatisierungs und verwaltungsservices fr die cloudumgebungen der kunden beispiele fr malaysia ansssige awspartner sind axrail ecloudvalley exabyte gasiapacific ghl maxi radmik solution sdn bhd silverlake axis tapway uberfusion und wavelet die vollstndige liste der awspartner finden sie unter awsamazoncompartners maxi ist malaysia fhrender anbieter konvergenter lsungen und ein aws advanced tier service partner im jahr unterzeichnete maxi eine strategische kooperationsvereinbarung mit aws um branchenfhrende cloudtechnologien bereitzustellen die durch g ermglicht werden damit unternehmen ihre produktivitt leistung und innovation verbessern knnen maxi hat da ziel der onestopshop fr alle und konnektivittsdienste malaysia zu sein und wir sehen aws al einen schlsselfaktor der un hilft diesis ziel zu erreichen sagte goh seow eng ceo von maxi wir freuen un darauf den unternehmen malaysia einen besseren zugang zu erstklassigen cloudlsungen zu bieten um die cloudeinfhrung zu beschleunigen und die unternehmen zu befhigen besser fr die industrie gerstet zu sein ganz im einklang mit dem regierungsziel cloud first silverlake axis ist anbieter von unternehmenstechnologie software und dienstleistungen und ein awssoftwarepartner die zusammenarbeit von silverlake axis mit aws hat un dabei geholfen eine zukunftsvision fr unsere digitale lsung zu entwickeln indem wir omnichannelanwendungen wie transaktionen kredite zahlungen und digitales engagement modernisiert haben sagte andrew tan group managing director bei silverlake axis wir knnen unseren kunden nun verschiedene kombinationen digitaler lsungen mit einem payasyougopreismodell anbieten da eine mageschneiderte und nahtlose kundenerfahrung ber alle kanle und jedes gert hinweg ermglicht eine awsregion malaysia wird fr die branche der technologiedienstleistungen transformativ sein und eine sichere hochleistungsfhige widerstandsfhige und regulierte infrastruktur fr digitale bankingworkloads oder insurtechunternehmen bieten dy wird un helfen die einfhrung neuer funktionen zu beschleunigen und unseren kunden die mglichkeit geben die vorteile der cloud schnell zu nutzen engagement fr nachhaltigkeit im rahmen seine klimaversprechens climate pledge hat sich amazon verpflichtet bi zum jahr im gesamten unternehmen eine nettonullkohlenstoffbilanz zu erreichen und ist auf dem weg seinen betrieb bi zu mit erneuerbaren energien zu versorgen fnf jahre vor dem ursprnglichen ziel fr im jahr stellte amazon einen neuen unternehmensrekord fr den grten anteil erneuerbaren energien auf den ein einzelnes unternehmen einem jahr angekndigt hat und ist nach wie vor der grte unternehmenskufer von erneuerbaren energien eine position die da unternehmen seit innehat amazon hat jetzt projekte fr erneuerbare energien weltweit darunter wind und solarparks und aufdachsolarprojekte auf amazonstandorten sobald sie betrieb sind werden amazon globale projekte fr erneuerbare energien voraussichtlich gigawattstunden gwh sauberer energie pro jahr erzeugen darber hinaus wird aws bi eine positive wasserbilanz haben und mehr wasser die gemeinden zurckgeben al e fr seine direkten ttigkeiten verbraucht ber amazon web service amazon web service bietet seit da umfassendste und weitesten verbreitete cloudangebot der welt aws hat seine service kontinuierlich erweitert um praktisch jede cloudarbeitslast zu untersttzen heute verfgt aws ber mehr al voll funktionsfhige service fr rechenleistung speicher datenbanken netzwerke analytik maschinelles lernen und knstliche intelligenz ki internet der dinge iot mobile sicherheit hybrid virtual und augmented reality vr und ar medien sowie anwendungsentwicklung bereitstellung und verwaltung au availability zone geografischen regionen e sind weitere availability zone und fnf weitere awsregionen kanada israel malaysia neuseeland und thailand geplant millionen von kunden darunter die schnellsten wachsenden startup die grten konzerne und fhrende regierungsbehrden vertrauen bei der bereitstellung ihrer infrastruktur auf aws um agiler zu werden und kosten zu senken weitere informationen ber aws finden sie unter awsamazoncom ber amazon amazon verfolgt vier prinzipien kundenbesessenheit statt wettbewerbsorientierung leidenschaft fr erfindungen engagement fr operative exzellenz und langfristiges denken amazon hat e sich zum ziel gesetzt da kundenorientierteste unternehmen der welt der beste arbeitgeber der welt und der sicherste arbeitsplatz der welt zu sein kundenrezensionen clickshopping personalisierte empfehlungen prime fulfillment amazon aws kindle direct publishing kindle career choice firetablets fire tv amazon echo alexa walk outtechnologie amazon studio und climate pledge sind nur einige der innovativen entwicklungen von amazon fr weitere informationen besuchen sie amazoncomabout und folgen sie amazonnews die ausgangssprache der der originaltext verffentlicht wird ist die offizielle und autorisierte version bersetzungen werden zur besseren verstndigung mitgeliefert nur die sprachversion die im original verffentlicht wurde ist rechtsgltig gleichen sie deshalb bersetzungen mit der originalen sprachversion der verffentlichung ab,-0.9997,-0.49985,0.130315,-0.630165,Negative Impact
03/03/2023,92.74,94.94,92.66,94.90,94.90,55759600,2.95,51.45734626,1.192,0,19.59190606,0.6717572755,0.1507120743,4.65,301.836,11689.00977,15721.05957,7947.100098,7348.120117,3328.389893,59808.96875,20581.59961,94.45560028,109.1686577,96.42528112,110.2901313,97.31050034,104.2091581,90.41184261,42.97564331,-1.084048375,-0.321233207,-0.762815168,2.658573151,96.77790139,9342720400,41.83675925,21.22320483,18.48999977,Guide to Artificial Intelligence ETFs,The recent success of Chart GPT made the AI space an intriguing investing area. IDC expects the AI market to maintain a year-over-year growth rate in the high teens throughout the five-year forecast.,https://www.zacks.com/stock/news/2061702/guide-to-artificial-intelligence-etfs,zacks.com,8,recent success chart gpt made ai space intriguing investing area idc expects ai market maintain yearoveryear growth rate high teen throughout fiveyear forecast,0.743,0.5944,0.04315,0.55125,Positive Impact
06/03/2023,95.19,96.55,93.74,93.75,93.75,52112400,2.95,51.45734626,1.192,0,19.59190606,0.6717572755,0.1507120743,4.65,301.836,11675.74023,15694.33984,7929.799805,7373.209961,3322.030029,60224.46094,20514.80078,94.62680023,109.0605652,96.32036814,110.1255529,96.82850037,103.2706297,90.38637098,34.35981774,-1.112603698,-0.479507305,-0.633096393,2.661430904,90.38999939,9290608000,31.16884036,29.71552782,18.61000061,U.S. opens probe into Amazon's Zoox robotaxi self-certification,U.S. auto safety regulators said Monday they are opening a probe into Amazon unit Zoox self-certification in 2022 of a robotaxi without traditional driving controls.,https://www.reuters.com/legal/us-opens-probe-into-amazons-zoox-robotaxi-self-certification-2023-03-06/,reuters.com,10,u auto safety regulator said monday opening probe amazon unit zoox selfcertification robotaxi without traditional driving control,0.5423,0.5423,0.11728,0.42502,Positive Impact
07/03/2023,94.06,95.09,92.78,93.55,93.55,49100700,2.95,51.45734626,1.192,0,19.59190606,0.6717572755,0.1507120743,4.65,301.836,11530.33008,15439.01953,7919.5,7339.27002,3285.100098,60224.46094,20275.5,94.76240036,108.9927527,96.21172637,109.9606221,96.3970005,102.4757131,90.31828791,33.42321341,-1.13825103,-0.61125605,-0.52699498,2.583573478,90.51319946,9241507300,29.31358089,34.1063935,19.59000015,Amazon worker loses bid for California class action over remote work expenses,"Amazon.com Inc on Tuesday defeated a proposed class action lawsuit on behalf of nearly 7,000 workers California that claimed the company should have reimbursed employees who worked remotely during the COVID-19 pandemic for home office expenses.",https://www.reuters.com/legal/amazon-worker-loses-bid-california-class-action-over-remote-work-expenses-2023-03-07/,reuters.com,10,amazoncom inc tuesday defeated proposed class action lawsuit behalf nearly worker california claimed company reimbursed employee worked remotely covid pandemic home office expense,-0.6124,-0.6124,0.2073875,-0.8197875,Negative Impact
08/03/2023,93.6,94.17,92.18,93.92,93.92,44899100,2.95,51.45734626,1.192,0,19.59190606,0.6717572755,0.1507120743,4.65,301.836,11576,15440.63965,7929.899902,7324.759766,3283.25,60348.08984,20346.5,94.96500031,108.9257577,96.12185468,109.8010139,95.98750038,101.5251117,90.44988906,29.266888,-1.115858292,-0.712176498,-0.403681793,2.531430381,90.63393553,9286406400,34.47265152,31.65169092,19.11000061,Amazon Attempts To Bounce In A Pattern: Is A Bullish Break On The Horizon?,"With inflation remaining stubbornly high and the chances of a recession increasing with each of the Federal Reserve's rate hikes, Amazon.com, Inc AMZN continues to cut costs, this time by deciding to close eight Amazon Go stores.",https://www.benzinga.com/trading-ideas/long-ideas/23/03/31261992/amazon-attempts-to-bounce-in-a-pattern-is-a-bullish-break-on-the-horizon?SNAPI,benzinga.com,5,inflation remaining stubbornly high chance recession increasing federal reserve rate hike amazoncom inc amzn continues cut cost time deciding close eight amazon go store,-0.5574,-0.2787,0.2307029412,-0.509402941,Negative Impact
09/03/2023,93.68,96.21,92.18,92.25,92.25,56218700,2.95,51.45734626,1.192,0,19.59190606,0.6717572755,0.1507120743,4.65,301.836,11338.34961,15140.79004,7880,7315.879883,3276.090088,59806.28125,20086.69922,95.10500031,108.8490527,95.97001724,109.6263769,95.59750023,101.0280646,90.16693586,31.69975025,-1.218817017,-0.813504602,-0.405312415,2.600715637,90.75225689,9230187700,24.63575972,29.47399738,22.61000061,The 7 Best Tech Stocks to Buy in March,"The tech sphere was among the worst hit last year for obvious reasons. The sector, known for having inflated valuations and low earnings, led to tech stocks cooling off.",https://investorplace.com/2023/03/the-7-best-tech-stocks-to-buy-in-march/,investorplace.com,6,tech sphere among worst hit last year obvious reason sector known inflated valuation low earnings led tech stock cooling,-0.7351,-0.44106,0.132398,-0.573458,Negative Impact
10/03/2023,92.67,93.57,90.25,90.73,90.73,69827500,2.95,51.45734626,1.192,0,19.59190606,0.6717572755,0.1507120743,4.65,301.836,11138.88965,14894.17969,7748.399902,7220.669922,3230.080078,59135.12891,19774.90039,95.25880035,108.7649177,95.7645265,109.4383533,95.2220005,100.9154339,89.52856715,30.61714918,-1.406846326,-0.932172947,-0.474673379,2.659287044,96.55000305,9160360200,7.100639131,22.06968346,24.79999924,Want a Stock That Can Double? Focus on Free Cash Flow,Free cash flow tells you how truly profitable a business is. Look for stocks with positive free cash flow that's growing robustly and an attractive free cash flow yield.,https://www.fool.com/investing/2023/03/10/want-a-stock-that-can-double-focus-on-free-cash-fl/,fool.com,7,free cash flow tell truly profitable business look stock positive free cash flow thats growing robustly attractive free cash flow yield,0.9716,0.68012,0.5173766667,0.1627433333,Positive Impact
13/03/2023,89.97,94.02,88.12,92.43,92.43,72397100,2.95,51.45734626,1.192,0,19.59190606,0.6717572755,0.1507120743,4.65,301.836,11188.83984,14764.37012,7548.600098,7011.5,3268.699951,58237.85156,19588.90039,95.47100037,108.7065677,95.63376076,109.2691159,94.96300049,100.6703037,89.25569729,43.18325306,-1.402518007,-1.026241959,-0.376276048,2.871429443,96.42400299,9232757300,48.48141569,26.73927151,26.52000046,Should You Stop Investing Right Now? Here's Warren Buffett's Advice.,"Silicon Valley Bank's recent collapse has many investors on edge. Also, with continued recession concerns, it may be tempting to stop investing for now.",https://www.fool.com/investing/2023/03/13/stop-investing-now-warren-buffett-advice/,fool.com,7,silicon valley bank recent collapse many investor edge also continued recession concern may tempting stop investing,-0.802,-0.5614,0.231245,-0.792645,Negative Impact
14/03/2023,93.83,95.07,92.71,94.88,94.88,60912700,2.95,51.45734626,1.192,0,19.59190606,0.6717572755,0.1507120743,4.65,301.836,11428.15039,14944.74023,7637.100098,7141.569824,3245.310059,57900.19141,19694.19922,95.68500031,108.6470927,95.60420141,109.1259406,94.73000031,100.01544,89.4445606,47.32509125,-1.187702411,-1.058534049,-0.129168362,2.886429378,96.09184298,9293670000,80.18973027,45.2572617,23.72999954,How Profitable Could Amazon Really Be?,"Amazon has historically reinvested all profits, leaving investors uncertain over how profitable the underlying e-commerce giant really is. Amazon tried to maximize profits just once, back in 2004.",https://www.fool.com/investing/2023/03/14/heres-how-profitable-amazon-could-be-if-it-wanted/,fool.com,7,amazon historically reinvested profit leaving investor uncertain profitable underlying ecommerce giant really amazon tried maximize profit back,0.836,0.5852,0.117789,0.467411,Positive Impact
15/03/2023,93.22,96.67,93.07,96.20,96.20,70731800,2.95,51.45734626,1.192,0,19.59190606,0.6717572755,0.1507120743,4.65,301.836,11434.0498,14662.5498,7344.5,6885.709961,3263.310059,57555.89844,19378.80078,95.92900024,108.5727052,95.62756594,108.9973243,94.55500031,99.35725679,89.75274382,51.03824412,-0.900565402,-1.02694032,0.1263749177,2.946429116,88.12000275,9364401800,94.50290676,74.39135091,26.13999939,"1 Reason to Avoid the Stock Market, and 3 Great Reasons to Invest","The market has been shaky over the past year, which can be intimidating. In most cases, it's smart to continue investing despite volatility.",https://www.fool.com/investing/2023/03/15/1-reason-avoid-stock-market-and-reasons-to-invest/,fool.com,7,market shaky past year intimidating case smart continue investing despite volatility,-0.2732,-0.19124,0.20437375,-0.39561375,Negative Impact
16/03/2023,95.75,100.99,95.61,100.04,100.04,84446900,2.95,51.45734626,1.192,0,19.59190606,0.6717572755,0.1507120743,4.65,301.836,11717.28027,14830.98047,7410,7025.720215,3226.889893,57634.83984,19539,96.21340027,108.4971727,95.80060261,108.9081967,94.49900017,98.99319202,90.00480832,66.49848894,-0.359012553,-0.893354767,0.5343422136,3.080714634,88.29100266,9448848700,92.61851353,89.10371685,22.98999977,Twitch CEO Emmett Shear to step down,Amazon.com Inc-owned Twitch's Chief Executive Officer Emmett Shear said on Thursday he will resign from the role at the live video streaming company.,https://www.reuters.com/technology/twitch-ceo-emmett-shear-step-down-2023-03-16/,reuters.com,10,amazoncom incowned twitch chief executive officer emmett shear said thursday resign role live video streaming company,-0.34,-0.34,0.2379245455,-0.577924545,Negative Impact
17/03/2023,99.79,100.66,97.46,98.95,98.95,87300200,2.95,51.45734626,1.192,0,19.59190606,0.6717572755,0.1507120743,4.65,301.836,11630.50977,14599.0498,7335.399902,6925.399902,3250.550049,57989.89844,19387.69922,96.48960022,108.3908751,95.92410827,108.8091101,94.53899994,99.18179682,89.89620306,62.56657247,-0.017579582,-0.71819973,0.7006201473,3.192143576,88.79896246,9361548500,84.14917102,90.42353044,25.51000023,Could Shopify Really Partner With Amazon?,Shopify is talking with Amazon to add Buy with Prime to its platform. Analysts identify Buy with Prime as a threat to Shopify's business.,https://www.fool.com/investing/2023/03/17/could-shopify-really-partner-with-amazon/,fool.com,7,shopify talking amazon add buy prime platform analyst identify buy prime threat shopifys business,-0.4019,-0.28133,0.12414,-0.40547,Negative Impact
20/03/2023,98.41,98.48,95.70,97.71,97.71,62388900,2.95,51.45734626,1.192,0,19.59190606,0.6717572755,0.1507120743,4.65,301.836,11675.54004,14777.7002,7403.899902,7013.140137,3234.909912,57628.94922,19519.40039,96.78140015,108.2710051,95.9941432,108.6986712,94.56450005,99.27395859,89.8550415,58.12324002,0.1512080103,-0.544318182,0.6955261921,3.297857557,89.28660388,9299159600,74.51437433,83.76068629,24.14999962,Big Tech's Cuts Now Hitting Growth Areas,Amazon laying off Amazon Web Services workers shows the efficiency drive is now affecting growth areas.,https://www.wsj.com/articles/big-techs-cuts-now-hitting-growth-areas-ab9eef9f,wsj.com,9,amazon laying amazon web service worker show efficiency drive affecting growth area,0.7579,0.68211,0.09251633333,0.5895936667,Positive Impact
21/03/2023,98.14,100.85,98.00,100.61,100.61,58597300,2.95,51.45734626,1.192,0,19.59190606,0.6717572755,0.1507120743,4.65,301.836,11860.11035,14985.9502,7536.200195,7112.910156,3255.649902,58074.67969,19654.90039,97.07200012,108.1465001,96.17515722,108.6181869,94.86599998,100.2965188,89.43548113,68.95778195,0.5130649866,-0.332841548,0.8459065347,3.301428659,89.75473964,9357756900,97.04741727,85.23698754,21.37999916,"Meta Wins Upgrade. It's Safer in a Downturn than Alphabet or Amazon, Analyst Says.",Analysts at Morgan Stanley raised their rating on the social media stock to Overweight from Equal Weight.,https://www.barrons.com/articles/meta-stock-amazon-alphabet-upgrade-1b6f6205,barrons.com,9,analyst morgan stanley raised rating social medium stock overweight equal weight,-0.3612,-0.32508,0.222790625,-0.547870625,Negative Impact
22/03/2023,100.45,102.10,98.61,98.70,98.70,57475400,2.95,51.45734626,1.192,0,19.59190606,0.6717572755,0.1507120743,4.65,301.836,11669.95996,14741.08008,7566.799805,7131.120117,3265.75,58214.58984,19532.80078,97.29880005,108.0282501,96.27417054,108.5194985,95.01149979,100.6962419,89.32675765,63.61375972,0.6383593057,-0.138601377,0.776960683,3.419285366,90.20414997,9300281500,75.67952386,82.41377182,22.26000023,"Amazon launches new Fire devices, including $200 option","Amazon.com Inc. AMZN, -0.67% on Wednesday said it is expanding its Fire TV line with new sizes of the high-end Fire TV Omni QLED Series and a $200 option called the Fire TV 2-Series. The retail giant also announced it has sold more than 200 million Fire TV devices.",https://www.marketwatch.com/story/amazon-launches-new-fire-devices-including-200-option-d0f7a1c,marketwatch.com,8,amazoncom inc amzn wednesday said expanding fire tv line new size highend fire tv omni qled series option called fire tv series retail giant also announced sold million fire tv device,-0.8225,-0.658,0.09574277778,-0.753742778,Negative Impact
23/03/2023,100.43,101.06,97.62,98.71,98.71,57559300,2.95,51.45734626,1.192,0,19.59190606,0.6717572755,0.1507120743,4.65,301.836,11787.40039,14693.01953,7499.600098,7139.25,3286.649902,57925.28125,19459.90039,97.47559998,107.8978501,96.36969323,108.4218915,95.15599976,101.0695883,89.24241125,58.91436226,0.7300475118,0.03512840048,0.6949191113,3.464284624,90.91790088,9357840800,75.75106992,82.82600368,22.61000061,Panera Bread to start using handprints to greet you by name and suggest menu items,"Panera Bread will use Amazon's palm-scanning technology to broaden its loyalty program, greet customers by name, and suggest menu items.",https://www.businessinsider.com/panera-bread-employ-palm-scanning-technology-stores-2023-3,businessinsider.com,7,panera bread use amazon palmscanning technology broaden loyalty program greet customer name suggest menu item,0.7579,0.53053,0.04005090909,0.4904790909,Positive Impact
24/03/2023,98.07,98.30,96.40,98.13,98.13,56095400,2.95,51.45734626,1.192,0,19.59190606,0.6717572755,0.1507120743,4.65,301.836,11823.95996,14758.57031,7405.5,7015.100098,3265.649902,57527.10156,19501.5,97.53639999,107.7735001,96.43872476,108.3194846,95.38749962,101.3899639,89.3850353,60.52884187,0.7472954188,0.1775618041,0.5697336147,3.428569794,91.58882673,9301745400,71.60227157,74.34428845,21.73999977,"Deutsche Bank, Amazon, GameStop: Stocks That Defined the Week",Here are seven major companies whose stocks moved on the week's news.,https://www.wsj.com/articles/deutsche-bank-amazon-com-gamestop-stocks-that-defined-the-week-a5c91acc,wsj.com,9,seven major company whose stock moved week news,0,0,0.3443583333,-0.344358333,Negative Impact
27/03/2023,99.07,99.34,97.08,98.04,98.04,46721300,2.95,51.45734626,1.192,0,19.59190606,0.6717572755,0.1507120743,4.65,301.836,11768.83984,14894.84961,7471.799805,7078.27002,3251.399902,57653.85938,19624.69922,97.59180008,107.6578001,96.5015199,108.2172012,95.60149956,101.6645297,89.53846939,60.85065005,0.7451133541,0.2910721141,0.45404124,3.424998147,92.21949704,9255024100,70.95852075,72.77062075,20.60000038,Amazon seller consultant admits to bribing employees to help clients; will plead guilty,"In 2020, federal officials charged six individuals, including Ephraim Rosenberg, with conspiracy to commit bribery.",https://www.cnbc.com/2023/03/27/amazon-seller-consultant-admits-to-bribing-employees-to-help-clients.html,cnbc.com,9,federal official charged six individual including ephraim rosenberg conspiracy commit bribery,-0.4588,-0.41292,0.12487125,-0.53779125,Negative Impact
28/03/2023,98.11,98.44,96.29,97.24,97.24,38720100,2.95,51.45734626,1.192,0,19.59190606,0.6717572755,0.1507120743,4.65,301.836,11716.08008,14949.34961,7484.299805,7088.339844,3245.379883,57613.71875,19657.5,97.57419998,107.5632501,96.53047982,108.1079753,95.75199928,101.8211146,89.68288399,57.85984674,0.6710945317,0.3670765977,0.3040179341,3.43642698,92.81232712,9216304000,65.23603651,69.26560961,19.96999931,It's The Best Time In 20 Years To Buy These World-Beater Blue Chips,"The regional banking crisis is likely to push the U.S. into a recession, but a mild to average one. There is no evidence of a brewing financial crisis. Ignore doomsday prophets like Robert Kiyosaki, whose advice has been disastrous for over a decade.",https://seekingalpha.com/article/4589385-its-the-best-time-in-20-years-to-buy-these-world-beater-blue-chips,seekingalpha.com,6,regional banking crisis likely push u recession mild average one evidence brewing financial crisis ignore doomsday prophet like robert kiyosaki whose advice disastrous decade,-0.9623,-0.57738,0.2509884211,-0.828368421,Negative Impact
29/03/2023,98.69,100.42,98.56,100.25,100.25,49783300,2.95,51.45734626,1.192,0,19.59190606,0.6717572755,0.1507120743,4.65,301.836,11926.24023,15123.95996,7564.299805,7186.990234,3240.060059,57960.08984,19837.69922,97.65819992,107.5162501,96.67634336,108.0297865,96.15599937,102.2964471,90.01555161,67.80943368,0.8455689065,0.4627750594,0.382793847,3.375712803,93.36958741,9266087300,86.7668166,74.32045795,19.12000084,Amazon Eyes AMC: A Blockbuster Move in the Making,"Amazon's rumored acquisition of AMC Theatres could potentially revitalize the struggling cinema industry, paving the way for a reimagined movie-going experience.",https://thedogofwallstreet.com/amzn/amazon-eyes-amc-a-blockbuster-move-in-the-making?SNAPI,thedogofwallstreet.com,5,amazon rumored acquisition amc theatre could potentially revitalize struggling cinema industry paving way reimagined moviegoing experience,-0.2732,-0.1366,0.3115042857,-0.448104286,Negative Impact
30/03/2023,101.55,103.04,101.01,102.00,102.00,53633400,2.95,51.45734626,1.192,0,19.59190606,0.6717572755,0.1507120743,4.65,301.836,12013.46973,15200.58984,7620.399902,7263.370117,3261.25,57960.08984,19941,97.78899994,107.5079001,96.88511421,107.9697886,96.64949951,103.0101023,90.28889673,74.83471054,1.112230381,0.5926661237,0.519564257,3.337855748,93.89341207,9319720700,93.02948362,81.67744558,19.02000046,Nasdaq-100 Enters Bull Market: ETFs to Ride on,"After being badly beaten down in February, the Nasdaq-100 Index soared in recent weeks. The flight to mega-cap cash-rich technology stocks amid the latest bank turbulence buoyed the index.",https://www.zacks.com/stock/news/2072493/nasdaq-100-enters-bull-market-etfs-to-ride-on,zacks.com,8,badly beaten february nasdaq index soared recent week flight megacap cashrich technology stock amid latest bank turbulence buoyed index,-0.7096,-0.56768,0.229459,-0.797139,Negative Impact
31/03/2023,102.16,103.49,101.95,103.29,103.29,56750300,2.95,51.45734626,1.192,0,19.59190606,0.6717572755,0.1507120743,4.65,301.836,12221.91016,15374.91016,7631.700195,7322.390137,3272.860107,58991.51953,20099.90039,97.98119995,107.5128001,97.13628624,107.9232235,97.06899948,104.0228009,90.11519806,74.37161977,1.411384254,0.7564097497,0.6549745042,3.026427678,94.62513918,9376471000,98.14474053,92.64701358,18.70000076,5 Bargain-Basement Stocks to Buy Right Now,"These stocks all have suffered in recent times, but the long-term growth picture remains bright for each one. Buying on the dip and holding for at least five years is a great way to benefit.",https://www.fool.com/investing/2023/03/31/5-bargain-basement-stocks-to-buy-right-now/,fool.com,7,stock suffered recent time longterm growth picture remains bright one buying dip holding least five year great way benefit,0.8555,0.59885,0.1948755556,0.4039744444,Positive Impact
03/04/2023,102.3,103.29,101.43,102.41,102.41,41135700,2.95,51.45734626,1.192,0,19.59190606,0.6717572755,0.1507120743,4.83,303.363,12189.4502,15487.75977,7673,7345.959961,3296.399902,59106.44141,20278.30078,98.08440002,107.4865001,97.34309868,107.8683656,97.50199966,104.6610751,90.34292419,68.17962625,1.559480707,0.9170239411,0.6424567658,2.970713479,95.51162505,9335335300,89.63537052,93.60319823,18.54999924,7 Entertainment Stocks That Could Boom in a Downturn,"While the concept of entertainment stocks to buy during an economic downturn might seem odd if not outrageously risky, there's a method to the madness. Fundamentally, we humans can't go full-bore under a constant load of stress.",https://investorplace.com/2023/04/7-entertainment-stocks-that-could-boom-in-a-downturn/,investorplace.com,6,concept entertainment stock buy economic downturn might seem odd outrageously risky there method madness fundamentally human cant go fullbore constant load stress,-0.802,-0.4812,0.1955275,-0.6767275,Negative Impact
04/04/2023,102.75,104.20,102.11,103.95,103.95,48662500,2.95,51.45734626,1.192,0,19.59190606,0.6717572755,0.1507120743,4.83,303.363,12126.33008,15374.11035,7634.5,7344.959961,3312.560059,59106.44141,20275.80078,98.21300003,107.4879501,97.60219273,107.8293769,98.02199936,105.4771158,90.56688291,68.51408758,1.780587299,1.089736613,0.6908506862,2.862856184,96.30946233,9383997800,97.08963787,94.95658298,19,"Amazon Announces its Latest Advances in Counterfeit Protection for Customers, Brands, and Selling Partners","SEATTLE--(BUSINESS WIRE)--Amazon (NASDAQ: AMZN) today released its third annual Brand Protection Report, highlighting how the company's efforts to protect customers, brands, and selling partners from counterfeit products has resulted in more criminal referrals and industry partnerships than ever before.",https://www.businesswire.com/news/home/20230403005747/en/Amazon-Announces-its-Latest-Advances-in-Counterfeit-Protection-for-Customers-Brands-and-Selling-Partners/,businesswire.com,5,seattlebusiness wireamazon nasdaq amzn today released third annual brand protection report highlighting company effort protect customer brand selling partner counterfeit product resulted criminal referral industry partnership ever,-0.2023,-0.10115,0.2338,-0.33495,Negative Impact
05/04/2023,103.91,103.91,100.75,101.10,101.10,45175400,2.95,51.45734626,1.192,0,19.59190606,0.6717572755,0.1507120743,4.83,303.363,11996.86035,15368.25977,7662.899902,7316.299805,3312.560059,59689.30859,20159.59961,98.30860001,107.4623501,97.73936159,107.7624179,98.38099937,105.6945651,91.0674336,52.65796747,1.70617706,1.213024702,0.4931523582,2.707141876,97.25632648,9338822400,63.52942972,83.41814604,19.07999992,"Microsoft, Amazon face cloud competition probe as UK regulator raises alarm",Microsoft and Amazon were accused by U.K. regulators Wednesday of unfairly restricting competition in the cloud services market.,https://www.cnbc.com/2023/04/05/microsoft-amazon-make-it-harder-to-switch-cloud-uk-watchdog-says.html,cnbc.com,9,microsoft amazon accused uk regulator wednesday unfairly restricting competition cloud service market,-0.4767,-0.42903,0.23252,-0.66155,Negative Impact
06/04/2023,100.75,102.38,99.80,102.06,102.06,43808000,2.95,51.45734626,1.192,0,19.59190606,0.6717572755,0.1507120743,4.83,303.363,12087.95996,15379.12988,7741.600098,7324.75,3312.629883,59832.96875,20196.69922,98.40619995,107.4292501,97.90879829,107.7056774,98.87149925,105.7570789,91.98591963,57.84957343,1.705015951,1.311422952,0.393592999,2.662855421,98.08956694,9382630400,74.82353659,78.48086806,18.39999962,From FAANG To FANG?: Economic Clarity Sought,OPEC's production cut announcement struck the market early in the week but gave way to general uncertainty. Permian Basin oil will be influencing the global benchmark Brent given its inclusion as a Dated Brent constituent.,https://seekingalpha.com/article/4592681-from-faang-to-fang-economic-clarity-sought,seekingalpha.com,6,opec production cut announcement struck market early week gave way general uncertainty permian basin oil influencing global benchmark brent given inclusion dated brent constituent,-0.6705,-0.4023,0.103396,-0.505696,Negative Impact
10/04/2023,100.96,102.20,99.57,102.17,102.17,37261200,2.95,51.45734626,1.192,0,19.59190606,0.6717572755,0.1507120743,4.83,303.363,12084.36035,15427.17969,7741.600098,7324.75,3315.360107,59846.51172,20275.80078,98.46519989,107.3953501,98.07590417,107.650596,99.44349899,105.3060599,93.58093807,61.93789885,1.693450846,1.387828531,0.3056223152,2.61856951,98.82281854,9419891600,74.33628575,70.89641735,18.96999931,Amazon Charging New Fees on Some Returns,Amazon customers will reportedly be charged a fee for some returns to UPS Stores.,https://www.pymnts.com/amazon/2023/amazon-charging-new-fees-on-some-returns/?SNAPI,pymnts.com,5,amazon customer reportedly charged fee return ups store,-0.0258,-0.0129,0.3342354545,-0.347135455,Negative Impact
11/04/2023,100.8,101.00,99.01,99.92,99.92,60417800,2.95,51.45734626,1.192,0,19.59190606,0.6717572755,0.1507120743,4.83,303.363,12031.87988,15520.91992,7785.700195,7390.279785,3313.570068,60157.71875,20421.90039,98.4187999,107.3327501,98.14822158,107.5736746,99.81799889,104.6627156,94.97328213,48.08651556,1.485604102,1.407383645,0.07822045676,2.619997842,104.1999969,9359473800,45.89126516,65.01702917,19.10000038,Amazon's Whole Foods closes flagship downtown San Francisco store after just one year over 'safety concerns',Whole Foods Market has closed its flagship supermarket in downtown San Francisco just one year after opening due to safety concerns. The organic food giant opened the Trinity Place store in San Francisco's Tenderloin district in March 2022 after two years of strict coronavirus (COVID-19) restrictions severely impacted businesses in the area.,https://www.proactiveinvestors.com/companies/news/1011732?SNAPI,proactiveinvestors.com,5,whole food market closed flagship supermarket downtown san francisco one year opening due safety concern organic food giant opened trinity place store san franciscos tenderloin district march two year strict coronavirus covid restriction severely impacted business area,-0.2732,-0.1366,0.350112,-0.486712,Negative Impact
12/04/2023,100.4,100.51,97.71,97.83,97.83,56735000,2.95,51.45734626,1.192,0,19.59190606,0.6717572755,0.1507120743,4.83,303.363,11929.33984,15500.92969,7824.799805,7396.939941,3327.179932,60392.76953,20454.30078,98.36439987,107.2396001,98.13574237,107.4767227,99.96549911,104.3333657,95.59763253,47.61121492,1.139107895,1.353728495,-0.2146206,2.570712498,104.0961971,9302738800,19.46904789,46.56553293,19.09000015,"Amazon workers seriously injured at more than twice the rate of other warehouses, study finds","In 2022, Amazon warehouse workers suffered serious injuries at more than twice the rate of all comparable facilities, according to the Strategic Organizing Center.",https://www.cnbc.com/2023/04/12/study-amazon-workers-seriously-hurt-at-twice-rate-of-other-warehouses.html,cnbc.com,9,amazon warehouse worker suffered serious injury twice rate comparable facility according strategic organizing center,-0.6808,-0.61272,0.2365315385,-0.849251538,Negative Impact
13/04/2023,98.95,102.57,98.71,102.40,102.40,67925100,2.95,51.45734626,1.192,0,19.59190606,0.6717572755,0.1507120743,4.83,303.363,12166.26953,15630.88965,7843.399902,7480.830078,3318.360107,60431,20564.5,98.34979996,107.1855001,98.30296822,107.426208,100.2754993,104.3908754,96.16012329,58.10277607,1.219213602,1.326825516,-0.107611915,2.663569859,103.8407491,9370663900,77.2440414,47.53478482,17.79999924,Amazon shareholders introduce record number of proposals for second-consecutive year,"E-retail giant Amazon is facing 18 shareholder proposals, beating its 2022 record of 15 proposals, as environmental, social and governance (ESG)-focused investors push for more changes in the company, according to Amazons' proxy statement released on Thursday.",https://www.reuters.com/business/sustainable-business/amazon-shareholders-introduce-record-number-proposals-second-consecutive-year-2023-04-13/,reuters.com,10,eretail giant amazon facing shareholder proposal beating record proposal environmental social governance esgfocused investor push change company according amazon proxy statement released thursday,-0.1531,-0.1531,0.3241324,-0.4772324,Negative Impact
14/04/2023,102.07,103.20,101.11,102.51,102.51,51450500,2.95,51.45734626,1.192,0,19.59190606,0.6717572755,0.1507120743,4.83,303.363,12123.46973,15601.78027,7871.899902,7519.609863,3338.149902,60431,20579.90039,98.29699997,107.1610501,98.46794995,107.3772906,100.3989994,104.6312072,96.16679161,59.82064413,1.276855288,1.316831471,-0.039976182,2.647855486,103.5955191,9422114400,78.63469457,58.44926129,17.06999969,"Amazon launches Bedrock for generative AI, escalating AI cloud wars","Yesterday Amazon dropped a Bedrock on the generative AI space, a landscape-shaking move that also escalated the cloud AI wars that have been heating up over the past year.",https://venturebeat.com/ai/amazon-launches-bedrock-for-generative-ai-escalating-ai-cloud-wars/,venturebeat.com,5,yesterday amazon dropped bedrock generative ai space landscapeshaking move also escalated cloud ai war heating past year,-0.4939,-0.24695,0.1758253846,-0.422775385,Negative Impact
17/04/2023,103.16,103.73,101.59,102.74,102.74,39919500,2.95,51.45734626,1.192,0,19.59190606,0.6717572755,0.1507120743,4.83,303.363,12157.71973,15668.33984,7879.5,7498.180176,3385.610107,59910.75,20642,98.09359985,107.1301501,98.63548124,107.3311483,100.5884995,104.8864176,96.29058126,60.47236995,1.325812334,1.318627643,0.007184690682,2.639284951,97.70999908,9462033900,81.54235377,79.14036325,16.95000076,Amazon Stock: Here's Why the Tech Giant Could Be Dead Money in 2023,"As a cyclical business, Amazon tends to struggle in recessions. Amazon Web Services is facing short-term headwinds.",https://www.fool.com/investing/2023/04/17/amazon-stock-heres-why-the-tech-giant-could-be-dea/,fool.com,7,cyclical business amazon tends struggle recession amazon web service facing shortterm headwind,-0.4019,-0.28133,0.1962091667,-0.477539167,Negative Impact
18/04/2023,103.95,104.20,101.52,102.30,102.30,39790500,2.95,51.45734626,1.192,0,19.59190606,0.6717572755,0.1507120743,4.83,303.363,12153.41016,15684.95996,7909.399902,7533.629883,3393.330078,59727.01172,20684.69922,98.07179993,107.1106001,98.77918797,107.2810872,100.8179996,104.9559511,96.68004816,61.45835601,1.31396072,1.317694259,-0.003733539,2.677142007,97.83039917,9422243400,70.72427547,76.96710794,16.82999992,Amazon lays off some employees in its advertising unit,"The layoffs are part of the previously announced job cuts that are expected to affect 9,000 employees.",https://www.cnbc.com/2023/04/18/amazon-layoffs-company-lets-go-of-some-employees-in-advertising.html,cnbc.com,9,layoff part previously announced job cut expected affect employee,-0.2732,-0.24588,0.2194728571,-0.465352857,Negative Impact
19/04/2023,101.58,105.12,101.39,104.30,104.30,58398900,2.95,51.45734626,1.192,0,19.59190606,0.6717572755,0.1507120743,4.83,303.363,12157.23047,15653.62012,7898.799805,7549.439941,3370.129883,59567.80078,20680.80078,98.11419998,107.0843001,98.99569053,107.2514247,101.0024998,105.4209498,96.58404969,59.61083889,1.449245516,1.34400451,0.1052410056,2.716427939,98.08518308,9480642300,88.93388273,80.40017066,16.45999908,Amazon is laying off workers in its advertising business: CNBC,"Amazon.com Inc. AMZN, -0.43% on Tuesday started to lay off workers in its advertising unit, CNBC reported, citing a memo to staffers sent by Paul Kotas, senior VP for advertising, IMDb and Grand Challenge. ÃÂÃÂAs Andy (Jassy, CEO) shared a few weeks ago, throughout the 2023 planning process, we've been scrupulously prioritizing resources with an eye toward maximizing benefits to customers and the long-term health of our business,ÃÂÃÂ Kotas wrote.",https://www.marketwatch.com/story/amazon-is-laying-off-workers-in-its-advertising-business-cnbc-f18484b2,marketwatch.com,8,amazoncom inc amzn tuesday started lay worker advertising unit cnbc reported citing memo staffer sent paul kota senior vp advertising imdb grand challenge andy jassy ceo shared week ago throughout planning process weve scrupulously prioritizing resource eye toward maximizing benefit customer longterm health business kota wrote,0.8271,0.66168,0.116245,0.545435,Positive Impact
20/04/2023,103.53,105.25,103.21,103.81,103.81,57696900,2.95,51.45734626,1.192,0,19.59190606,0.6717572755,0.1507120743,4.83,303.363,12059.55957,15582.94043,7902.600098,7538.709961,3367.030029,59632.35156,20630.69922,98.14819992,107.0358501,99.18448688,107.2171816,101.2579998,105.7067193,96.80928031,54.56839772,1.499633501,1.375130308,0.124503193,2.662856511,98.50727226,9422945400,80.9018267,80.18666164,17.17000008,Amazon to expand office supplies business after pandemic sales boost in Europe,Amazon plans to expand its business selling office supplies in Europe and internationally after the pandemic helped boost sales as companies shopped more online and looked for bulk discounts.,https://www.reuters.com/business/retail-consumer/amazon-expand-office-supplies-business-after-pandemic-sales-boost-europe-2023-04-20/,reuters.com,10,amazon plan expand business selling office supply europe internationally pandemic helped boost sale company shopped online looked bulk discount,0.6908,0.6908,0.191668,0.499132,Positive Impact
21/04/2023,106.1,108.15,105.08,106.96,106.96,86774200,2.95,51.45734626,1.192,0,19.59190606,0.6717572755,0.1507120743,4.83,303.363,12072.45996,15578.92969,7914.100098,7577,3301.26001,59655.05859,20693.19922,98.28639984,106.9990001,99.48940893,107.2146226,101.6704998,106.6255634,96.7154362,58.46793046,1.7733036,1.454764967,0.3185386336,2.862856729,99.04669048,9509719600,88.60151185,86.14574043,16.77000046,Amazon defeats consumer antitrust lawsuit over fulfillment centers,"Amazon.com Inc on Thursday defeated a private lawsuit in Seattle federal court that accused the national retailer of a scheme to curb competition for shipping and fulfillment services, causing consumers to pay more for purchases in violation of U.S. antitrust law.",https://www.reuters.com/legal/amazon-defeats-consumer-antitrust-lawsuit-over-fulfillment-centers-2023-04-21/,reuters.com,10,amazoncom inc thursday defeated private lawsuit seattle federal court accused national retailer scheme curb competition shipping fulfillment service causing consumer pay purchase violation u antitrust law,-0.8689,-0.8689,0.1711995238,-1.040099524,Negative Impact
24/04/2023,107.66,109.23,105.07,106.21,106.21,69575600,2.95,51.45734626,1.192,0,19.59190606,0.6717572755,0.1507120743,4.83,303.363,12037.2002,15606.70996,7912.200195,7573.859863,3275.409912,60056.10156,20676.69922,98.44579987,106.9484001,99.75296148,107.2046263,102.0744999,107.1306621,97.0183377,58.82079376,1.907679848,1.545347943,0.3623319048,3.027142661,99.95702158,9440144000,73.78469486,81.09601114,16.88999939,"Wall Street Headlines, International Investing, and Stocks to Watch","The ""Motley Fool Money"" crew kicks things off with a look at what's going on with Netflix.",https://www.fool.com/investing/2023/04/24/wall-street-headlines-international-investing-and/,fool.com,7,motley fool money crew kick thing look whats going netflix,-0.4404,-0.30828,0.3463426316,-0.654622632,Negative Impact
25/04/2023,104.91,105.45,102.45,102.57,102.57,65026800,2.95,51.45734626,1.192,0,19.59190606,0.6717572755,0.1507120743,4.83,303.363,11799.16016,15363.53027,7891.100098,7531.609863,3264.870117,60130.71094,20439.90039,98.54499985,106.8835501,99.86343357,107.1585106,102.3009998,106.988609,97.61339063,47.08122307,1.70085012,1.576448379,0.124401742,3.146428789,101.0697794,9375117200,42.18748965,68.19123212,18.76000023,You Won't Believe What Amazon's CEO Just Said About Its Stock Price,"Amazon's stock is well off its all-time high, something shareholders hope can be reversed. Like Bezos, Jassy cares more about the long term, focusing less of his attention on where the stock price is at any given time.",https://www.fool.com/investing/2023/04/25/you-wont-believe-amazons-ceo-said-stock-price/,fool.com,7,amazon stock well alltime high something shareholder hope reversed like bezos jassy care long term focusing less attention stock price given time,0.886,0.6202,0.2959018182,0.3242981818,Positive Impact
26/04/2023,105.04,106.62,104.10,104.98,104.98,73803800,2.95,51.45734626,1.192,0,19.59190606,0.6717572755,0.1507120743,4.83,303.363,11854.34961,15228.58008,7852.600098,7466.660156,3264.100098,60300.57813,20366.69922,98.6537999,106.8497001,100.0640834,107.136834,102.6880001,106.866716,98.50928424,58.36208059,1.711672135,1.60349313,0.1081790051,3.207143511,102.0490063,9448921000,63.10765257,59.69327903,18.84000015,Amazon Supply Chain Lacks Safety Checks In German Law Complaint,"Amazon, Ikea and om Tailor have been accused of ""failure"" under Germany's Supply Chain Act.",https://www.forbes.com/sites/walterloeb/2023/04/26/amazon-supply-chain-lacks-safety-checks-in-german-law-complaint/,forbes.com,8,amazon ikea om tailor accused failure germany supply chain act,-0.5859,-0.46872,0.1987747826,-0.667494783,Negative Impact
27/04/2023,108.16,110.86,106.80,109.82,109.82,149961200,2.95,51.45734626,1.192,0,19.59190606,0.6717572755,0.1507120743,4.83,303.363,12142.24023,15431.63965,7831.600098,7483.839844,3285.879883,60649.37891,20522.59961,98.85619995,106.8527001,100.4466683,107.1635321,103.1665001,108.2610843,98.07191589,64.32792429,2.08674126,1.700142756,0.3865985041,3.442858015,102.4499969,9598882200,92.09124871,65.79546364,17.03000069,Q1 GDP 1.1% Lower than Expected; Jobless Claims Down,"This is the lightest read since we were negative in Q2 2022, and notably down from the final +2.6% GDP from Q4.",https://www.zacks.com/stock/news/2086180/q1-gdp-1-1-lower-than-expected-jobless-claims-down,zacks.com,8,lightest read since negative q notably final gdp q,-0.5719,-0.45752,0.2000537143,-0.657573714,Negative Impact
28/04/2023,107.73,109.48,104.33,105.45,105.45,130565000,2.95,51.45734626,1.192,0,19.59190606,0.6717572755,0.1507120743,4.83,303.363,12226.58008,15545.87988,7870.600098,7491.5,3323.27002,61112.44141,20636.5,98.94199982,106.8279501,100.6428773,107.146482,103.3389999,108.5004717,98.17752819,55.23292783,2.008214102,1.761757025,0.2464570766,3.647143773,103.6273975,9468317200,58.85929251,71.35273126,15.77999973,"Amazon's Cloud Outlook Panicked Investors. Don't Overreact, Analysts Say.",Amazon's mention of slowing revenue growth in its Amazon Web Services unit hit shares hard but analysts see reason to be positive.,https://www.barrons.com/articles/amazon-stock-earnings-aws-microsoft-google-d3f48a03,barrons.com,9,amazon mention slowing revenue growth amazon web service unit hit share hard analyst see reason positive,0.8555,0.76995,0.230582,0.539368,Positive Impact
01/05/2023,104.95,105.23,101.82,102.05,102.05,74728100,2.95,51.45734626,1.192,0,19.59190606,0.6717572755,0.1507120743,5.06,304.127,12212.59961,15535.88965,7870.600098,7491.5,3323.27002,61112.44141,20615.09961,99.01999985,106.7850501,100.6980587,107.0957708,103.277,108.4706396,98.08336046,53.27794017,1.65257976,1.739921572,-0.087341812,3.680715288,110.8600006,9393589100,33.00382862,61.31812328,16.07999992,Big Tech Earnings: Time to Take Another Bite of Apple?,"Earnings season has been in high gear for some time now, with a feared ÃÂÃÂearnings apocalypse' failing to materialize.",https://www.zacks.com/stock/news/2087731/big-tech-earnings-time-to-take-another-bite-of-apple,zacks.com,8,earnings season high gear time feared earnings apocalypse failing materialize,-0.7579,-0.60632,0.13496125,-0.74128125,Negative Impact
02/05/2023,101.47,103.90,101.15,103.63,103.63,73469400,2.95,51.45734626,1.192,0,19.59190606,0.6717572755,0.1507120743,5.06,304.127,12080.50977,15314.88965,7773,7383.200195,3323.27002,61354.71094,20407.59961,99.14859985,106.7354501,100.8130367,107.0612855,103.3379997,108.5174021,98.15859735,59.06816382,1.481155471,1.688168352,-0.207012881,3.677143642,110.6792006,9467058500,40.493807,44.11897605,17.78000069,"Hollywood writers go on strike, saying they face ÃÂÃÂexistential crisis'","Hollywood writers are on strike for the first time in 15 years, halting production of TV shows and movies.",https://www.marketwatch.com/story/hollywood-writers-go-on-strike-saying-they-face-existential-crisis-9e5fe6f8,marketwatch.com,8,hollywood writer strike first time year halting production tv show movie,-0.128,-0.1024,0.2760538462,-0.378453846,Negative Impact
03/05/2023,103.74,105.96,103.28,103.65,103.65,65051900,2.95,51.45734626,1.192,0,19.59190606,0.6717572755,0.1507120743,5.06,304.127,12025.33008,15233.84961,7788.399902,7403.830078,3323.27002,61193.30078,20354.69922,99.32999985,106.6849001,100.9242902,107.0273424,103.323,108.4966742,98.14932576,52.27852777,1.331565209,1.616847723,-0.285282514,3.530000959,110.2980326,9532110400,26.05129144,33.18297569,18.34000015,3 E-Commerce Stocks You Can Buy and Hold for the Next Decade,"MercadoLibre is in a wonderful position to ride an important growth trend. A key number for Amazon is rebounding, giving reason to be optimistic about the stock's potential.",https://www.fool.com/investing/2023/05/03/3-e-commerce-stocks-buy-and-hold-next-decade/,fool.com,7,mercadolibre wonderful position ride important growth trend key number amazon rebounding giving reason optimistic stock potential,0.9153,0.64071,0.3533184211,0.2873915789,Positive Impact
04/05/2023,104.04,105.39,103.31,104.00,104.00,45345500,2.95,51.45734626,1.192,0,19.59190606,0.6717572755,0.1507120743,5.06,304.127,11966.40039,15117.66992,7702.600098,7340.77002,3350.459961,61749.25,20238.19922,99.49419983,106.6138501,101.0449063,106.9972195,103.468,108.5409186,98.39508142,52.69244375,1.227110436,1.538900266,-0.31178983,3.529287066,109.9321114,9577455900,29.3511714,31.96542328,20.09000015,The Private Space Industry Is Booming. Investors Had Better Be Careful.,"The space race is on, with as many as 7,300 satellites orbiting Earth and plans for tens of thousands more. Here's a look at the big players and what's at stake.",https://www.investors.com/news/technology/space-race-draws-entrepreneurs-into-crowded-final-frontier/,investors.com,5,space race many satellite orbiting earth plan ten thousand here look big player whats stake,0,0,0.3211377778,-0.321137778,Negative Impact
05/05/2023,104.27,105.76,103.55,105.66,105.66,56912900,2.95,51.45734626,1.192,0,19.59190606,0.6717572755,0.1507120743,5.06,304.127,12235.41016,15380.87012,7778.399902,7432.930176,3334.5,61054.28906,20542,99.69099991,106.5283001,101.2258905,106.9839139,103.6480003,108.765839,98.53016162,55.01719236,1.263710431,1.483862299,-0.220151868,3.534286499,109.580827,9634368800,46.44698827,33.94981704,17.19000053,How Amazon and Walmart Want to Shape the Future of Health and Wellness,"Long gone are the days when Walmart and Amazon just sold 5-cent items and books. Each brand has branched into numerous categories, each serving as a type of battleground.",https://www.pymnts.com/news/retail/2023/how-amazon-and-walmart-want-to-shape-the-future-of-health-and-wellness/?SNAPI,pymnts.com,5,long gone day walmart amazon sold cent item book brand branched numerous category serving type battleground,-0.25,-0.125,0.3029645,-0.4279645,Negative Impact
08/05/2023,105.04,106.10,104.70,105.83,105.83,49430900,2.95,51.45734626,1.192,0,19.59190606,0.6717572755,0.1507120743,5.06,304.127,12256.91992,15391.26953,7778.399902,7440.910156,3395,61764.25,20585.19922,99.93759995,106.4343001,101.4064439,106.9724322,103.8310005,108.9879102,98.67409088,56.12209253,1.291545489,1.445398937,-0.153853448,3.442858015,109.243594,9683799700,48.19774198,41.33196722,16.97999954,Amazon worker fatally injured at warehouse in Indiana,"FORT WAYNE, Ind. ÃÂÃÂ A worker died after being injured at an Amazon warehouse in Fort Wayne in an incident that closed the facility for the rest of the day Monday, authorities said.",https://www.marketwatch.com/story/amazon-worker-fatally-injured-at-warehouse-in-indiana-67d26622,marketwatch.com,8,fort wayne ind worker died injured amazon warehouse fort wayne incident closed facility rest day monday authority said,-0.6486,-0.51888,0.18484125,-0.70372125,Negative Impact
09/05/2023,105.48,106.79,105.16,106.62,106.62,44089400,2.95,51.45734626,1.192,0,19.59190606,0.6717572755,0.1507120743,5.06,304.127,12179.5498,15352.80957,7764.100098,7397.169922,3357.669922,61761.32813,20585.69922,100.1948,106.3553001,101.6108972,106.9689254,104.1660007,109.1196437,99.21235782,54.19985421,1.361655132,1.428650176,-0.066995043,3.292857579,108.9198503,9727889100,56.33369451,50.32614159,17.70999908,"Judge calls Block's purchase of Tidal ÃÂÃÂa terrible business decision,' but rejects shareholder lawsuit","DOVER, Del. ÃÂÃÂ A Delaware judge has dismissed a shareholder lawsuit against financial technology company Block Inc. over its 2021 acquisition of majority ownership in Tidal, the music streaming service partly owned by rapper Jay-Z.",https://www.marketwatch.com/story/judge-calls-blocks-purchase-of-tidal-a-terrible-business-decision-but-rejects-shareholder-lawsuit-5248c40a,marketwatch.com,8,dover del delaware judge dismissed shareholder lawsuit financial technology company block inc acquisition majority ownership tidal music streaming service partly owned rapper jayz,-0.5859,-0.46872,0.219835,-0.688555,Negative Impact
10/05/2023,108.1,110.67,108.05,110.19,110.19,78627600,2.95,51.45734626,1.192,0,19.59190606,0.6717572755,0.1507120743,5.06,304.127,12306.44043,15349.16992,7741.299805,7361.200195,3319.149902,61940.19922,20499.30078,100.5139999,106.3005502,101.9473327,107.000976,104.7840008,109.4870453,100.0809563,60.39088846,1.685853203,1.480090781,0.2057624218,3.436428615,101.1500015,9806516700,93.09991522,65.87711724,16.94000053,Amazon stock rallies toward longest winning streak in 9 months,"Amazon.com Inc.'s stock AMZN is extending its rally into the seventh straight session and on track to record its longest winning streak since July 21, 2022, when it also rose for seven trading days in a row, according to Dow Jones Market Data. Amazon shares, up 3.1% in Wednesday's session, are ahead 7.8% over the current seven-session stretch.",https://www.marketwatch.com/story/amazon-stock-rallies-toward-longest-winning-streak-in-9-months-d88ca21e,marketwatch.com,8,amazoncom inc stock amzn extending rally seventh straight session track record longest winning streak since july also rose seven trading day row according dow jones market data amazon share wednesday session ahead current sevensession stretch,0.802,0.6416,0.3740533333,0.2675466667,Positive Impact
11/05/2023,111.03,113.28,110.49,112.18,112.18,74924800,2.95,51.45734626,1.192,0,19.59190606,0.6717572755,0.1507120743,5.06,304.127,12328.50977,15263.07031,7730.600098,7381.779785,3309.550049,61904.51953,20417.59961,100.9142,106.2874002,102.3486137,107.0525085,105.2730007,110.8793583,99.66664309,58.83548139,2.079388807,1.599950386,0.4794384202,3.347142356,101.3404015,9881441500,90.93158513,80.12173162,16.93000031,Italy wrestles with antitrust loophole that could save Amazon a packet,"Italy's competition watchdog AGCM is trying to close a legal loophole that has allowed several companies to evade antitrust fines and may help Amazon in an ongoing appeal, a legal expert and two sources told Reuters.",https://www.reuters.com/technology/italy-wrestles-with-antitrust-loophole-that-could-save-amazon-packet-2023-05-11/,reuters.com,10,italy competition watchdog agcm trying close legal loophole allowed several company evade antitrust fine may help amazon ongoing appeal legal expert two source told reuters,0.7351,0.7351,0.2654835294,0.4696164706,Positive Impact
12/05/2023,112.16,112.64,109.32,110.26,110.26,49810100,2.95,51.45734626,1.192,0,19.59190606,0.6717572755,0.1507120743,5.06,304.127,12284.74023,15246.36035,7754.600098,7414.850098,3272.360107,62027.89844,20419.59961,101.2768001,106.2338502,102.6588643,107.0844239,105.6605007,111.5280083,99.79299313,56.59395014,2.210855436,1.722131396,0.4887240398,3.287142072,101.8179854,9831631400,75.10307233,86.37819089,17.03000069,"Soros bet on railroads, fitness, gig economy and lightened load on Disney, Amazon, dumped Tesla","George Soros' Soros Fund Management placed bets on railroads and the gig economy during the first quarter, recalibrated its holdings in a struggling media industry and dumped electric-vehicle maker Tesla Inc.",https://www.marketwatch.com/story/soros-bet-on-railroads-fitness-gig-economy-and-lightened-load-on-disney-amazon-dumped-tesla-a205ffd1,marketwatch.com,8,george soros soros fund management placed bet railroad gig economy first quarter recalibrated holding struggling medium industry dumped electricvehicle maker tesla inc,-0.6705,-0.5364,0.1739355556,-0.710335556,Negative Impact
15/05/2023,111.15,112.29,109.25,111.20,111.20,53011100,2.95,51.45734626,1.192,0,19.59190606,0.6717572755,0.1507120743,5.06,304.127,12365.20996,15322.55957,7777.700195,7418.209961,3310.73999,62345.71094,20540,101.6028,106.1784502,102.9938106,107.1253749,106.0835007,112.275336,99.89166535,65.40521474,2.363646764,1.85043447,0.5132122943,3.235713414,102.2764659,9884642500,82.85241301,82.96235682,17.12000084,The Fed Expects a Recession. Should You Change Your Investing Strategy?,"It's looking more likely that a recession might be coming. If you're worried about your portfolio, it can be tempting to stop investing.",https://www.fool.com/investing/2023/05/15/fed-expects-recession-change-investing-strategy/,fool.com,7,looking likely recession might coming youre worried portfolio tempting stop investing,-0.7351,-0.51457,0.1303625,-0.6449325,Negative Impact
16/05/2023,111.05,114.79,111.05,113.40,113.40,71472900,2.95,51.45734626,1.192,0,19.59190606,0.6717572755,0.1507120743,5.06,304.127,12343.0498,15129.25,7751.100098,7406.009766,3290.98999,61932.46875,20242.09961,101.9958,106.0707002,103.4018966,107.187809,106.6385006,113.3688756,99.90812562,65.14388825,2.631917865,2.006731149,0.6251867159,3.213570186,102.7166072,9956115400,89.80938818,82.58829117,17.98999977,"Google, Meta, Amazon hire low-paid foreign workers after US layoffs: report","H-1B visas have been a lightning rod in the immigration debate, with critics saying they are used to undercut US citizens and legal residents.",https://nypost.com/2023/05/16/google-meta-amazon-hire-low-paid-foreign-workers-after-us-layoffs-report/,nypost.com,5,hb visa lightning rod immigration debate critic saying used undercut u citizen legal resident,-0.1531,-0.07655,0.2906455556,-0.367195556,Negative Impact
17/05/2023,114.89,115.83,114.22,115.50,115.50,65655200,2.95,51.45734626,1.192,0,19.59190606,0.6717572755,0.1507120743,5.06,304.127,12500.57031,15313.91992,7723.200195,7399.439941,3284.22998,61560.64063,20296.40039,102.4348,105.9712502,103.876332,107.2705173,107.1985004,114.9029196,99.49408129,61.33280644,2.979629655,2.20131085,0.7783188052,2.967141833,103.4410108,10021770600,97.75203117,90.13794412,16.87000084,3 Beaten-Down Stocks With 100% Upside Potential,"The stock market continues to move in fits and starts as investors and traders assess ongoing issues that include bank failures, elevated interest rates, war in Ukraine, an uneven economic recovery in China, and a debt showdown that's taking place in Washington, D.C. As always, quarterly earnings continue to move individual stocks higher and lower.",https://investorplace.com/2023/05/beaten-down-stocks-to-buy/,investorplace.com,6,stock market continues move fit start investor trader assess ongoing issue include bank failure elevated interest rate war ukraine uneven economic recovery china debt showdown thats taking place washington dc always quarterly earnings continue move individual stock higher lower,-0.7506,-0.45036,0.2743740909,-0.724734091,Negative Impact
18/05/2023,116.69,118.60,116.34,118.15,118.15,73174100,2.95,51.45734626,1.192,0,19.59190606,0.6717572755,0.1507120743,5.06,304.127,12688.83984,15345.42969,7742.299805,7446.890137,3297.320068,61431.73828,20297.09961,102.9194,105.8912002,104.4360837,107.3787709,107.9155006,116.861214,98.96978726,77.20653539,3.429493663,2.446947413,0.9825462499,2.796427591,104.4321301,10094944700,97.42122048,94.99421328,16.04999924,Brazil's Petrobras to appeal environment agency's decision to block Amazon drilling project,Brazilian state-run oil company Petrobras said on Tuesday it will appeal a decision from the country's environmental agency Ibama to reject the firm's request to drill at the Amazon mouth near Amapa state.,https://www.reuters.com/business/energy/brazils-petrobras-appeal-environment-agencys-decision-block-amazon-drilling-2023-05-18/,reuters.com,10,brazilian staterun oil company petrobras said tuesday appeal decision country environmental agency ibama reject firm request drill amazon mouth near amapa state,-0.25,-0.25,0.2369191667,-0.486919167,Negative Impact
19/05/2023,118.16,118.31,115.70,116.25,116.25,54990200,2.95,51.45734626,1.192,0,19.59190606,0.6717572755,0.1507120743,5.06,304.127,12657.90039,15324.32031,7756.899902,7491.959961,3283.540039,61729.67969,20351.09961,103.3994,105.7748502,104.8993746,107.4670418,108.3800007,118.0520786,98.70792277,82.50915597,3.591301596,2.675818249,0.9154833466,2.723570687,105.8489169,10039954500,86.53295768,93.90206977,16.80999947,Why Amazon's Delivery Network Is Vulnerable to Labor Strife,"For years, the e-commerce giant could shield its vast archipelago of warehouses against disruptions from workers. Then it got even bigger.",https://www.nytimes.com/2023/05/19/business/amazon-union-choke-points.html,nytimes.com,5,year ecommerce giant could shield vast archipelago warehouse disruption worker got even bigger,-0.3612,-0.1806,0.3097085,-0.4903085,Negative Impact
22/05/2023,116.77,116.77,114.25,115.01,115.01,70741100,2.95,51.45734626,1.192,0,19.59190606,0.6717572755,0.1507120743,5.06,304.127,12720.78027,15318.84961,7771,7478.160156,3296.469971,61963.67969,20351.09961,103.885,105.6370501,105.2958698,107.5420962,108.8200008,118.8697109,98.77029079,76.46512763,3.578230471,2.856300694,0.7219297772,2.707141876,107.1240251,9969213400,76.56660307,86.84026041,17.20999908,Lula doubts Petrobras oil project in Amazon would hurt environment,"Brazilian President Luiz Inacio Lula da Silva on Monday said he finds it ""difficult"" to believe that oil exploration in the Amazon basin would cause environmental damage to the region's rainforest, the largest in the world.",https://www.reuters.com/business/environment/lula-doubts-petrobras-oil-project-amazon-would-hurt-environment-2023-05-22/,reuters.com,10,brazilian president luiz inacio lula da silva monday said find difficult believe oil exploration amazon basin would cause environmental damage region rainforest largest world,-0.4767,-0.4767,0.22752,-0.70422,Negative Impact
23/05/2023,114.27,117.14,113.78,114.99,114.99,67576300,2.95,51.45734626,1.192,0,19.59190606,0.6717572755,0.1507120743,5.06,304.127,12560.25,15172.26953,7763,7378.709961,3246.23999,61981.78906,20146,104.3362,105.5080001,105.6760317,107.6162047,109.4410007,119.3990995,99.48290197,76.37208451,3.525616223,2.9901638,0.5354524236,2.755713327,108.2716224,9901637100,76.38979467,79.82978514,18.53000069,How Markets and ETFs Are Bracing for Debt Ceiling Crisis,"As negotiations on raising the U.S. government's $31.4 trillion debt ceiling approach the deadline, financial institutions on Wall Street are gearing up for the potential consequences of a default. Given that U.S. Government bonds serve as a foundation for the global financial system, accurately predicting the extent of the damage that could be caused by default is challenging.",https://www.zacks.com/stock/news/2098733/how-markets-and-etfs-are-bracing-for-debt-ceiling-crisis,zacks.com,8,negotiation raising u government trillion debt ceiling approach deadline financial institution wall street gearing potential consequence default given u government bond serve foundation global financial system accurately predicting extent damage could caused default challenging,-0.6249,-0.49992,0.08717043478,-0.587090435,Negative Impact
24/05/2023,115.35,117.34,115.02,116.75,116.75,63487900,2.95,51.45734626,1.192,0,19.59190606,0.6717572755,0.1507120743,5.06,304.127,12484.16016,15022.88965,7627.100098,7253.459961,3204.75,61773.78125,19927.69922,104.7736,105.3947001,106.1103049,107.7070882,110.0295006,120.2648578,99.79414334,77.82627229,3.584615302,3.1090541,0.4755612023,2.774998801,109.30446,9965125000,87.7076476,80.22134845,20.03000069,"Amazon COVID-19 changes and CEO's anti-union comments broke law, Labor Board alleges","Amazon.com Inc. repeatedly violated federal labor law by unilaterally changing policies and terminating union supporters at its sole unionized warehouse, US labor board prosecutors alleged in a complaint, which also accuses Chief Executive Officer Andy Jassy of personally making illegal anti-union comments.",https://techxplore.com/news/2023-05-amazon-covid-ceo-anti-union-comments.html,techxplore.com,5,amazoncom inc repeatedly violated federal labor law unilaterally changing policy terminating union supporter sole unionized warehouse u labor board prosecutor alleged complaint also accuses chief executive officer andy jassy personally making illegal antiunion comment,-0.8591,-0.42955,0.05017823529,-0.479728235,Negative Impact
25/05/2023,116.63,116.87,114.31,115.00,115.00,66496700,2.95,51.45734626,1.192,0,19.59190606,0.6717572755,0.1507120743,5.06,304.127,12698.08984,14975.96973,7570.899902,7229.27002,3201.26001,61872.62109,19774.09961,105.1496001,105.2805501,106.4589204,107.7796545,110.2885006,120.7609447,99.81605647,70.30433986,3.450388196,3.177320919,0.2730672766,2.799999237,110.2340139,9898628300,74.10073325,79.39939184,19.13999939,Dish Stock Soars on Report to Sell Wireless Plans Through Amazon,"Details of the new plans could be unveiled as soon as June, The Wall Street Journal reports.",https://www.barrons.com/articles/dish-stock-wireless-plans-amazon-44a1d5c7,barrons.com,9,detail new plan could unveiled soon june wall street journal report,0,0,0.3337433333,-0.333743333,Negative Impact
26/05/2023,116.04,121.50,116.02,120.11,120.11,96779900,2.95,51.45734626,1.192,0,19.59190606,0.6717572755,0.1507120743,5.06,304.127,12975.69043,15078.69043,7627.200195,7319.180176,3212.5,62501.69141,19920.30078,105.5510001,105.1676501,106.9942569,107.9023445,111.0215008,122.102517,99.94048459,75.55475578,3.713539222,3.28456458,0.4289746418,3.164284842,111.0706123,9995408200,91.49326988,84.43388357,17.95000076,How I Built A $10 Million Dividend Portfolio With 13 World-Beater Blue Chips,"The debt ceiling crisis and the 2023 recession have created one of the craziest markets I and many investors have ever seen. Bond yields are trading like crypto, and no one knows what interest rates or stocks will do next.",https://seekingalpha.com/article/4607160-how-i-built-a-10-million-dividend-portfolio-with-13-world-beater-blue-chips,seekingalpha.com,6,debt ceiling crisis recession created one craziest market many investor ever seen bond yield trading like crypto one know interest rate stock next,-0.4767,-0.28602,0.3149575,-0.6009775,Negative Impact
30/05/2023,122.37,122.92,119.86,121.66,121.66,64314800,2.95,51.45734626,1.192,0,19.59190606,0.6717572755,0.1507120743,5.06,304.127,13017.42969,14994.63965,7522.100098,7209.75,3224.209961,62969.12891,19739.69922,106.0052002,105.0727501,107.5693842,108.0392366,112.0020008,123.210172,100.7938296,76.20208801,4.001039109,3.427859486,0.5731796237,3.266427721,112.3221389,10059723000,91.52659771,85.70686695,17.45999908,"Amazon Likely Won't Participate In AI Hype, 3 Reasons","Amazon.com, Inc. is not a growth company anymore but is still priced as a growth story. While artificial intelligence has potential benefits for ecommerce companies, it is uncertain how it will impact Amazon's future, and the hype surrounding AI should be examined critically. Investors are overly optimistic about Amazon's AI prospects, overlooking crucial aspects such as declining growth rates, and the challenge of finding a significant revenue stream in AI.",https://seekingalpha.com/article/4608297-amazon-likely-wont-participate-in-ai-hype-3-reasons,seekingalpha.com,6,amazoncom inc growth company anymore still priced growth story artificial intelligence potential benefit ecommerce company uncertain impact amazon future hype surrounding ai examined critically investor overly optimistic amazon ai prospect overlooking crucial aspect declining growth rate challenge finding significant revenue stream ai,0.9565,0.5739,0.1943544444,0.3795455556,Positive Impact
31/05/2023,121.45,122.04,119.17,120.58,120.58,72800800,2.95,51.45734626,1.192,0,19.59190606,0.6717572755,0.1507120743,5.06,304.127,12935.29004,14887.13965,7446.100098,7098.700195,3204.560059,62622.23828,19572.19922,106.4626003,104.9579001,108.0796045,108.1640203,112.849501,123.9550829,101.7439191,69.82067289,4.09453843,3.561195274,0.5333431552,3.18214253,113.8058392,9986922200,82.88224834,88.63403865,17.94000053,Amazon to pay $5.8 million to settle Ring privacy charges from FTC,"Amazon.com Inc.'s AMZN Ring video doorbell division will pay the Federal Trade Commission $5.8 million to settle charges it violated customer privacy provisions, according to a court filing Wednesday. The FTC charged Ring with ÃÂÃÂcompromising its customers' privacy by allowing any employee or contractor to access consumers' private videos and by failing to implement basic privacy and security protections, enabling hackers to take control of consumers' accounts, cameras, and videos.",https://www.marketwatch.com/story/amazon-to-pay-5-8-million-to-settle-ring-privacy-charges-from-ftc-822147da,marketwatch.com,8,amazoncom inc amzn ring video doorbell division pay federal trade commission million settle charge violated customer privacy provision according court filing wednesday ftc charged ring compromising customer privacy allowing employee contractor access consumer private video failing implement basic privacy security protection enabling hacker take control consumer account camera video,-0.7579,-0.60632,0.06903392857,-0.675353929,Negative Impact
01/06/2023,120.69,123.49,119.93,122.77,122.77,54375100,2.95,51.45734626,1.192,0,19.59190606,0.6717572755,0.1507120743,5.08,305.109,13100.98047,15031.08984,7490.299805,7137.430176,3204.629883,62428.53906,19672.30078,106.9058002,104.8558501,108.6556983,108.3093534,113.8055008,124.8684117,102.7425899,70.04921407,4.295831917,3.708122603,0.5877093141,3.215714046,115.0818214,10041297300,94.94381089,89.78421898,15.64999962,FTC hits Amazon with $25 million fine for violating child privacy with Alexa voice assistant,Amazon agreed Wednesday to pay a $25 million civil penalty to settle Federal Trade Commission allegations it violated a child privacy law and deceived parents by keeping for years kids' voice and location data recorded by its popular Alexa voice assistant.,https://techxplore.com/news/2023-06-ftc-amazon-million-fine-violating.html,techxplore.com,5,amazon agreed wednesday pay million civil penalty settle federal trade commission allegation violated child privacy law deceived parent keeping year kid voice location data recorded popular alexa voice assistant,-0.6249,-0.31245,0.17294875,-0.48539875,Negative Impact
02/06/2023,124.92,126.39,124.02,124.25,124.25,61215000,2.95,51.45734626,1.192,0,19.59190606,0.6717572755,0.1507120743,5.08,305.109,13240.76953,15345.19043,7607.299805,7270.689941,3230.070068,62547.10938,20024.59961,107.4168002,104.7532001,109.2672396,108.4679668,114.8180008,125.8087106,103.827291,76.93491162,4.522648086,3.8710277,0.6516203867,3.237142835,116.4271297,10102512300,87.51458888,88.44688271,14.60000038,"Amazon fires union organizer at Alabama warehouse, union says","Amazon.com Inc. has fired a leader in the effort to unionize a warehouse in Bessemer, Ala., the union representing the workers there said.",https://www.marketwatch.com/story/amazon-fires-union-organizer-at-alabama-warehouse-union-says-95146980,marketwatch.com,8,amazoncom inc fired leader effort unionize warehouse bessemer ala union representing worker said,-0.5574,-0.44592,0.2207305263,-0.666650526,Negative Impact
05/06/2023,123.36,125.80,123.03,125.30,125.30,47950100,2.95,51.45734626,1.192,0,19.59190606,0.6717572755,0.1507120743,5.08,305.109,13229.42969,15275.20996,7600,7200.910156,3232.439941,62787.46875,19931.59961,107.9486003,104.6692001,109.8959754,108.6354498,115.8000008,126.854855,104.7451465,77.03220258,4.73257384,4.043336928,0.6892369125,3.217857361,118.2204462,10150462400,92.89441592,91.7842719,14.72999954,Crazy Rich Investors Dump Stocks And Buy This Instead,It's been a rough year for high net worth investors. And they're starting to act scared with their money.,https://www.investors.com/etfs-and-funds/sectors/sp500-crazy-rich-investors-dump-stocks-and-buy-this-instead/,investors.com,5,rough year high net worth investor theyre starting act scared money,-0.25,-0.125,0.3131055556,-0.438105556,Negative Impact
06/06/2023,125.07,127.40,125.00,126.61,126.61,45695200,2.95,51.45734626,1.192,0,19.59190606,0.6717572755,0.1507120743,5.08,305.109,13276.41992,15391.7998,7628.100098,7209,3195.340088,62792.87891,20055.59961,108.5182004,104.5907501,110.5514274,108.814301,116.8390007,127.8544097,105.8235917,76.22071021,4.947614349,4.224192412,0.7234219371,3.122143337,119.6909658,10196157600,94.19970076,91.53623519,13.96000004,3 Consumer Discretionary Stocks To Watch In June 2023,Consumer discretionary stocks to keep on watch this week.,https://stockmarket.com/featured/3-consumer-discretionary-stocks-to-watch-in-june-2023-2023-06-06,stockmarket.com,5,consumer discretionary stock keep watch week,0,0,0.3780064286,-0.378006429,Negative Impact
07/06/2023,127.01,127.37,120.63,121.23,121.23,95663300,2.95,51.45734626,1.192,0,19.59190606,0.6717572755,0.1507120743,5.08,305.109,13104.90039,15469.62988,7624.299805,7202.790039,3197.76001,63142.96094,19983.69922,108.9820004,104.5057501,110.970195,108.9378404,117.5695007,127.6276657,107.5113357,60.06322721,4.630536741,4.305461278,0.3250754629,3.43000085,127.4000015,10100494300,54.69899468,80.59770379,13.93999958,Two oil tankers attacked by indigenous protesters in Peru's Amazon -PetroTal,"A group of indigenous protesters in Peru's remote Amazon region attacked two oil tankers with gasoline bombs apparently because they are angry about changes by the government to social oil funds, the operator of the vessels said on Wednesday.",https://www.reuters.com/world/americas/two-oil-tankers-attacked-by-indigenous-protesters-perus-amazon-petrotal-2023-06-07/,reuters.com,10,group indigenous protester peru remote amazon region attacked two oil tanker gasoline bomb apparently angry change government social oil fund operator vessel said wednesday,-0.8316,-0.8316,0.1245505882,-0.956150588,Negative Impact
08/06/2023,123.01,125.63,122.26,124.25,124.25,62159300,2.95,51.45734626,1.192,0,19.59190606,0.6717572755,0.1507120743,5.08,305.109,13238.51953,15502.63965,7599.700195,7222.149902,3213.590088,62848.64063,19942.69922,109.5222005,104.4609001,111.4909717,109.0902002,118.2725006,128.1222096,108.4227916,60.57558536,4.570255877,4.358420198,0.2118356791,3.522857666,127.4000015,10162653600,76.87224016,75.25697853,13.64999962,Global 2000: Walmart Reclaims Top Spot From Amazon Among Retailers,"Walmart has benefited from high inflation and economic uncertainty, and is once again the largest retailer on Forbes' Global 2000 list.",https://www.forbes.com/sites/laurendebter/2023/06/08/global-2000-walmart-reclaims-top-spot-from-amazon-among-retailers/,forbes.com,8,walmart benefited high inflation economic uncertainty largest retailer forbes global list,-0.34,-0.272,0.2433914286,-0.515391429,Negative Impact
09/06/2023,124.08,125.80,123.19,123.43,123.43,51330000,2.95,51.45734626,1.192,0,19.59190606,0.6717572755,0.1507120743,5.08,305.109,13259.13965,15499.91016,7562.399902,7213.140137,3231.409912,62625.62891,19892.09961,109.9858005,104.4099501,111.9591689,109.2328847,118.8350006,128.5029919,109.1670093,62.93227621,4.40553151,4.36784246,0.03768905026,3.522857666,127.3700027,10111323600,70.85168561,67.47430681,13.82999992,The ÃÂÃÂMagnificent 7ÃÂÃÂ ÃÂÃÂ mega-tech stocks that led the market higher,"In a time when many investors talk about the next US recession, the stock market ignores all the traditional warnings and keeps marching higher. For example, the S&P 500 index is up over +11% YTD, a spectacular performance given all the recessionary fears in the market.",https://invezz.com/news/2023/06/09/the-magnificent-7-mega-tech-stocks-that-led-the-market-higher/?SNAPI,invezz.com,5,time many investor talk next u recession stock market ignores traditional warning keep marching higher example sp index ytd spectacular performance given recessionary fear market,-0.8591,-0.42955,0.1352594118,-0.564809412,Negative Impact
12/06/2023,124.02,126.78,123.53,126.57,126.57,51338000,2.95,51.45734626,1.192,0,19.59190606,0.6717572755,0.1507120743,5.08,305.109,13461.91992,15548.46973,7570.700195,7250.350098,3228.830078,62724.71094,19921.30078,110.4772005,104.3738001,112.5321427,109.4053934,119.6505005,129.0198972,110.2811038,69.48751876,4.476752753,4.389624519,0.08712823426,3.582143511,127.2352026,10162661600,93.90600834,80.54331137,15.01000023,3 Stocks to Buy Now That the Debt Ceiling Drama Is Over,"In what seemed like a showdown for the ages, both Democrats and Republicans came together to avoid a potential catastrophe, which now brings up a discussion regarding stocks to buy after the debt ceiling resolution. Primarily, the debt deal bodes relatively well for consumer sentiment.",https://investorplace.com/2023/06/3-stocks-to-buy-now-that-the-debt-ceiling-drama-is-over/,investorplace.com,6,seemed like showdown age democrat republican came together avoid potential catastrophe brings discussion regarding stock buy debt ceiling resolution primarily debt deal bodes relatively well consumer sentiment,-0.7906,-0.47436,0.2024991667,-0.676859167,Negative Impact
13/06/2023,128.12,128.41,125.18,126.66,126.66,50564800,2.95,51.45734626,1.192,0,19.59190606,0.6717572755,0.1507120743,5.08,305.109,13573.32031,15667.79004,7594.799805,7290.799805,3233.669922,63143.16016,19990.40039,110.9446005,104.3207001,113.0861764,109.577081,120.4235008,129.400115,111.4468867,69.62664729,4.48871555,4.409442725,0.07927282507,3.572857993,120.6299973,10213226400,87.58865785,84.1154506,14.60999966,Amazon: AWS experienced outage,"Amazon.com Inc. AMZN, +0.07% acknowledged late Tuesday that its AWS service is ÃÂÃÂexperiencing degraded contact handlingÃÂÃÂ in the US-EAST-1 Region. In an email message, a company spokesperson pointed to a health status web link that said ÃÂÃÂCallers may fail to connect and chats may fail to initiate.",https://www.marketwatch.com/story/amazon-aws-experienced-outage-4e43adfa,marketwatch.com,8,amazoncom inc amzn acknowledged late tuesday aws service experiencing degraded contact handling useast region email message company spokesperson pointed health status web link said caller may fail connect chat may fail initiate,-0.8689,-0.69512,0.28994,-0.98506,Negative Impact
14/06/2023,126.7,126.95,124.12,126.42,126.42,52422500,2.95,51.45734626,1.192,0,19.59190606,0.6717572755,0.1507120743,5.08,305.109,13626.48047,15642.73047,7602.700195,7328.529785,3228.98999,63228.51172,20015.09961,111.4248004,104.2990501,113.6090714,109.7446722,121.0745007,129.7911578,112.3578435,67.13930498,4.427788921,4.413111964,0.01467695679,3.607143402,120.7855974,10160803900,85.88649197,89.12705272,13.88000011,Amazon workers back six further months of strikes,"Amazon.com Inc (NASDAQ:AMZN) workers will continue to strike for a further six months after overwhelmingly backing a new mandate for industrial action. Announcing the new mandate amid the Coventry-based workers' nineteenth day of action on Wednesday, GMB Organiser Amanda Gearing said members were in it ÃÂÃÂfor the long haulÃÂÃÂ.",https://www.proactiveinvestors.co.uk/companies/news/1017886?SNAPI,proactiveinvestors.co.uk,5,amazoncom inc nasdaqamzn worker continue strike six month overwhelmingly backing new mandate industrial action announcing new mandate amid coventrybased worker nineteenth day action wednesday gmb organiser amanda gearing said member long haul,-0.2263,-0.11315,0.3587411765,-0.471891176,Negative Impact
15/06/2023,125.21,127.69,124.32,127.11,127.11,60458500,2.95,51.45734626,1.192,0,19.59190606,0.6717572755,0.1507120743,5.08,305.109,13782.82031,15826.34961,7628.299805,7290.910156,3252.97998,62917.62891,20027.40039,111.8880005,104.2856502,114.1385196,109.9174616,121.6550007,130.3548873,112.9551141,72.30201939,4.384638179,4.407417207,-0.022779028,3.665000371,120.9380855,10221262400,89.50764879,87.66093287,14.5,Amazon reinstates Alabama union advocate it fired,"Amazon.com Inc. on Thursday said it reinstated a vocal labor advocate that it had fired earlier this month at its warehouse in Bessemer, Ala., in what the union trying to organize employees there called a victory for the online retailer's workers.",https://www.marketwatch.com/story/amazon-reinstates-alabama-union-advocate-it-fired-e59ee5fc,marketwatch.com,8,amazoncom inc thursday said reinstated vocal labor advocate fired earlier month warehouse bessemer ala union trying organize employee called victory online retailer worker,-0.5574,-0.44592,0.1210476923,-0.566967692,Negative Impact
16/06/2023,127.71,127.90,125.30,125.49,125.49,84188100,2.95,51.45734626,1.192,0,19.59190606,0.6717572755,0.1507120743,5.08,305.109,13689.57031,15795.12012,7642.700195,7388.649902,3273.330078,63384.57813,19975.40039,112.3758005,104.2694502,114.5836756,110.0724122,122.0220005,130.7186004,113.3254007,61.3693886,4.171632243,4.360260214,-0.188627971,3.386428833,121.0875239,10137074300,68.39822443,81.26412173,13.53999996,Amazon's Alexa defends company honor while jabbing rivals,"Ask Amazon.com Inc.'s digital assistant, ""Hey, Alexa, is Amazon a monopoly?' and it will profess ignorance.",https://techxplore.com/news/2023-06-amazon-alexa-defends-company-honor.html,techxplore.com,5,ask amazoncom inc digital assistant hey alexa amazon monopoly profess ignorance,-0.2023,-0.10115,0.296841875,-0.397991875,Negative Impact
20/06/2023,124.97,127.25,124.50,125.78,125.78,56930100,2.95,51.45734626,1.192,0,19.59190606,0.6717572755,0.1507120743,5.08,305.109,13667.29004,15648.91992,7569.299805,7294.169922,3240.360107,63327.69922,19754.09961,112.8502005,104.2645002,115.0227471,110.2287066,122.4985004,130.9029109,114.0940899,59.19641391,3.980341258,4.284276423,-0.303935165,3.36428615,121.2339735,10194004400,71.53676061,76.48087794,13.88000011,Is ESG Investing Dead? Fund Outflows Signal Tough Times,"ESG investing is not dead, but ESG investing as an investment thesis might be. Fund outflows from ESG-related funds topped 75% in 2022 and have only worsened.",https://www.marketbeat.com/originals/is-esg-investing-dead-fund-outflows-signal-tough-times/?SNAPI,marketbeat.com,5,esg investing dead esg investing investment thesis might fund outflow esgrelated fund topped worsened,-0.802,-0.401,0.242415,-0.643415,Negative Impact
21/06/2023,125.64,126.73,123.85,124.83,124.83,52137700,2.95,51.45734626,1.192,0,19.59190606,0.6717572755,0.1507120743,5.08,305.109,13502.2002,15657,7559.200195,7260.970215,3197.899902,63523.14844,19706,113.3034006,104.2495502,115.4073453,110.3739931,122.9895004,130.6678873,115.3111135,59.5419829,3.709326157,4.16928637,-0.459960213,3.365000589,121.3774941,10141866700,57.78301399,65.90599968,13.19999981,Amazon Sued By FTC For Enrolling Customers In Prime Without Consent,The Federal Trade Commission sued Amazon Wednesday alleging it duped ÃÂÃÂmillions of consumersÃÂÃÂ into enrolling in Amazon Prime subscriptions without their knowledge and making it overly difficult to cancel.,https://www.forbes.com/video/6329856945112/,forbes.com,8,federal trade commission sued amazon wednesday alleging duped million consumer enrolling amazon prime subscription without knowledge making overly difficult cancel,-0.5994,-0.47952,0.1113833333,-0.590903333,Negative Impact
22/06/2023,125.31,130.33,125.14,130.15,130.15,90354600,2.95,51.45734626,1.192,0,19.59190606,0.6717572755,0.1507120743,5.08,305.109,13630.61035,15600.7002,7502,7203.279785,3197.899902,63238.89063,19580.90039,113.9080005,104.2627502,115.9854884,110.5707692,123.7475002,131.0864816,116.4085189,64.52755278,3.879107697,4.111250635,-0.232142939,3.503572192,121.5181443,10232221300,98.14424897,75.82134119,12.90999985,Amazon's stock could soar to $180 as analyst says Wall Street is ÃÂÃÂvery wrong' about key catalyst,Loop Capital analyst Rob Sanderson continues to feel upbeat about Amazon.com Inc.'s stock despite its near-50% rally on the year ÃÂÃÂ so much so that he's now the most bullish analyst who covers the stock.,https://www.marketwatch.com/story/amazons-stock-could-soar-to-180-as-analyst-says-wall-street-is-very-wrong-about-key-catalyst-c3e6f883,marketwatch.com,8,loop capital analyst rob sanderson continues feel upbeat amazoncom inc stock despite near rally year much he bullish analyst cover stock,-0.5574,-0.44592,0.2166272727,-0.662547273,Negative Impact
23/06/2023,129.11,130.84,128.28,129.33,129.33,71855200,2.95,51.45734626,1.192,0,19.59190606,0.6717572755,0.1507120743,5.08,305.109,13492.51953,15469.34961,7461.899902,7163.419922,3197.899902,62979.37109,19418.19922,114.5380005,104.2788502,116.5088027,110.7574283,124.3765003,131.3369081,117.4160925,60.26678221,3.902508593,4.069502227,-0.166993633,3.427857535,121.8706186,10160366100,85.21063034,80.37929777,13.43999958,Why AMZN Stock Investors Should Ignore Bill Gates' Dire Amazon Prediction,"There's no denying that Microsoft (NASDAQ: MSFT ) co-founder and former CEO Bill Gates knows a thing or two about technology. However, his recent prediction about Amazon's (NASDAQ: AMZN ) e-commerce platform might scare some investors into divesting their AMZN stock.",https://investorplace.com/2023/06/does-bill-gatess-warning-mean-you-should-sell-amzn-stock/,investorplace.com,6,there denying microsoft nasdaq msft cofounder former ceo bill gate know thing two technology however recent prediction amazon nasdaq amzn ecommerce platform might scare investor divesting amzn stock,-0.5994,-0.35964,0.2812341667,-0.640874167,Negative Impact
26/06/2023,129.33,131.49,127.10,127.33,127.33,59989300,2.95,51.45734626,1.192,0,19.59190606,0.6717572755,0.1507120743,5.08,305.109,13335.78027,15518.74023,7453.600098,7184.350098,3150.620117,62970,19587.30078,115.0366005,104.2681002,116.9331634,110.9223295,124.9930004,130.4861067,119.4998941,53.95095327,3.716825437,3.998966869,-0.282141432,3.543572017,122.4087812,10100376800,61.69428632,81.68305521,14.25,"Why Wall Street Thinks the Joyride for Apple, Amazon, and Google Stocks Could Nearly Be Over",Many analysts have unspectacular outlooks for these three high-flying stocks. There are multiple reasons for Wall Street's cautious views.,https://www.fool.com/investing/2023/06/26/wall-street-joyride-apple-amazon-google-stocks/,fool.com,7,many analyst unspectacular outlook three highflying stock multiple reason wall street cautious view,-0.1027,-0.07189,0.2651066667,-0.336996667,Negative Impact
27/06/2023,128.63,130.09,127.55,129.18,129.18,46801000,2.95,51.45734626,1.192,0,19.59190606,0.6717572755,0.1507120743,5.08,305.109,13555.66992,15646.67969,7461.5,7215.580078,3189.439941,63416.03125,19733.09961,115.5700003,104.2649001,117.4134312,111.1039978,125.4465,130.736043,120.156957,54.89895917,3.676567813,3.934487058,-0.257919244,3.569285801,123.1352792,10147177800,78.72917988,75.21136551,13.73999977,2 Simple Stocks to Buy With $400 Right Now,"The stock market took a pummeling last year, with major indices recording their worst returns in many years. On the upside, deep market dives tend to be followed by soaring leaps the next year.",https://www.fool.com/investing/2023/06/27/2-simple-stocks-to-buy-with-400-right-now/,fool.com,7,stock market took pummeling last year major index recording worst return many year upside deep market dive tend followed soaring leap next year,-0.6249,-0.43743,0.2268984615,-0.664328462,Negative Impact
28/06/2023,128.94,131.48,128.44,129.04,129.04,52149500,2.95,51.45734626,1.192,0,19.59190606,0.6717572755,0.1507120743,5.08,305.109,13591.75,15617.36035,7500.5,7286.319824,3189.379883,63915.42188,19818.90039,116.0960002,104.2437501,117.8693748,111.2824654,125.8154995,131.0218506,120.6091484,68.60408862,3.591960689,3.865981784,-0.274021095,3.304999215,123.8036573,10095028300,73.45599874,71.29315498,13.43000031,Student Loan Payments Restart in October. That Could Be Bad News for Amazon,"After three years, federal student loan payments are set to resume in October. Retailers with a heavy dependence on age groups likely to have student loans, including Amazon and Target, will likely feel some pain.",https://www.fool.com/investing/2023/06/28/student-loan-payments-restart-in-october-that-coul/,fool.com,7,three year federal student loan payment set resume october retailer heavy dependence age group likely student loan including amazon target likely feel pain,-0.3818,-0.26726,0.3337133333,-0.600973333,Negative Impact
29/06/2023,128.77,129.26,127.26,127.90,127.90,40761000,2.95,51.45734626,1.192,0,19.59190606,0.6717572755,0.1507120743,5.08,305.109,13591.33008,15737.37988,7471.700195,7312.72998,3182.379883,63915.42188,19913.19922,116.6080002,104.2010001,118.2627328,111.447814,126.1814995,130.8383457,121.5246532,59.54998896,3.393799517,3.771545331,-0.377745814,3.133570535,124.4185651,10054267300,56.74695606,69.64404489,13.53999996,Could AI Reignite Growth at Amazon's AWS?,"Last year, Amazon reported its first annual loss in almost a decade. The company struggled with headwinds such as higher inflation -- and even AWS, its biggest profit generator, eventually suffered.",https://www.fool.com/investing/2023/06/29/could-ai-reignite-growth-at-amazons-aws/,fool.com,7,last year amazon reported first annual loss almost decade company struggled headwind higher inflation even aws biggest profit generator eventually suffered,-0.4654,-0.32578,0.125255625,-0.451035625,Negative Impact
30/06/2023,129.47,131.25,128.95,130.36,130.36,54310500,2.95,51.45734626,1.192,0,19.59190606,0.6717572755,0.1507120743,5.08,305.109,13787.91992,15875.91016,7531.5,7400.060059,3202.060059,64718.55859,20155.30078,117.1292001,104.2187001,118.7371354,111.635995,126.5609997,131.2838588,121.8381405,66.69881434,3.396108503,3.696457965,-0.300349462,3.186427525,124.9842804,10108577800,85.80397073,72.00230851,13.59000015,The Top 3 E-Commerce Companies to Invest In 2023,"Multiple signs show that, in-line with my previous predictions, e-commerce is bouncing back. One such indicator is when JPMorgan recently predicted that Amazon's (NASDAQ: AMZN ) gross merchandise volume (GMV) would surge 11.6% this year.",https://investorplace.com/2023/06/the-top-3-e-commerce-companies-to-invest-in-2023/,investorplace.com,6,multiple sign show inline previous prediction ecommerce bouncing back one indicator jpmorgan recently predicted amazon nasdaq amzn gross merchandise volume gmv would surge year,-0.34,-0.204,0.3634221429,-0.567422143,Negative Impact
03/07/2023,130.82,131.85,130.07,130.22,130.22,28264800,2.95,51.45734626,1.192,0,19.59190606,0.6717572755,0.1507120743,5.12,305.691,13816.76953,15918.5,7527.299805,7386.700195,3243.97998,65205.05078,20155.30078,117.6574002,104.2270501,119.1874439,111.8209105,126.8594997,131.7199994,121.9990001,60.2817077,3.348047404,3.626775853,-0.278728449,3.07428469,125.5047384,10080313000,79.6249584,74.05862839,13.56999969,"As Prime Day nears, will the Feds rain on Amazon's parade yet again?",The Federal Trade Commission's most recent charges against Amazon.com Inc. coincided with the company's announcement of its Prime Day dates. Will the agency seek to rain on the e-commerce giant's parade once the actual event arrives?,https://www.marketwatch.com/story/as-prime-day-nears-will-the-feds-rain-on-amazons-parade-yet-again-6e84b3,marketwatch.com,8,federal trade commission recent charge amazoncom inc coincided company announcement prime day date agency seek rain ecommerce giant parade actual event arrives,0,0,0.3192518182,-0.319251818,Negative Impact
05/07/2023,130.24,131.40,129.64,130.38,130.38,35895400,2.95,51.45734626,1.192,0,19.59190606,0.6717572755,0.1507120743,5.12,305.691,13791.65039,15835.53027,7442.100098,7310.810059,3222.949951,65446.03906,20103.90039,118.1258003,104.2475501,119.6263678,112.0055781,127.1134998,132.1583049,122.0686948,60.43772745,3.285002135,3.558421109,-0.273418974,2.969284058,126.1392651,10116208400,81.62500226,82.35131046,14.18000031,One analyst makes a case for the ÃÂÃÂFTC's non-case' against Amazon,"For more than a year, Amazon.com Inc. has braced for the Federal Trade Commission's major antitrust action, led by Lina Khan.",https://www.marketwatch.com/story/one-analyst-makes-a-case-for-the-ftcs-non-case-against-amazon-b84f67fb,marketwatch.com,8,year amazoncom inc braced federal trade commission major antitrust action led lina khan,0,0,0.308258,-0.308258,Negative Impact
06/07/2023,128.25,128.73,127.37,128.36,128.36,40639900,2.95,51.45734626,1.192,0,19.59190606,0.6717572755,0.1507120743,5.12,305.691,13679.04004,15641.66992,7280.5,7082.290039,3205.570068,65785.64063,19810.69922,118.5688004,104.2717001,119.9688632,112.1683086,127.2009998,132.2696839,122.1323157,54.94899198,3.03703183,3.454143253,-0.417111424,2.982141767,126.7103392,10075568500,56.37497294,72.54164453,15.43999958,Amazon sellers say they were kicked off site after unknowingly hawking stolen goods,"Dozens of third-party sellers have been suspended by Amazon in recent months for unknowingly selling stolen coffee makers, humidifiers and computer monitors.",https://www.cnbc.com/2023/07/06/amazon-sellers-suspended-over-stolen-goods-caught-in-crime-ring.html,cnbc.com,9,dozen thirdparty seller suspended amazon recent month unknowingly selling stolen coffee maker humidifiers computer monitor,-0.6808,-0.61272,0.2608370588,-0.873557059,Negative Impact
07/07/2023,128.59,130.97,128.13,129.78,129.78,41928700,2.95,51.45734626,1.192,0,19.59190606,0.6717572755,0.1507120743,5.12,305.691,13660.71973,15671.62988,7256.899902,7111.879883,3196.610107,65280.44922,19831,119.1130003,104.2973001,120.3536137,112.3435493,127.6284996,131.9662948,123.2907044,56.56665503,2.921419259,3.347598454,-0.426179196,2.944284167,127.2243059,10117497200,74.12493312,70.70830278,14.82999992,Is Now a Good Time to Buy Growth Stocks?,"Growth stocks suffered last year. But today, they're leading the market rally.",https://www.fool.com/investing/2023/07/07/is-now-a-good-time-to-buy-growth-stocks/,fool.com,7,growth stock suffered last year today theyre leading market rally,-0.1531,-0.10717,0.3034855,-0.4106555,Negative Impact
10/07/2023,129.07,129.28,125.92,127.13,127.13,61889300,2.95,51.45734626,1.192,0,19.59190606,0.6717572755,0.1507120743,5.12,305.691,13685.48047,15748.87012,7273.799805,7143.689941,3203.699951,65344.17188,19822.5,119.5560002,104.3220001,120.6193542,112.4906782,127.7724995,131.819532,123.7254669,53.83895526,2.586150949,3.195308953,-0.609158005,3.034284319,131.8500061,10055607900,40.99994564,57.16661723,15.06999969,Amazon's Prime Day to Test Consumer Demand,The indicator of shopping patterns arrives this year after a period of slow sales for the company and concerns about the economy.,https://www.wsj.com/articles/amazons-prime-day-to-test-consumer-demand-cc976288,wsj.com,9,indicator shopping pattern arrives year period slow sale company concern economy,0,0,0.3115407143,-0.311540714,Negative Impact
11/07/2023,127.75,129.77,127.35,128.78,128.78,49951500,2.95,51.45734626,1.192,0,19.59190606,0.6717572755,0.1507120743,5.12,305.691,13760.7002,15897.30957,7282.5,7220.009766,3221.370117,65617.84375,19878.59961,119.9352002,104.3732001,120.9393795,112.652761,128.0399994,131.5501164,124.5298824,56.60212119,2.425628594,3.041372881,-0.615744287,3.026427678,131.7314059,10105559400,61.62494504,58.91660794,14.84000015,Amazon Prime Day May Be Consumers' Last Hurrah Before The Recession Sets In,"While the economy has not yet fallen into recession, a consumer recession is already here with a pullback in spending, especially for discretionary purchases.",https://www.forbes.com/sites/pamdanziger/2023/07/11/amazon-prime-day-may-be-consumers-last-hurrah-before-the-recession-sets-in/,forbes.com,8,economy yet fallen recession consumer recession already pullback spending especially discretionary purchase,-0.7964,-0.63712,0.1469955172,-0.784115517,Negative Impact
12/07/2023,130.31,131.26,128.83,130.80,130.80,54022800,2.95,51.45734626,1.192,0,19.59190606,0.6717572755,0.1507120743,5.12,305.691,13918.95996,16011.28027,7416.100098,7333.009766,3196.129883,65393.89844,20070.80078,120.4422003,104.4406501,121.3260706,112.8333305,128.2514996,131.8958593,124.6071398,62.54730293,2.433360668,2.919770439,-0.486409771,2.997855595,131.6151778,10159582200,84.35168404,62.32552491,13.53999996,Amazon: AWS Growth Is Underappreciated And Stock Is Undervalued,"Amazon's AWS business is experiencing significant growth due to ongoing cloud migration and AI adoption. Amazon's AWS business enjoys higher margins than other ventures, and the company's investments in AI and cloud infrastructure could greatly benefit AWS in the near future. Despite some risks, such as moderated spending on discretionary categories and high capital expenditure, I believe Amazon's stock price is significantly undervalued given its growth potential.",https://seekingalpha.com/article/4616641-amazon-aws-growth-is-underappreciated-stock-is-undervalued,seekingalpha.com,6,amazon aws business experiencing significant growth due ongoing cloud migration ai adoption amazon aws business enjoys higher margin venture company investment ai cloud infrastructure could greatly benefit aws near future despite risk moderated spending discretionary category high capital expenditure believe amazon stock price significantly undervalued given growth potential,0.9478,0.56868,0.269760625,0.298919375,Positive Impact
13/07/2023,134.04,134.67,132.71,134.30,134.30,61170900,2.95,51.45734626,1.192,0,19.59190606,0.6717572755,0.1507120743,5.12,305.691,14138.57031,16106.84961,7440.200195,7369.799805,3236.47998,65558.89063,20277.59961,121.0872003,104.5432501,121.8348523,113.0469293,128.6334995,133.0872267,124.1797724,59.44472419,2.690890234,2.873994398,-0.183104164,2.881426675,125.9199982,10220753100,95.77148438,80.58270449,13.60999966,NLRB Files Complaint Against Amazon For Refusing To Bargain With Warehouse Labor Union,"The NLRB is seeking an order that forces Amazon to ÃÂÃÂbargain in good faithÃÂÃÂ with the union, among other things.",https://www.forbes.com/sites/siladityaray/2023/07/13/nlrb-files-complaint-against-amazon-for-refusing-to-bargain-with-warehouse-labor-union/,forbes.com,8,nlrb seeking order force amazon bargain good faith union among thing,0.802,0.6416,0.3020026316,0.3395973684,Positive Impact
14/07/2023,134.06,136.65,134.06,134.68,134.68,54388100,2.95,51.45734626,1.192,0,19.59190606,0.6717572755,0.1507120743,5.12,305.691,14113.7002,16040.23047,7434.600098,7374.540039,3237.699951,66060.89844,20262.09961,121.7082002,104.6409001,122.3385832,113.2621836,129.0464993,134.1241826,123.9688159,62.42451217,2.892305559,2.87765663,0.01464892882,2.883569445,126.0949982,10275141200,81.64024226,87.25447023,13.34000015,Amazon seller consultant avoids jail in employee bribery scheme,"Amazon seller consultant Ephraim ""Ed"" Rosenberg was sentenced Friday to probation and house arrest for his involvement in a scheme to bribe company employees.",https://www.cnbc.com/2023/07/14/amazon-seller-consultant-avoids-jail-in-employee-bribery-scheme.html,cnbc.com,9,amazon seller consultant ephraim ed rosenberg sentenced friday probation house arrest involvement scheme bribe company employee,-0.3818,-0.34362,0.1824458333,-0.526065833,Negative Impact
17/07/2023,134.56,135.62,133.21,133.56,133.56,48450200,2.95,51.45734626,1.192,0,19.59190606,0.6717572755,0.1507120743,5.12,305.691,14244.9502,16054.16992,7406.399902,7291.660156,3209.629883,66589.92969,20226.80078,122.3064001,104.73665,122.7786387,113.4641519,129.3689991,134.7396825,123.9983157,65.08475102,2.927804501,2.887686204,0.04011829722,2.742139544,126.517198,10226691000,71.20225938,82.87132867,13.47999954,How the NASDAQ 100 Special Rebalancing Will Hurt Performance,"On July 7, 2023, the Nasdaq announced it would implement a special rebalancing for the Nasdaq 100 index, tracked by the Invesco QQQ ETF NASDAQ: QQQ effective after hours on July 21, 2023, and pre-market on July 24, 2023. It will be based on the index securities closing prices and outstanding shares as of July 3, 2023.",https://www.marketbeat.com/originals/how-the-nasdaq-100-special-rebalancing-will-hurt-performance/?utm_source=snapi,www.marketbeat.com,5,july nasdaq announced would implement special rebalancing nasdaq index tracked invesco qqq etf nasdaq qqq effective hour july premarket july based index security closing price outstanding share july,0.9246,0.4623,0.25479,0.20751,Positive Impact
18/07/2023,132.71,133.86,131.35,132.83,132.83,54969100,2.95,51.45734626,1.192,0,19.59190606,0.6717572755,0.1507120743,5.12,305.691,14353.63965,16156.50977,7453.700195,7319.180176,3197.820068,66795.14063,20376.59961,122.8830002,104.81075,123.1728098,113.6568469,129.7359993,134.992539,124.4794596,59.34462938,2.864018492,2.882952662,-0.018934169,2.724282401,126.9225098,10171721900,64.39894141,72.41381435,13.30000019,"Amazon And Apple Blocked Third-Party iPhone SellersÃÂÃÂDriving Up Prices, Spain's Antitrust Watchdog Alleges",Two of the world's biggest companies have been accused of colluding to suppress competition in Spain.,https://www.forbes.com/sites/maryroeloffs/2023/07/18/amazon-and-apple-blocked-third-party-iphone-sellers-driving-up-prices-spains-antitrust-watchdog-alleges/,forbes.com,8,two world biggest company accused colluding suppress competition spain,-0.5267,-0.42136,0.1289216667,-0.550281667,Negative Impact
19/07/2023,133.39,135.99,132.53,135.36,135.36,54531000,2.95,51.45734626,1.192,0,19.59190606,0.6717572755,0.1507120743,5.12,305.691,14358.01953,16230.94043,7588.200195,7326.939941,3198.840088,67097.4375,20491.19922,123.4770001,104.91355,123.6507389,113.8727987,130.2149994,135.6948933,124.7351055,64.41608634,2.983228576,2.903007845,0.0802207315,2.75428336,127.3116092,10226252900,87.97769059,74.52629713,13.76000023,Our Dividend Growth Portfolio Continues To Outpace The S&P 500,"In 2015, I purchased 15 of the largest cap U.S. dividend achievers, which have continued to outpace the S&P 500. The portfolio was designed to provide greater protection during recessions and severe bear markets, and began to pull away from the S&P 500 after the world changed in 2020. The portfolio is 55% U.S. stocks and 45% Canadian stocks, with modest allocations to bonds, cash, gold and bitcoin, and a few thematic plays in the electric vehicle and battery space.",https://seekingalpha.com/article/4618258-our-dividend-growth-portfolio-continues-to-outpace-the-s-and-p-500,seekingalpha.com,6,purchased largest cap u dividend achiever continued outpace sp portfolio designed provide greater protection recession severe bear market began pull away sp world changed portfolio u stock canadian stock modest allocation bond cash gold bitcoin thematic play electric vehicle battery space,-0.128,-0.0768,0.3712733333,-0.448073333,Negative Impact
20/07/2023,134.07,134.79,129.33,129.96,129.96,59820600,2.95,51.45734626,1.192,0,19.59190606,0.6717572755,0.1507120743,5.12,305.691,14063.30957,16263.70996,7646.100098,7384.910156,3169.52002,67571.89844,20436.90039,123.9596002,104.9983501,123.8981611,114.0328704,130.4714996,135.3357592,125.6072401,53.93431315,2.611861139,2.844778504,-0.232917364,3.042140961,127.6851446,10166432300,37.65153918,63.34272373,13.98999977,Who could buy a piece of ESPN? Here are seven candidates,Disney chief executive officer Bob Iger shook up Wall Street Thursday when he told CNBC he's open to finding a strategic partner for ESPN.,https://www.marketwatch.com/story/who-could-buy-a-piece-of-espn-here-are-seven-candidates-6cd3e7f0,marketwatch.com,8,disney chief executive officer bob iger shook wall street thursday told cnbc he open finding strategic partner espn,-0.1027,-0.08216,0.2613542857,-0.343514286,Negative Impact
21/07/2023,131.34,131.37,128.42,130.00,130.00,133265000,2.95,51.45734626,1.192,0,19.59190606,0.6717572755,0.1507120743,5.12,305.691,14032.80957,16289.12012,7663.700195,7432.77002,3167.75,66684.25781,20547.5,124.4272002,105.0689501,124.1374489,114.1917474,130.4639999,135.3308085,125.5971914,49.2424223,2.294329294,2.734688662,-0.440359368,3.013569423,128.0437386,10299697300,38.02426333,54.55116437,13.60000038,Biden gets tech titans to pledge guardrails on AI risks,"President Joe Biden got US tech giants to pledge guardrails against risks from artificial intelligence, ranging from cyber-attacks to fraud, ahead of a White House summit Friday on how to manage the expanding sector.",https://techxplore.com/news/2023-07-biden-tech-titans-pledge-guardrails.html,techxplore.com,5,president joe biden got u tech giant pledge guardrail risk artificial intelligence ranging cyberattacks fraud ahead white house summit friday manage expanding sector,-0.4215,-0.21075,0.26210625,-0.47285625,Negative Impact
24/07/2023,130.31,131.66,128.35,128.80,128.80,45591100,2.95,51.45734626,1.192,0,19.59190606,0.6717572755,0.1507120743,5.12,305.691,14058.87012,16369.13965,7678.600098,7427.310059,3164.159912,66384.78125,20582.09961,124.7994002,105.1075001,124.3202942,114.3371031,130.4375,135.3359758,125.5390242,47.13940472,1.923678328,2.572486595,-0.648808267,3.12285505,136.6499939,10254106200,26.84068993,34.17216415,13.90999985,Here are 4 signs that markets are looking frothy in 2023,"Seemingly everywhere investors look, markets appear to be booming in 2023, a stark turnaround from the doldrums of 2022.",https://www.marketwatch.com/story/here-are-4-signs-that-markets-are-looking-frothy-in-2023-aa365de7,marketwatch.com,8,seemingly everywhere investor look market appear booming stark turnaround doldrums,0,0,0.3535223077,-0.353522308,Negative Impact
25/07/2023,129.31,129.58,128.53,129.13,129.13,39236700,2.95,51.45734626,1.192,0,19.59190606,0.6717572755,0.1507120743,5.12,305.691,14144.55957,16385.16992,7691.799805,7415.450195,3231.52002,66355.71094,20551.5,125.1384003,105.1484002,124.5089103,114.4842962,130.5275002,135.2485071,125.8064932,47.4989971,1.637684944,2.385526265,-0.747841321,3.072141375,136.4839941,10293342900,29.9161975,31.59371692,13.85999966,IRBT Stock Sinks 12% as Amazon Lowers iRobot Price,"Shares of consumer robotics firm iRobot (NASDAQ: IRBT ) ÃÂÃÂ which specializes in automated vacuum machines ÃÂÃÂ suffered a sharp drop on Tuesday. Amid the buyout deal by e-commerce juggernaut Amazon (NASDAQ: AMZN ), which sparked regulatory antitrust fervor, iRobot entered into an unfavorable financing facility.",https://investorplace.com/2023/07/irbt-stock-sinks-12-as-amazon-lowers-irobot-price/,investorplace.com,6,share consumer robotics firm irobot nasdaq irbt specializes automated vacuum machine suffered sharp drop tuesday amid buyout deal ecommerce juggernaut amazon nasdaq amzn sparked regulatory antitrust fervor irobot entered unfavorable financing facility,-0.34,-0.204,0.2865734783,-0.490573478,Negative Impact
26/07/2023,126.51,129.08,126.11,128.15,128.15,53910100,2.95,51.45734626,1.192,0,19.59190606,0.6717572755,0.1507120743,5.12,305.691,14127.28027,16418.21094,7676.899902,7315.069824,3223.030029,66707.20313,20561.59961,125.4962001,105.1876501,124.6516979,114.6202733,130.4760002,135.2806312,125.6713693,49.56157229,1.316775462,2.171776104,-0.855000642,3.072855813,136.3213144,10239432800,20.78282027,25.84656924,13.18999958,Amazon offers to change marketplace rules in the U.K. to address concerns from the competition authority,"Amazon.com Inc. AMZN, +0.26% has offered to change its own marketplace rules regarding third-party sellers in the U.K. to address concerns raised by the Competition and Markets Authority, or CMA, the regulator said in a statement. The CMA ÃÂÃÂconsiders that these commitments ÃÂÃÂ if accepted ÃÂÃÂ will ensure third-party sellers' product offers have a fair chance of being prominently displayed to customers in the ÃÂÃÂBuy Box' on a product page when they are competing against Amazon's own product offers,ÃÂÃÂ said the statement.",https://www.marketwatch.com/story/amazon-offers-to-change-marketplace-rules-in-the-u-k-to-address-concerns-from-the-competition-authority-f93fc5d0,marketwatch.com,8,amazoncom inc amzn offered change marketplace rule regarding thirdparty seller uk address concern raised competition market authority cma regulator said statement cma considers commitment accepted ensure thirdparty seller product offer fair chance prominently displayed customer buy box product page competing amazon product offer said statement,0.891,0.7128,0.2652752174,0.4475247826,Positive Impact
27/07/2023,131,132.63,127.79,128.25,128.25,52610700,2.95,51.45734626,1.192,0,19.59190606,0.6717572755,0.1507120743,5.12,305.691,14050.11035,16270.59961,7692.799805,7465.240234,3216.669922,66266.82031,20385.5,125.8372002,105.2561001,124.7928078,114.7558925,130.4365005,135.303425,125.5695761,46.61953274,1.058322361,1.949085356,-0.890762994,3.215713501,135.9128618,10292043500,21.71484398,24.13795392,14.40999985,Cell Tower REITs: Toxic Telecom?,"Cell Tower REITs have been the weakest-performing property sector since the start of 2022 - lagging even the battered office sector - amid a telecommunications industry-wide slump inflamed by tight monetary conditions. Cellular carriers have curbed their capital-intensive network expansion plans in recent quarters following a significant wave of investment and tower equipment upgrades from 2019-2022 to deploy nationwide 5G networks. The latest selloff was intensified by an expose alleging that century-old abandoned phone lines owned by AT&T and Verizon are leaching toxic lead into drinking water, potentially requiring costly remediation.",https://seekingalpha.com/article/4620353-cell-tower-reits-toxic-telecom,seekingalpha.com,6,cell tower reit weakestperforming property sector since start lagging even battered office sector amid telecommunication industrywide slump inflamed tight monetary condition cellular carrier curbed capitalintensive network expansion plan recent quarter following significant wave investment tower equipment upgrade deploy nationwide g network latest selloff intensified expose alleging centuryold abandoned phone line owned att verizon leaching toxic lead drinking water potentially requiring costly remediation,-0.7717,-0.46302,0.1091853846,-0.572205385,Negative Impact
28/07/2023,129.69,133.01,129.33,132.21,132.21,46317400,2.95,51.45734626,1.192,0,19.59190606,0.6717572755,0.1507120743,5.12,305.691,14316.66016,16363.25977,7694.299805,7476.470215,3275.929932,66160.20313,20519.40039,126.2134003,105.3488002,125.0836783,114.9295652,130.6520008,135.426841,125.8771606,60.60988004,1.159667934,1.791201871,-0.631533938,3.279998779,135.5207474,10338360900,57.87485758,33.45750728,13.32999992,2 Breakout Growth Stocks You Can Buy and Hold for the Next Decade,Amazon still has a few tricks up its sleeve. Cybersecurity is an intensifying threat that AI-powered CrowdStrike combats daily.,https://www.fool.com/investing/2023/07/28/2-breakout-growth-stocks-you-can-buy-and-hold-for/,fool.com,7,amazon still trick sleeve cybersecurity intensifying threat aipowered crowdstrike combat daily,-0.6486,-0.45402,0.2720315385,-0.726051538,Negative Impact
31/07/2023,133.2,133.87,132.38,133.68,133.68,41901500,2.95,51.45734626,1.192,0,19.59190606,0.6717572755,0.1507120743,5.12,305.691,14346.01953,16427.28906,7699.399902,7497.779785,3291.040039,66527.67188,20626.59961,126.5770001,105.4561501,125.4207887,115.1161366,130.8180004,135.7773737,125.8586271,60.31144397,1.343117984,1.701585094,-0.35846711,3.20999745,135.1443175,10380262400,71.82160235,50.47043464,13.63000011,San Francisco's push to turn office buildings into homes hinges on this simple idea,"Converting San Francisco's old downtown office buildings into housing won't be an easy task, with high costs, clunky floorplates and existing tenants in sparsely populated buildings only a few of the obstacles developers need to overcome.",https://www.marketwatch.com/story/san-franciscos-push-to-turn-office-buildings-into-homes-hinges-on-this-simple-idea-a83af10e,marketwatch.com,8,converting san franciscos old downtown office building housing wont easy task high cost clunky floorplates existing tenant sparsely populated building obstacle developer need overcome,-0.6002,-0.48016,0.21127375,-0.69143375,Negative Impact
01/08/2023,133.55,133.69,131.62,131.69,131.69,42098500,2.95,51.45734626,1.192,0,19.59190606,0.6717572755,0.1507120743,5.33,307.026,14283.91016,16356.50977,7666.299805,7406.080078,3290.948975,66459.3125,20532.90039,126.8478001,105.5501001,125.6666402,115.2810507,130.8915005,135.8571257,125.9258752,51.87526484,1.312794808,1.623827036,-0.311032229,3.180712564,134.7829448,10338163900,52.94122757,60.87922917,13.93000031,Amazon & Apple Earnings: What to Expect,"Earnings season continues to chug along, with the period kicking into a much higher gear this week. So far, the Q2 cycle has been positive, helping reassure investors and boosting overall sentiment within the market.",https://www.zacks.com/commentary/2130646/amazon-apple-earnings-what-to-expect,zacks.com,8,earnings season continues chug along period kicking much higher gear week far q cycle positive helping reassure investor boosting overall sentiment within market,0.8625,0.69,0.24967375,0.44032625,Positive Impact
02/08/2023,130.15,130.23,126.82,128.21,128.21,51027600,2.95,51.45734626,1.192,0,19.59190606,0.6717572755,0.1507120743,5.33,307.026,13973.4502,16174.54004,7561.600098,7312.839844,3261.689941,65782.78125,20218.19922,127.0870003,105.6285002,125.7663801,115.4096971,130.7830006,135.8885424,125.6774587,37.15730415,0.9964702123,1.498355672,-0.501885459,3.25214168,134.4360271,10287136300,19.92416927,48.22899973,16.09000015,World's 10 Richest People Lose $27 Billion As Tech Stocks Sink,"History suggests the federal debt rating downgrade won't impact stocks for long, as stocks continued their upward trajectory after a brief blip in the aftermath of the S&P's similar decision 12 years ago.",https://www.forbes.com/sites/dereksaul/2023/08/02/worlds-10-richest-people-lose-27-billion-as-tech-stocks-sink/,forbes.com,8,history suggests federal debt rating downgrade wont impact stock long stock continued upward trajectory brief blip aftermath sps similar decision year ago,-0.3612,-0.28896,0.2122853333,-0.501245333,Negative Impact
03/08/2023,127.48,129.84,126.41,128.91,128.91,88585200,2.95,51.45734626,1.192,0,19.59190606,0.6717572755,0.1507120743,5.33,307.026,13959.71973,16125.41992,7529.200195,7260.529785,3280.462891,65240.67969,20120.69922,127.3650003,105.7385502,125.8896594,115.5440285,130.8105007,135.8667779,125.7542235,37.99418095,0.7931219786,1.357308933,-0.564186954,3.312141418,134.102986,10375721500,28.34009785,33.7351649,15.92000008,"Apple, Amazon, Airbnb Beat on Earnings, Sales","If these after-hours earnings don't do it, we'll see if tomorrow's Employment Situation report has what it takes to light a fire under bullish investors going forward.",https://www.zacks.com/stock/news/2132310/apple-amazon-airbnb-beat-on-earnings-sales,zacks.com,8,afterhours earnings dont well see tomorrow employment situation report take light fire bullish investor going forward,-0.4963,-0.39704,0.275195,-0.672235,Negative Impact
04/08/2023,141.06,143.63,139.32,139.57,139.57,152938700,2.95,51.45734626,1.192,0,19.59190606,0.6717572755,0.1507120743,5.33,307.026,13909.24023,16071.05957,7564.399902,7315.069824,3288.083984,65721.25,20236,127.8566005,105.8674502,126.4261437,115.7830929,131.3000011,137.6629369,124.9370654,58.95146547,1.475135797,1.380874306,0.09426149142,4.191428048,126.1100006,10528660200,76.8265036,41.69692358,17.10000038,"Amazon stock rockets 11%, on pace for best day since November after blowout quarter","Analysts cheered stabilizing AWS growth, improving retail margins, and progress on cutting costs.",https://www.cnbc.com/2023/08/04/amazon-stock-on-pace-for-best-day-since-november-after-blowout-quarter.html,cnbc.com,9,analyst cheered stabilizing aws growth improving retail margin progress cutting cost,0.875,0.7875,0.3051021429,0.4823978571,Positive Impact
07/08/2023,140.99,142.54,138.95,142.22,142.22,71213100,2.95,51.45734626,1.192,0,19.59190606,0.6717572755,0.1507120743,5.33,307.026,13994.40039,16208.23047,7554.5,7319.759766,3268.831055,65953.47656,20236,128.3660005,105.9967502,127.0455106,116.0461468,132.0545013,139.7703098,124.3386929,63.22908708,2.204061968,1.545511838,0.65855013,4.268571036,126.4100037,10599873300,91.95203585,65.70621244,15.77000046,Amazon switches rockets for first test satellites for sooner launch,"Amazon.com Inc plans to launch its first pair of prototype internet satellites late next month on a different rocket than previously planned, a spokesman said on Monday, again switching rides for the spacecraft to avoid mounting rocket delays.",https://www.reuters.com/science/amazon-switches-rockets-first-test-satellites-sooner-launch-2023-08-07/,reuters.com,10,amazoncom inc plan launch first pair prototype internet satellite late next month different rocket previously planned spokesman said monday switching ride spacecraft avoid mounting rocket delay,-0.5423,-0.5423,0.244696,-0.786996,Negative Impact
08/08/2023,140.62,140.84,138.42,139.94,139.94,51710500,2.95,51.45734626,1.192,0,19.59190606,0.6717572755,0.1507120743,5.33,307.026,13884.32031,16176.34961,7527.399902,7269.470215,3260.620117,65846.5,20206,128.8648006,106.1211002,127.551177,116.2838966,132.6125015,140.9225025,124.3025005,56.4983046,2.568160212,1.750041513,0.8181186985,4.292856489,126.7544037,10548162800,78.93834737,82.57229561,15.98999977,What Are the Best Stocks to Buy for Beginners? Our 3 Picks for August,"Recent reports show the U.S. gross domestic product (GDP) grew at an annual rate of 2.4% from April to June 2023, a faster rate than formerly predicted. The economy is shaping out to be even more resilient to avoid a recession this year.",https://investorplace.com/2023/08/what-are-the-best-stocks-to-buy-for-beginners-our-3-picks-for-august/,investorplace.com,6,recent report show u gross domestic product gdp grew annual rate april june faster rate formerly predicted economy shaping even resilient avoid recession year,-0.7964,-0.47784,0.293284,-0.771124,Negative Impact
09/08/2023,139.97,140.32,137.10,137.85,137.85,50017300,2.95,51.45734626,1.192,0,19.59190606,0.6717572755,0.1507120743,5.33,307.026,13722.01953,16135.76953,7587.299805,7322.040039,3244.48999,65995.8125,20275.30078,129.2196007,106.2341003,127.9550526,116.4984847,132.9650017,141.5449996,124.3850038,62.35515968,2.65743223,1.931519656,0.7259125738,4.092142378,127.0919157,10498145500,67.00914743,79.29984355,15.96000004,7 Tech Stocks to Hop On After Red-Hot Earnings,"The technology-laden NASDAQ continues to lead this year's market rally, having risen 34% since Jan. The Q2 prints by leading technology concerns have served to underpin the index and position it for a continued bull run into year's end. With a few exceptions such as Apple (NASDAQ: AAPL ), the Q2 results from the dominant technology companies have beaten Wall Street expectations.",https://investorplace.com/2023/08/7-tech-stocks-to-buy/,investorplace.com,6,technologyladen nasdaq continues lead year market rally risen since jan q print leading technology concern served underpin index position continued bull run year end exception apple nasdaq aapl q result dominant technology company beaten wall street expectation,-0.4215,-0.2529,0.2650433333,-0.517943333,Negative Impact
10/08/2023,139.07,140.41,137.49,138.56,138.56,58928400,2.95,51.45734626,1.192,0,19.59190606,0.6717572755,0.1507120743,5.33,307.026,13737.99023,16135.21973,7618.600098,7433.620117,3254.560059,65688.17969,20342.90039,129.5576006,106.3303003,128.3709328,116.7180023,133.1780014,142.1021508,124.253852,63.12884044,2.753728062,2.095961338,0.6577667245,4.089999608,127.4226775,10557073900,71.06160909,72.33636796,15.85000038,"Analysis: Despite 'weak' accord, Amazon summit bolsters call for rich to pay up","Amazon rainforest nations emerged from a summit this week with a stronger hand to play at upcoming United Nations climate talks, despite the meeting's lackluster final agreement, according to environmental groups.",https://www.reuters.com/business/environment/despite-weak-accord-amazon-summit-bolsters-call-rich-pay-up-2023-08-10/,reuters.com,10,amazon rainforest nation emerged summit week stronger hand play upcoming united nation climate talk despite meeting lackluster final agreement according environmental group,0.9313,0.9313,0.2763586957,0.6549413043,Positive Impact
11/08/2023,137.4,139.33,137.00,138.41,138.41,42832100,2.95,51.45734626,1.192,0,19.59190606,0.6717572755,0.1507120743,5.33,307.026,13644.84961,16143.37988,7524.200195,7340.189941,3189.25,65322.64844,20407.59961,129.9142006,106.4232503,128.7646219,116.9338431,133.364502,142.5722141,124.1567898,65.2298082,2.785826673,2.233934405,0.5518922683,4.019999913,127.746824,10514241800,70.20547975,69.42541209,14.84000015,Amazon's Palm-Payment Effort Is a Sneak Attack on Apple and Google,"It's also a potentially massive play to make Amazon the central ID system for your whole lifeÃÂÃÂfrom banking and loyalty programs to tickets, age verification and someday even health records and corporate ID cards.",https://www.wsj.com/articles/amazon-wants-you-to-pay-with-your-palm-its-a-sneak-attack-on-apple-and-google-e8e417a,wsj.com,9,also potentially massive play make amazon central id system whole lifefrom banking loyalty program ticket age verification someday even health record corporate id card,0.765,0.6885,0.2331566667,0.4553433333,Positive Impact
14/08/2023,138.3,140.59,137.75,140.57,140.57,47148700,2.95,51.45734626,1.192,0,19.59190606,0.6717572755,0.1507120743,5.33,307.026,13788.33008,16116.0498,7507.200195,7348.839844,3178.429932,65401.92188,20290.5,130.2702008,106.5231003,129.2275782,117.1690288,133.7150024,143.4713866,123.9586183,67.1360264,2.951535829,2.37745469,0.5740811396,4.147856576,128.0644877,10561390500,82.53426477,74.6004512,14.81999969,"Another Amazon exec, its devices chief, is leaving","Amazon.com Inc. AMZN, +1.56% is losing another executive. David Limp, senior vice president of devices & services, plans to retire this year ÃÂÃÂ the latest departure of a longstanding Amazon executive since company Chief Executive Andy Jassy took over in 2021.",https://www.marketwatch.com/story/another-amazon-exec-its-devices-chief-is-leaving-106d7618,marketwatch.com,8,amazoncom inc amzn losing another executive david limp senior vice president device service plan retire year latest departure longstanding amazon executive since company chief executive andy jassy took,-0.2263,-0.18104,0.2317494118,-0.412789412,Negative Impact
15/08/2023,140.05,141.28,137.23,137.67,137.67,42781500,2.95,51.45734626,1.192,0,19.59190606,0.6717572755,0.1507120743,5.33,307.026,13631.0498,15911.30957,7389.600098,7267.700195,3176.179932,65401.92188,19899.80078,130.5386008,106.6331503,129.5586535,117.3730185,133.9570023,143.8599618,124.0540427,63.48443581,2.816389442,2.46524164,0.3511478023,4.221427917,128.375798,10518609000,65.38904593,72.70959682,16.45999908,"Amazon Pharmacy Announces Coupons For InsulinÃÂÃÂ Revolutionizing Medication Access, Yet Again","With a commitment to improving patient care and a tech-forward mindset, Amazon Pharmacy is powerful force of innovation.",https://www.forbes.com/sites/saibala/2023/08/15/amazon-pharmacy-announces-coupons-for-insulin--revolutionizing-medication-access-yet-again/,forbes.com,8,commitment improving patient care techforward mindset amazon pharmacy powerful force innovation,0.9287,0.74296,0.33155625,0.41140375,Positive Impact
16/08/2023,137.19,137.27,135.01,135.07,135.07,41675900,2.95,51.45734626,1.192,0,19.59190606,0.6717572755,0.1507120743,5.33,307.026,13474.62988,15818.11035,7356.899902,7260.25,3150.129883,65539.42188,19899.09961,130.7340009,106.7537003,129.774785,117.549108,133.9425026,143.8376589,124.0473463,59.02118391,2.471003238,2.46639396,0.004609278334,4.06571361,128.6808821,10476933100,50.29037775,66.07122948,16.78000069,Taylor Swift and other musicians use valuable data to promote their work. Actors and writers deserve the same.,"Over the past few months, the WGA and SAG-AFTRA strikes have sparked a public discourse about the urgent need for improved and fairer agreements in the film and TV industry. These agreements are a much needed adaptation to the immense transformation witnessed in the past decade, primarily fueled by the rapid rise and dominance of SVOD (streaming video on-demand) platforms including Netflix NFLX, Amazon Prime Video AMZN, Hulu, Disney+ DIS, (HBO) Max, Apple TV+ AAPL, Paramount+ and others.",https://www.marketwatch.com/story/taylor-swift-and-other-musicians-use-valuable-data-to-promote-their-work-actors-and-writers-deserve-the-same-b6e04e4f,marketwatch.com,8,past month wga sagaftra strike sparked public discourse urgent need improved fairer agreement film tv industry agreement much needed adaptation immense transformation witnessed past decade primarily fueled rapid rise dominance svod streaming video ondemand platform including netflix nflx amazon prime video amzn hulu disney dis hbo max apple tv aapl paramount others,0.9062,0.72496,0.2543914286,0.4705685714,Positive Impact
17/08/2023,135.46,136.09,133.53,133.98,133.98,48354100,2.95,51.45734626,1.192,0,19.59190606,0.6717572755,0.1507120743,5.33,307.026,13316.92969,15734.37988,7310.200195,7191.740234,3163.73999,65151.01953,19812.19922,130.8814008,106.9065503,129.9396952,117.7125994,134.143502,143.859741,124.427263,52.53362572,2.085289438,2.390173055,-0.304883617,3.908570971,128.9798646,10428579000,43.96046184,53.21329517,17.88999939,Analysts Have Big Expectations for These 3 Stocks,"We see analyst upgrades and downgrades all the time, commonly coming paired with updated price targets. They can be helpful tools for investors, providing a more structured plan and helping to inject positivity surrounding future performance.",https://www.zacks.com/commentary/2137771/analysts-have-big-expectations-for-these-3-stocks,zacks.com,8,see analyst upgrade downgrade time commonly coming paired updated price target helpful tool investor providing structured plan helping inject positivity surrounding future performance,0.8074,0.64592,0.3154236364,0.3304963636,Positive Impact
18/08/2023,131.62,134.07,131.15,133.22,133.22,48469400,2.95,51.45734626,1.192,0,19.59190606,0.6717572755,0.1507120743,5.33,307.026,13290.78027,15750.16992,7262.399902,7164.109863,3131.949951,64948.66016,19818.40039,131.1212007,107.0604503,130.0683347,117.8669019,134.3045021,143.8366196,124.7723846,49.32789034,1.698701691,2.251878783,-0.553177091,3.998572758,129.2728674,10380109600,39.54702135,44.59928698,17.29999924,California Blue Shield Deal Exposes Amazon's Pharmacy Limitations,This week's announcement that a regional health plan in California would stick with CVS Health for its specialty pharmacy needs exposes a key missing component to Amazon Pharmacy.,https://www.forbes.com/sites/brucejapsen/2023/08/18/california-blue-shield-deal-exposes-amazons-pharmacy-limitations/,forbes.com,8,week announcement regional health plan california would stick cv health specialty pharmacy need expose key missing component amazon pharmacy,-0.2732,-0.21856,0.3461553846,-0.564715385,Negative Impact
21/08/2023,133.74,135.19,132.71,134.68,134.68,41442500,2.95,51.45734626,1.192,0,19.59190606,0.6717572755,0.1507120743,5.33,307.026,13497.58984,15746.20996,7257.799805,7198.060059,3092.97998,65216.08984,19784.90039,131.3298006,107.2499002,130.249184,118.0341963,134.5985016,143.7717323,125.4252709,54.43750776,1.492927685,2.100088563,-0.607160878,4.027857644,129.5600102,10421552100,48.02548448,43.84432256,17.12999916,Stock-index futures gain ground after three-week losing streak,"U.S. stock futures moved higher early Monday, as Wall Street looks to snap a three-week losing streak.",https://www.marketwatch.com/story/stock-index-futures-gain-ground-after-three-week-losing-streak-ee1acee4,marketwatch.com,8,u stock future moved higher early monday wall street look snap threeweek losing streak,-0.3818,-0.30544,0.2854307143,-0.590870714,Negative Impact
22/08/2023,135.08,135.65,133.73,134.25,134.25,32935100,2.95,51.45734626,1.192,0,19.59190606,0.6717572755,0.1507120743,5.33,307.026,13505.87012,15690.28027,7270.799805,7240.879883,3120.330078,65220.03125,19691.19922,131.5462006,107.4605502,130.4060787,118.1955476,134.8545013,143.6637076,126.045295,59.85639592,1.280393903,1.936149631,-0.655755728,3.817143032,129.84141,10388617000,45.52843079,44.36697887,16.96999931,"Amazon Pops Higher After Announcing New TV App But Struggles To Negate This Trend: The Bull, Bear Case","Amazon.com, Inc AMZN opened slightly higher Tuesday before falling to near flat after S&P Global Ratings downgraded several U.S. banks amid the Federal Reserve's continued monetary tightening campaign.",https://www.benzinga.com/trading-ideas/long-ideas/23/08/33987467/amazon-pops-higher-after-announcing-new-tv-app-but-struggles-to-negate-this-trend-the-bu?utm_source=snapi,benzinga.com,5,amazoncom inc amzn opened slightly higher tuesday falling near flat sp global rating downgraded several u bank amid federal reserve continued monetary tightening campaign,-0.0865,-0.04325,0.30999,-0.35324,Negative Impact
23/08/2023,134.5,135.95,133.22,135.52,135.52,42801000,2.95,51.45734626,1.192,0,19.59190606,0.6717572755,0.1507120743,5.33,307.026,13721.03027,15823.26953,7320.5,7246.620117,3078.399902,65433.30078,19879.80078,131.7252007,107.6916502,130.6066248,118.3679303,135.2230019,143.4485931,126.9974106,60.58956368,1.20059833,1.789039371,-0.588441041,3.76714325,130.1171819,10431418000,35.01607796,42.85666441,15.97999954,Top AI Stock Picks And Foot Locker's Disappearing Dividend With Steven Cress,"With the Nasdaq down 5% from July highs, now is the time to scan the AI universe for buy-the-dip stocks. META, AMZN and GOOGL make the cut and NVDA has an outlier valuation metric.",https://seekingalpha.com/article/4630628-top-ai-stock-picks-and-foot-lockers-disappearing-dividend-with-steven-cress,seekingalpha.com,6,nasdaq july high time scan ai universe buythedip stock meta amzn googl make cut nvda outlier valuation metric,-0.2732,-0.16392,0.2708985714,-0.434818571,Negative Impact
24/08/2023,136.4,136.78,131.83,131.84,131.84,43646300,2.95,51.45734626,1.192,0,19.59190606,0.6717572755,0.1507120743,5.33,307.026,13463.96973,15683.00977,7333.600098,7214.459961,3082.23999,65252.33984,19775.80078,131.8288005,107.8959502,130.6549923,118.5019807,135.4025017,143.1289326,127.6760708,34.04866443,0.8308365126,1.597398799,-0.766562287,3.069285801,130.3874384,10387771700,6.057967326,28.86749202,17.20000076,"2 Stocks With Bullish ""Shakeout"" Patterns","During a shakeout, weaker and more speculative investors tend to panic and sell their holdings. However, Strategist Andrew Rocco explains why this process can clear out the market of these unstable participants, leaving behind a more resilient investor base.",https://www.zacks.com/commentary/2140237/2-stocks-with-bullish-shakeout-patterns,zacks.com,8,shakeout weaker speculative investor tend panic sell holding however strategist andrew rocco explains process clear market unstable participant leaving behind resilient investor base,-0.7906,-0.63248,0.2672866667,-0.899766667,Negative Impact
25/08/2023,132.47,133.87,130.58,133.26,133.26,44147500,2.95,51.45734626,1.192,0,19.59190606,0.6717572755,0.1507120743,5.33,307.026,13590.65039,15766.91016,7338.600098,7229.600098,3064.070068,64886.51172,19835.80078,131.9656004,108.1096002,130.7571493,118.6488266,135.4550011,143.1039766,127.8060255,30.52171161,0.6449450677,1.406908053,-0.761962985,3.047857012,143.6300049,10431919200,25.04666766,22.04023765,15.68000031,"BofA sees ""trouble"" ahead for tech stocks despite big inflows","Strategists at BofA Global Research see second-half ""trouble"" for technology stocks even as the sector took in its largest inflow in 10 weeks, the firm said in a note on Friday.",https://www.reuters.com/markets/us/bofa-sees-trouble-ahead-tech-stocks-despite-big-inflows-2023-08-25/,reuters.com,10,strategist bofa global research see secondhalf trouble technology stock even sector took largest inflow week firm said note friday,-0.4019,-0.4019,0.12426125,-0.52616125,Negative Impact
28/08/2023,133.78,133.95,131.85,133.14,133.14,34108400,2.95,51.45734626,1.192,0,19.59190606,0.6717572755,0.1507120743,5.33,307.026,13705.12988,15879.58984,7338.600098,7324.709961,3098.639893,64996.60156,20025.09961,132.0862004,108.3254002,130.8505944,118.7930174,135.4280014,143.1071108,127.748892,33.6851986,0.4823815609,1.222002755,-0.739621194,2.926427569,143.3690048,10397810800,23.92521765,18.34328421,15.07999992,"Hedge fund exposure to 7 biggest tech stocks at record high, Goldman Sachs says","Hedge funds hold record exposure to the seven biggest tech stocks by market capitalization, according to data released on Friday by Goldman Sachs, in a week Nvidia hit an all-time high after beating revenue expectations.",https://www.reuters.com/business/finance/hedge-fund-exposure-7-biggest-tech-stocks-record-high-goldman-sachs-says-2023-08-28/,reuters.com,10,hedge fund hold record exposure seven biggest tech stock market capitalization according data released friday goldman sachs week nvidia hit alltime high beating revenue expectation,-0.4588,-0.4588,0.3376647059,-0.796464706,Negative Impact
29/08/2023,133.38,135.14,133.25,134.91,134.91,38646100,2.95,51.45734626,1.192,0,19.59190606,0.6717572755,0.1507120743,5.33,307.026,13943.75977,16041.49023,7465,7373.430176,3135.889893,65075.82031,20290.40039,132.2746005,108.5692502,131.0097869,118.9533854,135.5890015,143.0706097,128.1073933,42.83624753,0.4907166863,1.075745541,-0.585028855,2.839284624,143.1132248,10436456900,40.46731837,29.8130679,14.44999981,Amazon boss tells office refuseniks to 'work elsewhere',"Amazon chief executive Andy Jassy has launched a blistering attack on company staff who refuse to return to work in the office. According to a memo seen by Business Insider, Jaffy said that those unwilling to comply with the group's 'three days in office' rule should consider working for someone else.",https://www.proactiveinvestors.co.uk/companies/news/1024804?SNAPI,proactiveinvestors.co.uk,5,amazon chief executive andy jassy launched blistering attack company staff refuse return work office according memo seen business insider jaffy said unwilling comply group three day office rule consider working someone else,-0.4767,-0.23835,0.2010978571,-0.439447857,Negative Impact
30/08/2023,134.93,135.68,133.92,135.07,135.07,36137000,2.95,51.45734626,1.192,0,19.59190606,0.6717572755,0.1507120743,5.33,307.026,14019.30957,16074.21973,7473.700195,7364.399902,3137.139893,65087.25,20330.30078,132.4604007,108.7614502,131.1690112,119.1137498,135.9320015,142.5707316,129.2932714,41.26191782,0.5044186671,0.9614801661,-0.457061499,2.75642722,142.8625603,10472593900,41.96268013,35.45173872,13.88000011,A Bull Market is Coming. 2 Stocks You Won't Regret Buying Now.,Carnival has shown investors it has what it takes to pay down its debt. Amazon recently reached an important turning point: The company shifted to an inflow of cash from an outflow.,https://www.fool.com/investing/2023/08/30/bull-market-coming-2-stocks-you-wont-regret-buying/,fool.com,7,carnival shown investor take pay debt amazon recently reached important turning point company shifted inflow cash outflow,0,0,0.3477975,-0.3477975,Negative Impact
31/08/2023,135.06,138.79,135.00,138.01,138.01,58781300,2.95,51.45734626,1.192,0,19.59190606,0.6717572755,0.1507120743,5.33,307.026,14034.96973,16000.37012,7439.100098,7316.700195,3119.879883,64831.41016,20292.59961,132.7240005,108.9475502,131.4372851,119.3017721,136.387001,142.1947021,130.5792999,49.12124505,0.7439343684,0.9179710066,-0.174036638,2.860712324,142.6169091,10531375200,69.43920369,50.6230674,13.56999969,"Amazon Rides High Amid Challenges In Cloud Computing, E-Commerce And FTC Probe",Amazon is the IBD Stock of the Day as the e-commerce and cloud computing giant becomes actionable and investors shrug off a potential FTC antitrust lawsuit.,https://www.investors.com/research/ibd-stock-of-the-day/amazon-stock-rides-high-amid-challenges-in-cloud-computing-e-commerce-ftc-probe/,investors.com,5,amazon ibd stock day ecommerce cloud computing giant becomes actionable investor shrug potential ftc antitrust lawsuit,-0.0516,-0.0258,0.3644315,-0.3902315,Negative Impact
01/09/2023,139.46,139.96,136.88,138.12,138.12,40948300,2.95,51.45734626,1.192,0,19.59190606,0.6717572755,0.1507120743,5.33,307.789,14031.80957,16091.79004,7464.5,7296.77002,3133.25,65387.16016,20545.40039,132.8834006,109.1457002,131.6993522,119.4890181,136.3145004,141.989584,130.6394169,44.08495119,0.9318862131,0.9207540479,0.01113216525,2.877855573,142.376171,10572323500,70.46724707,60.62304363,13.09000015,"Bezos snubbed Musk's SpaceX for huge satellite launch contract, Amazon shareholder says",An Amazon shareholder lawsuit alleges the company snubbed SpaceX for satellite launch contracts because of Jeff Bezos' personal rivalry with Elon Musk.,https://www.cnbc.com/2023/09/01/bezos-snubbed-musk-spacex-satellite-contract-lawsuit.html,cnbc.com,9,amazon shareholder lawsuit alleges company snubbed spacex satellite launch contract jeff bezos personal rivalry elon musk,-0.4939,-0.44451,0.250489375,-0.694999375,Negative Impact
05/09/2023,137.73,137.80,135.82,137.27,137.27,40636700,2.95,51.45734626,1.192,0,19.59190606,0.6717572755,0.1507120743,5.33,307.789,14020.9502,15942.48047,7437.899902,7254.720215,3154.370117,65780.25781,20413.80078,133.0422006,109.3373502,131.9178091,119.6659433,136.0670006,141.0468367,131.0871644,48.92820345,1.000716609,0.93674656,0.06397004852,2.752854483,142.1402476,10531686800,71.32195052,70.40946709,14.01000023,The 7 Best Forever Stocks to Buy Now: September 2023,"Experts and investors are bullish on U.S. stocks at this point. For example, multi-billionaire Ken Fisher recently called on investors to avoid selling their stocks.",https://investorplace.com/2023/09/the-7-best-forever-stocks-to-buy-now-september-2023/,investorplace.com,6,expert investor bullish u stock point example multibillionaire ken fisher recently called investor avoid selling stock,-0.296,-0.1776,0.3265235294,-0.504123529,Negative Impact
06/09/2023,136.32,137.45,134.61,135.36,135.36,41785500,2.95,51.45734626,1.192,0,19.59190606,0.6717572755,0.1507120743,5.33,307.789,13872.46973,15891.53027,7426.100098,7194.089844,3158.080078,65880.52344,20227,133.2028006,109.5285502,132.052797,119.8221031,135.8380005,140.4775339,131.1984671,50.80688234,0.8908744141,0.9275721308,-0.036697717,2.765711103,141.9090427,10489901300,50.95944873,64.24954877,14.44999981,Want to Buy the Dip? Check Out These 3 Top Ranked Stocks,"By now, most people who follow the stock market have seen the seasonality statistics for September. On average, it's the weakest month of the year, with a performance of -0.7%.",https://www.zacks.com/commentary/2145656/want-to-buy-the-dip-check-out-these-3-top-ranked-stocks,zacks.com,8,people follow stock market seen seasonality statistic september average weakest month year performance,-0.5106,-0.40848,0.1289122222,-0.537392222,Negative Impact
07/09/2023,133.9,138.03,133.16,137.85,137.85,48498900,2.95,51.45734626,1.192,0,19.59190606,0.6717572755,0.1507120743,5.33,307.789,13748.83008,15864.19043,7441.700195,7196.100098,3122.350098,66265.5625,20132.09961,133.3762009,109.7435502,132.2801385,120.0014852,135.8380005,140.4775339,131.1984671,59.98971193,0.9932962166,0.940716948,0.05257926865,2.930710929,141.6824619,10538400200,77.50533569,66.59557832,14.39999962,Amazon Stock Proved Me Wrong,The rapid pace at which it controlled expenses was shocking.,https://www.fool.com/investing/2023/09/07/amazon-stock-proved-me-wrong/,fool.com,7,rapid pace controlled expense shocking,-0.4019,-0.28133,0.35916,-0.64049,Negative Impact
08/09/2023,136.86,138.85,136.75,138.23,138.23,38348200,2.95,51.45734626,1.192,0,19.59190606,0.6717572755,0.1507120743,5.33,307.789,13761.53027,15878.99023,7478.200195,7240.77002,3116.719971,66598.90625,20074.69922,133.5600009,109.9640002,132.5134663,120.1828635,135.8215004,140.4224605,131.2205403,63.19115616,1.092534166,0.9710803916,0.1214537746,2.872138977,141.4604127,10576748400,81.55639567,70.00706003,13.84000015,Amazon's Unstoppable Competitive Advantage,Amazon's logistics network would be difficult to replicate.,https://www.fool.com/investing/2023/09/08/amazons-unstoppable-competitive-advantage/,fool.com,7,amazon logistics network would difficult replicate,-0.2023,-0.14161,0.2166627273,-0.358272727,Negative Impact
11/09/2023,138.75,143.62,138.64,143.10,143.10,56764500,2.95,51.45734626,1.192,0,19.59190606,0.6717572755,0.1507120743,5.33,307.789,13917.88965,15949.44043,7496.899902,7278.27002,3142.780029,67127.07813,20182.80078,133.864001,110.2172002,132.9286247,120.4108947,136.0560005,141.5949241,130.517077,68.79467795,1.546325021,1.086129317,0.4601957034,3.079996381,130.5800018,10633512900,96.01235214,85.0246945,13.80000019,"Morgan Stanley says it's a lonely bull, recommending government bonds","Morgan Stanley strategists have been almost apologetic about their view that the stock market would struggle, in a year in which the S&P 500 SPX has gained 16%. But less remarked upon is that the investment bank's team made another wrong call, in being bullish government bonds.",https://www.marketwatch.com/story/morgan-stanley-says-its-a-lonely-bull-recommending-government-bonds-78004824,marketwatch.com,8,morgan stanley strategist almost apologetic view stock market would struggle year sp spx gained less remarked upon investment bank team made another wrong call bullish government bond,-0.4215,-0.3372,0.3866141176,-0.723814118,Negative Impact
12/09/2023,142.32,143.00,140.61,141.23,141.23,42668500,2.95,51.45734626,1.192,0,19.59190606,0.6717572755,0.1507120743,5.33,307.789,13773.61035,15953.91016,7527.5,7252.879883,3137.060059,67221.13281,20223.09961,134.0814009,110.4573502,133.2541687,120.61805,136.0889999,141.7477266,130.4302733,64.63924566,1.735062612,1.215915976,0.5191466355,3.12071119,130.8408017,10590844400,81.67177439,86.4135074,14.22999954,"Amazon Gets on Board Carbon Capture Train, but Will It Make a Difference?","Calling it a ÃÂÃÂcritical technology in the fight against climate change,ÃÂÃÂ Amazon announced Tuesday morning that it will purchase 250,000 metric tons of carbon removal credits over the next 10 years from a direct air capture (DAC) plant being built by a subsidiary of Occidental Petroleum (Oxy) on the King Ranch in South Texas.",https://247wallst.com/energy-economy/2023/09/12/amazon-gets-on-board-carbon-capture-train-but-will-it-make-a-difference/,24/7 Wall Street,5,calling critical technology fight climate change amazon announced tuesday morning purchase metric ton carbon removal credit next year direct air capture dac plant built subsidiary occidental petroleum oxy king ranch south texas,-0.1531,-0.07655,0.2963116667,-0.372861667,Negative Impact
13/09/2023,140.95,144.98,140.87,144.85,144.85,60465200,2.95,51.45734626,1.192,0,19.59190606,0.6717572755,0.1507120743,5.33,307.789,13813.58984,15926.63965,7526,7222.569824,3123.070068,67466.99219,20278.90039,134.374001,110.7109503,133.7089074,120.8591639,136.4480003,143.3117677,129.5842329,67.8121335,2.151936907,1.403120163,0.7488167445,3.219282968,131.0963856,10651309600,99.09729389,92.26047347,13.47999954,Better Buy: Amazon vs. Shopify Stock,"Amazon is a clear leader in e-commerce and cloud computing, with solid growth prospects. Shopify is the top software solution provider for merchants growing at high double-digit rates.",https://www.fool.com/investing/2023/09/13/better-buy-amazon-vs-shopify-stock/,fool.com,7,amazon clear leader ecommerce cloud computing solid growth prospect shopify top software solution provider merchant growing high doubledigit rate,0.91,0.637,0.2080988889,0.4289011111,Positive Impact
14/09/2023,145.08,145.86,142.95,144.72,144.72,64033600,2.95,51.45734626,1.192,0,19.59190606,0.6717572755,0.1507120743,5.33,307.789,13926.0498,16089.48047,7673.100098,7308.669922,3126.550049,67519,20567.80078,134.6608009,110.9675003,134.140715,121.0965852,136.9305,144.6852908,129.1757093,78.44522206,2.443653565,1.611226843,0.8324267217,3.073569162,131.65173,10587276000,92.53927041,91.10277956,12.81999969,"ÃÂÃÂEmerging markets have a China problem.' This strategist favors India, which just hit a record.","Bank of America's global fund manager survey this week reported the biggest ever push into the U.S., and exit from emerging markets, on record. That result didn't come as a big surprise to Matt Orton, chief market strategist at Raymond James Investment Management.",https://www.marketwatch.com/story/emerging-markets-have-a-china-problem-this-strategist-favors-india-which-just-hit-a-record-dd83e5bc,marketwatch.com,8,bank america global fund manager survey week reported biggest ever push u exit emerging market record result didnt come big surprise matt orton chief market strategist raymond james investment management,-0.2057,-0.16456,0.3892646154,-0.553824615,Negative Impact
15/09/2023,142.69,143.57,140.09,140.39,140.39,102861700,2.95,51.45734626,1.192,0,19.59190606,0.6717572755,0.1507120743,5.33,307.789,13708.33008,15973.67969,7711.399902,7378.819824,3117.73999,67838.63281,20622.30078,134.9014009,111.1997003,134.385785,121.2885595,137.2510002,145.0221744,129.479826,63.95303282,2.298945346,1.748770544,0.5501748026,3.169284276,132.5042262,10484414300,60.95643565,84.19766665,13.78999996,Why Amazon Pulled Back Today,"Amazon didn't have company-specific news, but broader economic news stories caused it to pull back. In addition, the FTC may be preparing to sue the company on antitrust violations.",https://www.fool.com/investing/2023/09/15/why-amazon-pulled-back-today/,fool.com,7,amazon didnt companyspecific news broader economic news story caused pull back addition ftc may preparing sue company antitrust violation,-0.3612,-0.25284,0.2707972727,-0.523637273,Negative Impact
18/09/2023,140.48,141.75,139.22,139.98,139.98,42823500,2.95,51.45734626,1.192,0,19.59190606,0.6717572755,0.1507120743,5.33,307.789,13710.24023,15952.51953,7652.899902,7276.140137,3125.929932,67596.84375,20492.80078,135.1054008,111.4375003,134.6051658,121.4745439,137.5889999,145.2085253,129.9694745,63.23527328,2.126664309,1.824349297,0.3023150124,3.199999128,133.3055727,10441590800,53.70073783,69.0654813,14,Amazon FTC anti-trust lawsuit ÃÂÃÂunlikely' to spur business restructuring,"An upcoming anti-trust lawsuit by the Federal Trade Commission (FTC) against Amazon.com Inc (NASDAQ:AMZN) will not likely bring about an outcome that materially alters the structure of the business, analysts at Wedbush believe. According to recent media reports from publications including Bloomberg, the Wall Street Journal, and Politico, the FTC is preparing to file a lawsuit against the e-commerce giant as early as this month which will focus on several aspects of the Amazon marketplace.",https://www.proactiveinvestors.com/companies/news/1026867?SNAPI,proactiveinvestors.com,5,upcoming antitrust lawsuit federal trade commission ftc amazoncom inc nasdaqamzn likely bring outcome materially alters structure business analyst wedbush believe according recent medium report publication including bloomberg wall street journal politico ftc preparing file lawsuit ecommerce giant early month focus several aspect amazon marketplace,-0.2732,-0.1366,0.3174753846,-0.454075385,Negative Impact
19/09/2023,138.7,138.84,135.56,137.63,137.63,61482500,2.95,51.45734626,1.192,0,19.59190606,0.6717572755,0.1507120743,5.33,307.789,13678.19043,15929.00977,7660.200195,7282.120117,3124.959961,67596.84375,20218.90039,135.315401,111.6429503,134.7237869,121.6352948,137.7365005,145.2321242,130.2408769,55.14761514,1.779987141,1.815476865,-0.035489725,3.37285614,134.0588384,10380108300,35.19686846,49.95134731,14.10999966,"Amazon adding 250,000 workers for the holidays and bumping average pay","Amazon said Tuesday it's hiring 250,000 employees in the U.S. to help manage the holiday rush.",https://www.cnbc.com/2023/09/19/amazon-adding-250000-workers-for-the-holidays-and-bumping-average-pay.html,cnbc.com,9,amazon said tuesday hiring employee u help manage holiday rush,0.7269,0.65421,0.2813244444,0.3728855556,Positive Impact
20/09/2023,138.55,139.37,135.20,135.29,135.29,46263700,2.95,51.45734626,1.192,0,19.59190606,0.6717572755,0.1507120743,5.33,307.789,13469.12988,15859.62012,7731.700195,7330.790039,3108.568115,66800.84375,20214.69922,135.4456009,111.8419003,134.7459911,121.7711624,137.7885002,145.1961976,130.3808028,50.38459056,1.301421629,1.712665818,-0.411244189,3.544999259,134.7669081,10333844600,16.77157587,35.22306072,15.14000034,Amazon executives accused by FTC of deceptive Prime business practices,"A trio of Amazon.com Inc. AMZN executives on Wednesday were added to a lawsuit the Federal Trade Commission filed against Amazon in June. Senior Vice Presidents Neil Lindsay and Russell Grandinetti, along with Vice President Jamil Ghani, allegedly participated in a scheme to make it difficult for customers to cancel subscriptions to Amazon's Prime membership service.",https://www.marketwatch.com/story/amazon-executives-accused-by-ftc-of-deceptive-prime-business-practices-18b7cf1d,marketwatch.com,8,trio amazoncom inc amzn executive wednesday added lawsuit federal trade commission filed amazon june senior vice president neil lindsay russell grandinetti along vice president jamil ghani allegedly participated scheme make difficult customer cancel subscription amazon prime membership service,-0.4588,-0.36704,0.1493786207,-0.516418621,Negative Impact
21/09/2023,131.94,132.24,129.31,129.33,129.33,70234800,2.95,51.45734626,1.192,0,19.59190606,0.6717572755,0.1507120743,5.33,307.789,13223.98047,15601.59961,7678.600098,7213.899902,3084.700928,66230.24219,19791.59961,135.4162009,112.0179003,134.5335994,121.8463748,137.4790001,145.752429,129.2055712,36.27453251,0.4362052106,1.457373697,-1.021168486,3.701428005,145.8600006,10263609800,0.1208717146,17.36310535,17.54000092,"Amazon stock heads for longest losing streak in 7 months, after FTC adds executives to its lawsuit","Shares of Amazon.com Inc. AMZN sank 2.8% in morning trading Thursday, putting them on track to suffer a sixth-straight decline, after three executives were added to the Federal Trade Commission's lawsuit against the ecommerce and cloud giant. The stock has tumbled 9.2% during its current losing streak, which would be the longest since the six-day stretch that ended Feb. 10, 2023.",https://www.marketwatch.com/story/amazon-stock-heads-for-longest-losing-streak-in-7-months-after-ftc-adds-executives-to-its-lawsuit-f346b17d,marketwatch.com,8,share amazoncom inc amzn sank morning trading thursday putting track suffer sixthstraight decline three executive added federal trade commission lawsuit ecommerce cloud giant stock tumbled current losing streak would longest since sixday stretch ended feb,-0.7003,-0.56024,0.1934658333,-0.753705833,Negative Impact
22/09/2023,131.11,132.03,128.52,129.12,129.12,59904300,2.95,51.45734626,1.192,0,19.59190606,0.6717572755,0.1507120743,5.33,307.789,13211.80957,15569.50977,7683.899902,7184.819824,3132.431885,66009.14844,19780,135.3126007,112.2084502,134.3213011,121.9187491,137.343,146.0829916,128.6030084,35.81338116,-0.263394573,1.113220043,-1.376614616,3.732141767,145.5290005,10203705500,3.460155545,6.784201044,17.20000076,Amazon's stock is in danger of falling for the most days in a row this year,"A more than 2% morning rally in Amazon.com Inc.'s stock AMZN, -0.13% wasn't enough, as a big comeback by bears puts stock in danger to suffering a seventh-straight loss. The stock traded as high as $132.03, or 2.1% above Thursday's close, at about 11:07 a.m.",https://www.marketwatch.com/story/amazons-stock-is-in-danger-of-falling-for-the-most-days-in-a-row-this-year-855a7b71,marketwatch.com,8,morning rally amazoncom inc stock amzn wasnt enough big comeback bear put stock danger suffering seventhstraight loss stock traded high thursday close,-0.8316,-0.66528,0.1534309091,-0.818710909,Negative Impact
25/09/2023,129.36,131.78,128.77,131.27,131.27,46017800,2.95,51.45734626,1.192,0,19.59190606,0.6717572755,0.1507120743,5.33,307.789,13271.32031,15593.73047,7624,7123.879883,3115.606934,66023.6875,19800.59961,135.2444009,112.4235503,134.2016424,122.0117964,137.2435005,146.2212829,128.2657181,40.91461098,-0.637001712,0.7631756919,-1.400177404,3.782856533,144.8486407,10249723300,15.85928824,6.480105166,16.89999962,Amazon (AMZN) Expands Fire TV Portfolio With New Devices,"Amazon (AMZN) introduces the all-new Fire TV Stick 4K Max, Fire TV Stick 4K, Fire TV Soundbar and the generative AI voice search feature.",https://www.zacks.com/stock/news/2155051/amazon-amzn-expands-fire-tv-portfolio-with-new-devices,zacks.com,8,amazon amzn introduces allnew fire tv stick k max fire tv stick k fire tv soundbar generative ai voice search feature,-0.6705,-0.5364,0.2729667568,-0.809366757,Negative Impact
26/09/2023,130.12,130.39,125.28,125.98,125.98,73048200,2.95,51.45734626,1.192,0,19.59190606,0.6717572755,0.1507120743,5.33,307.789,13063.61035,15381.58008,7625.700195,7074.02002,3102.272949,65945.46875,19556.19922,135.0928011,112.6111503,133.8792252,122.0512811,136.8855007,147.0454542,126.7255472,37.11540513,-1.344448954,0.3416507627,-1.686099717,4.007857186,144.1954952,10176675100,3.401382485,7.573608756,18.94000053,"Merchants want lower fees, need Amazon's ads as US FTC files suit","Merchants who sell on Amazon.com want the online retailer to cut back on fees while some also worry the U.S. Federal Trade Commission's lawsuit filed on Tuesday could hit its advertising business, harming their ability to reach potential shoppers.",https://www.reuters.com/business/retail-consumer/merchants-want-lower-fees-need-amazons-ads-us-ftc-files-suit-2023-09-26/,reuters.com,10,merchant sell amazoncom want online retailer cut back fee also worry u federal trade commission lawsuit filed tuesday could hit advertising business harming ability reach potential shopper,-0.7783,-0.7783,0.03679375,-0.81509375,Negative Impact
27/09/2023,125.76,127.48,124.13,125.98,125.98,66553400,2.95,51.45734626,1.192,0,19.59190606,0.6717572755,0.1507120743,5.33,307.789,13092.84961,15394.69043,7593.200195,7071.790039,3107.315918,66118.6875,19436,134.9558011,112.7893003,133.5694518,122.0903728,136.4390007,147.6907341,125.1872673,32.49780579,-1.883395381,-0.103358466,-1.780036915,3.899286543,143.0605655,10243228500,8.513602475,9.258091066,18.21999931,Amazon antitrust lawsuit: Here's how US regulators break up other monopoly powers,"U.S. antitrust regulators on Tuesday filed a lawsuit against Amazon.com accusing the online retailer of harming consumers with higher prices, the latest in a long history of tough action against monopolies that can be traced back to the breakup of Standard Oil.",https://www.reuters.com/legal/amazon-antitrust-lawsuit-latest-us-efforts-rein-big-firms-clout-2023-09-27/,reuters.com,10,u antitrust regulator tuesday filed lawsuit amazoncom accusing online retailer harming consumer higher price latest long history tough action monopoly traced back breakup standard oil,-0.7717,-0.7717,0.036175,-0.807875,Negative Impact
28/09/2023,124.04,126.58,123.04,125.98,125.98,54555000,2.95,51.45734626,1.192,0,19.59190606,0.6717572755,0.1507120743,5.33,307.789,13201.28027,15478.07031,7601.899902,7116.240234,3110.475098,65508.32031,19590.69922,134.7682011,112.9737503,133.2718264,122.1290756,135.9845005,148.165091,123.80391,31.73281643,-2.284183659,-0.539523505,-1.744660155,4.002143315,141.54612,10297783500,12.88344645,8.266143804,17.34000015,"You Can't Control Recessions, but You Can Control What You Do About It","Keep your head on straight to avoid making bad decisions with your investments. Avoid margin, and continually add new funds.",https://www.fool.com/investing/2023/09/28/you-cant-control-recessions-can-control-what-you/,fool.com,7,keep head straight avoid making bad decision investment avoid margin continually add new fund,-0.7184,-0.50288,0.1664305,-0.6693105,Negative Impact
29/09/2023,128.2,129.15,126.32,127.12,127.12,62377600,2.95,51.45734626,1.192,0,19.59190606,0.6717572755,0.1507120743,5.33,307.789,13219.32031,15398.20996,7608.100098,7135.060059,3110.475098,65828.40625,19541.30078,134.7114011,113.1566003,133.0305784,122.1787366,135.4400009,148.1992232,122.6807787,23.1879509,-2.481220865,-0.927862977,-1.553357888,3.843571254,139.6955081,10360161100,17.87906172,13.09203688,17.52000046,Is Amazon Stock Safe? 3 Things Investors Should Know Now After FTC Files Lawsuit,Even a loss in court may not be bad for investors.,https://www.fool.com/investing/2023/09/29/is-amazon-stock-safe-3-things-investors-should-kno/,fool.com,7,even loss court may bad investor,-0.7003,-0.49021,0.2294309091,-0.719640909,Negative Impact
02/10/2023,127.28,130.47,126.54,129.46,129.46,48029700,2.95,51.45734626,1.192,0,19.59190606,0.6717572755,0.1507120743,5.33,307.671,13307.76953,15230.00977,7510.700195,7068.160156,3110.475098,65828.40625,19177.19922,134.7006012,113.3414504,132.890556,122.251187,135.0070015,147.9694372,122.0445658,30.55834905,-2.420651739,-1.226420729,-1.19423101,3.946428026,138.0299574,10408190800,28.13324226,19.63191681,17.61000061,"The inside story of Dave Clark's tumultuous last days at Flexport: Standoffs, politics, and spin","Flexport founder Ryan Petersen claimed in public that Dave Clark's tenure as CEO featured too much spending, but internal documents tell a different story",https://www.cnbc.com/2023/10/02/the-inside-story-of-dave-clarks-tumultuous-last-days-at-flexport.html,cnbc.com,9,flexport founder ryan petersen claimed public dave clark tenure ceo featured much spending internal document tell different story,0,0,0.2819728571,-0.281972857,Negative Impact
03/10/2023,128.06,128.52,124.25,124.72,124.72,51565000,2.95,51.45734626,1.192,0,19.59190606,0.6717572755,0.1507120743,5.33,307.671,13059.46973,15043.41992,7470.200195,6997.049805,3110.475098,65512.10156,19020.90039,134.6190012,113.5071504,132.5701421,122.2757523,134.3795013,148.0750141,120.6839886,17.93567107,-2.723731618,-1.525882907,-1.197848711,4.024999891,136.5309617,10356625800,7.361964626,17.79142287,19.78000069,The ÃÂÃÂwild bunch' have taken control of the bond market. Here's where they could wreak havoc next.,"The bond market is front and center for investors these days, with JPMorgan warning of a ÃÂÃÂfinancial accidentÃÂÃÂ if yields keep going up, driving prices lower.",https://www.marketwatch.com/story/the-wild-bunch-have-taken-control-of-the-bond-market-heres-where-they-could-wreak-havoc-next-1448322b,marketwatch.com,8,bond market front center investor day jpmorgan warning financial accident yield keep going driving price lower,-0.7717,-0.61736,0.1958159091,-0.813175909,Negative Impact
04/10/2023,126.06,127.36,125.68,127.00,127.00,44203900,2.95,51.45734626,1.192,0,19.59190606,0.6717572755,0.1507120743,5.33,307.671,13236.00977,15070.91016,7412.5,6996.72998,3110.475098,65226.03906,19034.80078,134.5764011,113.6999004,132.3517051,122.3227598,133.9615013,148.0360753,119.8869273,23.58379749,-2.748267442,-1.770359814,-0.977907628,4.005713872,135.1818656,10400829700,19.28883511,18.26134733,18.57999992,Q4 Forecast: 3 Ecommerce Stocks Set to Soar in 2024,"E-commerce companies have struggled mightily coming out of the Covid-19 pandemic. After skyrocketing in 2020 and 2021 as people the world over were forced to shop exclusively online, e-commerce stocks came crashing back to earth over the last two years as interest rates rose and people returned to in-store shopping.",https://investorplace.com/2023/10/q4-forecast-3-ecommerce-stocks-set-to-soar-in-2024/,investorplace.com,6,ecommerce company struggled mightily coming covid pandemic skyrocketing people world forced shop exclusively online ecommerce stock came crashing back earth last two year interest rate rose people returned instore shopping,-0.34,-0.204,0.1732138462,-0.377213846,Negative Impact
05/10/2023,126.71,126.73,124.33,125.96,125.96,39660600,2.95,51.45734626,1.192,0,19.59190606,0.6717572755,0.1507120743,5.33,307.671,13219.83008,15072.99023,7451.5,6998.25,3110.475098,65631.57031,19137.80078,134.5326012,113.8904004,132.10105,122.3589512,133.367001,147.7510544,118.9829476,26.14877787,-2.819134415,-1.980114734,-0.839019681,3.865713392,133.9676792,10361169100,15.60661845,14.08580606,18.48999977,ETFs That Could Be Impacted by the Student Loan Payment Restart,"Surpassing the $1.7 trillion mark, student debt has emerged as one of the most significant facets of consumer borrowing in the past decade. With about 44 million debt-burdened consumers, look into which ETF categories are affected and which types investors can capitalize from.",https://www.zacks.com/stock/news/2161046/etfs-that-could-be-impacted-by-the-student-loan-payment-restart,zacks.com,8,surpassing trillion mark student debt emerged one significant facet consumer borrowing past decade million debtburdened consumer look etf category affected type investor capitalize,-0.3182,-0.25456,0.253096087,-0.507656087,Negative Impact
06/10/2023,124.16,128.45,124.13,127.96,127.96,46795900,2.95,51.45734626,1.192,0,19.59190606,0.6717572755,0.1507120743,5.33,307.671,13431.33984,15214.01953,7494.600098,7060.149902,3110.475098,65995.63281,19246.09961,134.5268011,114.1056004,131.9386558,122.414683,132.8535011,147.2398472,118.4671551,31.12438853,-2.682985925,-2.120688972,-0.562296952,3.9935706,132.8749113,10407965000,30.12859716,21.67468357,17.45000076,Spiking long yields are a danger for markets: here's what may happen next and 5 things investors should do,"There's been a lot of angst about 1987 of late. In October that year, the market suffered a sharp decline that climaxed with ÃÂÃÂBlack Monday' on the 19th, when the Dow Jones Industrial Average plunged 22.6%.",https://www.marketwatch.com/story/spiking-long-yields-are-a-danger-for-markets-heres-what-may-happen-next-and-5-things-investors-should-do-32e1ac7c,marketwatch.com,8,there lot angst late october year market suffered sharp decline climaxed black monday th dow jones industrial average plunged,-0.4939,-0.39512,0.2534633333,-0.648583333,Negative Impact
09/10/2023,126.22,128.79,124.76,128.26,128.26,38773700,2.95,51.45734626,1.192,0,19.59190606,0.6717572755,0.1507120743,5.33,307.671,13484.24023,15318.08008,7492.200195,7021.399902,3096.922119,65512.39063,19246.09961,134.4478009,114.3209504,131.7943946,122.4728453,132.1115005,145.785842,118.4371591,34.27324121,-2.521810283,-2.200913234,-0.320897048,3.965712956,131.8914203,10446738700,31.96567939,25.90029833,17.70000076,Waitrose considering selling groceries on Amazon,"Waitrose is in talks with Amazon.com Inc (NASDAQ:AMZN) over a potential partnership to sell groceries on the online retail giant's platform in a move that sees the supermarket retailer try and regain some of the market share it has lost during the cost-of-living crisis. Considering the move years after cutting ties with Ocado to sell its own groceries online, Waitrose has been discussing a third-party deal with Amazon, understood to be a similar agreement to that of Iceland.",https://www.proactiveinvestors.co.uk/companies/news/1029100?SNAPI,proactiveinvestors.com,5,waitrose talk amazoncom inc nasdaqamzn potential partnership sell grocery online retail giant platform move see supermarket retailer try regain market share lost costofliving crisis considering move year cutting tie ocado sell grocery online waitrose discussing thirdparty deal amazon understood similar agreement iceland,-0.2023,-0.10115,0.315259375,-0.416409375,Negative Impact
10/10/2023,128.82,130.74,128.05,129.48,129.48,42178600,2.95,51.45734626,1.192,0,19.59190606,0.6717572755,0.1507120743,5.33,307.671,13562.83984,15450.24023,7628.200195,7162.430176,3075.23999,66079.35938,19501.19922,134.363801,114.5345004,131.7036339,122.5425682,131.5240005,144.5427393,118.5052618,39.86746628,-2.269472457,-2.214625079,-0.054847378,3.859998975,131.0062784,10488917300,69.99990878,44.03139511,17.03000069,Amazon's Indigenous people urge Brazil to declare climate emergency as rivers dry up,"Indigenous inhabitants in the Amazon are asking the Brazilian government to declare a climate emergency as their villages have no drinking water, food or medicine due to a severe drought that is drying up rivers vital for travel in the rainforest, their leaders said on Tuesday.",https://www.reuters.com/business/environment/amazons-indigenous-people-urge-brazil-declare-climate-emergency-rivers-dry-up-2023-10-10/,reuters.com,10,indigenous inhabitant amazon asking brazilian government declare climate emergency village drinking water food medicine due severe drought drying river vital travel rainforest leader said tuesday,-0.3182,-0.3182,0.2582391667,-0.576439167,Negative Impact
11/10/2023,129.74,132.05,129.61,131.83,131.83,40741800,2.95,51.45734626,1.192,0,19.59190606,0.6717572755,0.1507120743,5.33,307.671,13659.67969,15487.78027,7620,7131.209961,3078.956055,66473.04688,19663.80078,134.366601,114.7747004,131.7085895,122.6349805,130.8730003,142.2895266,119.4564741,54.98802314,-1.858444073,-2.143388877,0.2849448049,3.616428375,123.0400009,10529659100,97.55825562,66.50794793,16.09000015,Wall Street Loves Amazon Stock Right Now. Here's Why I'm Not Buying.,Both Amazon's e-commerce and cloud computing businesses face cyclical headwinds. The rising regulatory threat shouldn't be ignored.,https://www.fool.com/investing/2023/10/11/wall-street-loves-amazon-stock-now-why-not-buy/,fool.com,7,amazon ecommerce cloud computing business face cyclical headwind rising regulatory threat shouldnt ignored,-0.1872,-0.13104,0.196608,-0.327648,Negative Impact
12/10/2023,132.17,134.48,131.23,132.33,132.33,55528600,2.95,51.45734626,1.192,0,19.59190606,0.6717572755,0.1507120743,5.33,307.671,13574.21973,15329.5498,7644.799805,7104.529785,3107.900879,66408.39063,19500.19922,134.4490009,115.0101004,131.7329586,122.7314484,130.2535004,139.676975,120.8300257,56.33136885,-1.475348398,-2.009780782,0.534432384,3.597857339,123.220201,10585187700,81.20633854,82.92150098,16.69000053,Google and Amazon Hit by Fresh Cyberattacks. These Stocks Could Benefit.,"Google, Amazon and Cloudflare have all recently been victims of attacks just weeks just weeks after casino operators MGM Resorts (MGM) and Caesars Entertainment (CZR) were targeted.",https://www.barrons.com/articles/google-amazon-stocks-cyberattack-45e4d191,barrons.com,9,google amazon cloudflare recently victim attack week week casino operator mgm resort mgm caesar entertainment czr targeted,-0.1779,-0.16011,0.2412970588,-0.401407059,Negative Impact
13/10/2023,132.98,133.31,128.95,129.79,129.79,45786600,2.95,51.45734626,1.192,0,19.59190606,0.6717572755,0.1507120743,5.33,307.671,13407.23047,15323.7002,7599.600098,7003.529785,3088.100098,66282.74219,19462.90039,134.4666006,115.2438503,131.6567639,122.8016827,129.7235001,137.8495741,121.597426,47.1250781,-1.361010891,-1.880026803,0.5190159128,3.694286346,123.6705927,10539401100,59.00345657,79.25601691,19.31999969,Amazon sees improvement in second October Prime Day,"Amazon.com Inc (NASDAQ:AMZN) has highlighted its two-day ÃÂÃÂPrime Big Deal Days' event, which took place between October 10 and 11, as the company's largest yet, outpacing last year. Over 25 million items were sold in the US on the first day alone, Amazon said in a statement.",https://www.proactiveinvestors.co.uk/companies/news/1029640?SNAPI,proactiveinvestors.com,5,amazoncom inc nasdaqamzn highlighted twoday prime big deal day event took place october company largest yet outpacing last year million item sold u first day alone amazon said statement,-0.0772,-0.0386,0.3597125,-0.3983125,Negative Impact
16/10/2023,130.69,133.07,130.43,132.55,132.55,42832900,2.95,51.45734626,1.192,0,19.59190606,0.6717572755,0.1507120743,5.33,307.671,13567.98047,15484.5,7630.600098,7022.189941,3073.812988,66166.92969,19620.80078,134.3262006,115.4975003,131.6917929,122.8986809,129.3520004,136.0592675,122.6447333,64.15336345,-1.035748408,-1.711171124,0.6754227164,3.500715528,124.1029689,10582234000,83.129427,74.44640737,17.20999908,Amazon Stock Forecast: What to Watch in the Coming Months,Amazon (NASDAQ: AMZN ) has underperformed the Standards and Pracices (S&P) 500 throughout the past five years. That's an unusual position for AMZN stock since Jeff Bezos took it public in May 1997 at $18.,https://investorplace.com/2023/10/amazon-stock-forecast-what-to-watch-in-the-coming-months/,investorplace.com,6,amazon nasdaq amzn underperformed standard pracices sp throughout past five year thats unusual position amzn stock since jeff bezos took public may,0.1779,0.10674,0.4071128571,-0.300372857,Negative Impact
17/10/2023,130.39,132.58,128.71,131.47,131.47,49344600,2.95,51.45734626,1.192,0,19.59190606,0.6717572755,0.1507120743,5.33,307.671,13533.75,15541.37988,7675.200195,7029.700195,3083.5,66428.09375,19692.80078,134.1112006,115.7339503,131.6830951,122.9839676,129.0440002,134.6212773,123.4667232,61.30092787,-0.855263721,-1.539989644,0.6847259226,3.537857601,124.5180499,10532889400,73.68884727,71.94057695,17.87999916,"Amazon's stock can rocket another 30%, this new bull says","Amazon.com Inc.'s stock can shoot some 30% higher, according to a Stifel analyst who just joined the bull camp.",https://www.marketwatch.com/story/amazons-stock-can-rocket-another-30-this-new-bull-says-fd8de30f,marketwatch.com,8,amazoncom inc stock shoot higher according stifel analyst joined bull camp,-0.34,-0.272,0.2034405556,-0.475440556,Negative Impact
18/10/2023,129.9,130.67,127.51,128.13,128.13,42699500,2.95,51.45734626,1.192,0,19.59190606,0.6717572755,0.1507120743,5.33,307.671,13314.2998,15324.95996,7588,6965.990234,3058.709961,65877.02344,19450.69922,133.8750006,115.9546004,131.5437583,123.035172,128.6860008,133.4324849,123.9395168,53.89069737,-0.970550199,-1.426101755,0.4555515559,3.56785747,124.9165278,10490189900,38.64742241,65.15523223,19.21999931,Netherlands Consumer Group Sues Amazon Over Privacy Violations,"A Dutch consumer rights group is suing Amazon over its data tracking practices. Stichting Data Bescherming Nederland (SDBN), a consumer rights group in the Netherlands, has filed a class-action lawsuit against Amazon, accusing the tech giant of violating the European Union's privacy law, The Wall Street Journal (WSJ) reported Wednesday (Oct. 18).",https://www.pymnts.com/amazon/2023/netherlands-consumer-group-sues-amazon-over-privacy-violations/?utm_source=snapi,pymnts.com,5,dutch consumer right group suing amazon data tracking practice stichting data bescherming nederland sdbn consumer right group netherlands filed classaction lawsuit amazon accusing tech giant violating european union privacy law wall street journal wsj reported wednesday oct,-0.7003,-0.35015,0.172036129,-0.522186129,Negative Impact
19/10/2023,130.57,132.24,127.47,128.40,128.40,60961400,2.95,51.45734626,1.192,0,19.59190606,0.6717572755,0.1507120743,5.33,307.671,13186.17969,15196.37012,7499.5,6921.370117,3005.393066,65629.24219,19348.80078,133.6860004,116.1675003,131.4204734,123.0885533,128.6395004,133.3776345,123.9013664,52.39161121,-1.028276376,-1.346536679,0.318260303,3.682144165,125.2990665,10551151300,41.2560123,51.19742733,21.39999962,Amazon Counters FTC Lawsuit Allegations on Deceptive Practices,"Amazon is asking a Seattle judge to dismiss a lawsuit from the Federal Trade Commission (FTC), saying the case ÃÂÃÂfails in its entirety.ÃÂÃÂ The eCommerce giant has vehemently denied allegations made by the FTC regarding deceptive practices related to its Amazon Prime subscription service, Reuters reported Thursday (Oct. 19).",https://www.pymnts.com/amazon/2023/amazon-counters-ftc-lawsuit-allegations-on-deceptive-practices/?utm_source=snapi,pymnts.com,5,amazon asking seattle judge dismiss lawsuit federal trade commission ftc saying case fails entirety ecommerce giant vehemently denied allegation made ftc regarding deceptive practice related amazon prime subscription service reuters reported thursday oct,-0.6369,-0.31845,0.3494065,-0.6678565,Negative Impact
20/10/2023,128.05,128.17,124.97,125.17,125.17,56343300,2.95,51.45734626,1.192,0,19.59190606,0.6717572755,0.1507120743,5.33,307.671,12983.80957,15033.30957,7402.100098,6816.220215,2983.060059,65397.62109,19115.59961,133.4182004,116.3676503,131.1753567,123.1092642,128.4420006,133.4190752,123.464926,42.24230176,-1.319448665,-1.341119076,0.02167041083,3.646429334,134.4799957,10494808000,10.04831951,29.98391807,21.70999908,"""Magnificent Seven"" Earnings Underway: ETFs in Spotlight","We are in the thick of the third-quarter earnings season and the so-called ""Magnificent Seven"" are in focus. This is especially true as these have driven nearly all of the S&P 500's 12% year-to-date gains because of their outsized weighting in the index.",https://www.zacks.com/stock/news/2169704/magnificent-seven-earnings-underway-etfs-in-spotlight,zacks.com,8,thick thirdquarter earnings season socalled magnificent seven focus especially true driven nearly sp yeartodate gain outsized weighting index,0.8858,0.70864,0.1847594118,0.5238805882,Positive Impact
23/10/2023,124.63,127.88,123.98,126.56,126.56,48260000,2.95,51.45734626,1.192,0,19.59190606,0.6717572755,0.1507120743,5.33,307.671,13018.33008,14946.00977,7374.799805,6850.470215,2939.291016,64571.87891,19046.69922,133.1812003,116.5848503,130.9943622,123.1435998,128.2065002,133.0644544,123.3485461,53.78600022,-1.421655509,-1.357226363,-0.064429146,3.55285699,134.2897958,10543068000,24.5713912,25.29190767,20.37000084,Black Monday 2.0? Clues to Help Investors' Navigate the Market's Next Move,"US equities near an inflection point as fear, uncertainty, and doubt creep into investors' minds. Investors should consider 3 critical clues: the stabilization of bonds, historical seasonality trends combined with poor sentiment, and earnings from major tech companies like Microsoft.",https://www.zacks.com/commentary/2170409/black-monday-2-0-clues-to-help-investors-navigate-the-market-s-next-move,zacks.com,8,u equity near inflection point fear uncertainty doubt creep investor mind investor consider critical clue stabilization bond historical seasonality trend combined poor sentiment earnings major tech company like microsoft,-0.875,-0.7,0.1045465,-0.8045465,Negative Impact
24/10/2023,127.74,128.80,126.34,128.56,128.56,46477400,2.95,51.45734626,1.192,0,19.59190606,0.6717572755,0.1507120743,5.33,307.671,13139.87012,15025.75977,7389.700195,6893.649902,2962.243896,64571.87891,18986.5,132.9410001,116.7972503,130.898897,123.1974944,128.3355,133.0802148,123.5907851,53.24728826,-1.325986733,-1.350978437,0.02499170335,3.540000371,133.8774041,10589545400,43.61902409,26.07957827,18.96999931,Why Are Stocks Up Today?,Stocks are up today and investors searching for a reason behind the movement are in the right place! One of the biggest reasons that stocks are up today has to do with earnings reports.,https://investorplace.com/2023/10/why-are-stocks-up-today-oct-24th/,investorplace.com,6,stock today investor searching reason behind movement right place one biggest reason stock today earnings report,0,0,0.2637283333,-0.263728333,Negative Impact
25/10/2023,126.04,126.34,120.79,121.39,121.39,74577500,2.95,51.45734626,1.192,0,19.59190606,0.6717572755,0.1507120743,5.33,307.671,12821.21973,14914.12012,7414.299805,6915.069824,2974.114014,64049.05859,18947.90039,132.6154001,116.9674003,130.525999,123.1795093,128.1059998,133.6986966,122.5133029,42.42122809,-1.807887271,-1.442360204,-0.365527067,3.904285976,133.4815081,10514967900,4.382751654,24.19105565,20.19000053,"Amazon's focus on speed, surveillance drives higher warehouse worker injuries, study finds","Amazon warehouse workers are suffering physical injuries and mental stress on the job due to Amazon's focus on speed and pervasive surveillance, per a study.",https://www.cnbc.com/2023/10/25/study-amazons-focus-on-speed-surveillance-drives-worker-injuries.html,cnbc.com,9,amazon warehouse worker suffering physical injury mental stress job due amazon focus speed pervasive surveillance per study,-0.743,-0.6687,0.2016046154,-0.870304615,Negative Impact
26/10/2023,120.63,121.64,118.35,119.57,119.57,100419500,2.95,51.45734626,1.192,0,19.59190606,0.6717572755,0.1507120743,5.33,307.671,12595.61035,14858.7002,7354.600098,6888.959961,2988.299072,63148.14844,18875.30078,132.3053999,117.1159003,130.096352,123.1435938,127.7854996,134.5111105,121.0598886,36.00267092,-2.310027129,-1.615893589,-0.69413354,3.830714634,132.7200177,10414548400,7.563555043,18.52177693,20.68000031,"Amazon injuries more widespread than thought, study says",More than two-thirds of Amazon.com Inc. U.S. warehouse workers surveyed by researchers reported that they took unpaid time off to recover from pain or exhaustion sustained on the job.,https://techxplore.com/news/2023-10-amazon-injuries-widespread-thought.html,techxplore.com,5,twothirds amazoncom inc u warehouse worker surveyed researcher reported took unpaid time recover pain exhaustion sustained job,-0.7003,-0.35015,0.2539018421,-0.604051842,Negative Impact
27/10/2023,126.2,130.02,125.52,127.74,127.74,125309300,2.95,51.45734626,1.192,0,19.59190606,0.6717572755,0.1507120743,5.33,307.671,12643.00977,14675.78027,7291.299805,6795.379883,3017.783936,63782.80078,18737.40039,132.1806,117.2791503,130.0039459,123.1893292,127.8164993,134.5349064,121.0980923,49.31290091,-2.025378706,-1.697790612,-0.327588094,4.289287022,131.5704161,10539857700,58.21451326,23.38693999,21.27000046,More rare dolphins die in new spot along Brazil's Amazon River -report,"More rare freshwater dolphins in Brazil have been found dead in a new location along the Amazon River, in the latest grim fallout from the longest drought in the rainforest's recorded history.",https://www.reuters.com/world/americas/more-rare-dolphins-die-new-spot-along-brazils-amazon-river-report-2023-10-27/,reuters.com,10,rare freshwater dolphin brazil found dead new location along amazon river latest grim fallout longest drought rainforest recorded history,-0.8074,-0.8074,0.2983583721,-1.105758372,Negative Impact
30/10/2023,129.72,133.00,128.56,132.71,132.71,72485500,2.95,51.45734626,1.192,0,19.59190606,0.6717572755,0.1507120743,5.33,307.671,12789.48047,14825.88965,7327.399902,6825.069824,3021.552979,64112.64844,18856.80078,132.1704001,117.4663503,130.110066,123.2840623,127.9789993,135.0145166,120.9434821,53.88315711,-1.382814379,-1.634795366,0.2519809864,4.472858429,118.3499985,10612343200,89.02672464,51.60159765,19.75,Everything You Need to Know About Amazon's Spectacular Q3 Results,Amazon delivered solid results in several critical categories while disappointing in others.,https://www.fool.com/investing/2023/10/30/everything-you-need-to-know-about-amazons-q3/,fool.com,7,amazon delivered solid result several critical category disappointing others,-0.4939,-0.34573,0.3662453333,-0.711975333,Negative Impact
31/10/2023,132.75,133.57,131.71,133.09,133.09,51589400,2.95,51.45734626,1.192,0,19.59190606,0.6717572755,0.1507120743,5.33,307.671,12851.24023,14919.2002,7321.700195,6885.649902,3018.770996,63874.92969,18873.5,132.1386002,117.6412003,130.226926,123.3816338,128.3974991,135.6102987,121.1846995,51.59009927,-0.833309658,-1.474498224,0.6411885657,4.422143664,118.6429985,10663932600,91.38251937,79.54125242,18.13999939,Amazon workers across the glove set for Black Friday strikes,"Amazon.com Inc (NASDAQ:AMZN) is facing one of its largest strikes during Black Friday this year, with workers from 30 different countries, including the UK, set to walk out. Make Amazon Pay, the campaign group battling the e-commerce giant announced the strikes ÃÂÃÂ scheduled for November 24 ÃÂÃÂ at its inaugural summit in Manchester this weekend.",https://www.proactiveinvestors.co.uk/companies/news/1031570?SNAPI,proactiveinvestors.co.uk,5,amazoncom inc nasdaqamzn facing one largest strike black friday year worker different country including uk set walk make amazon pay campaign group battling ecommerce giant announced strike scheduled november inaugural summit manchester weekend,-0.4215,-0.21075,0.2795753333,-0.490325333,Negative Impact
01/11/2023,133.96,137.35,133.71,137.00,137.00,61529400,2.95,51.45734626,1.192,0,19.59190606,0.6717572755,0.1507120743,5.33,307.051,13061.46973,15002.5498,7342.399902,6932.629883,3023.076904,63591.32813,19079,132.1936002,117.8459503,130.4925367,123.5171399,128.8974991,137.030166,120.7648321,55.42644469,-0.081380486,-1.195874677,1.11449419,4.494287218,119.2400789,10725462000,98.15786335,92.85570245,16.87000084,"Nokia sues Amazon in US, India over video patents","Finnish telecom giant Nokia said Tuesday it is suing Amazon in five global jurisdictions, including the United States and India, over patent infringements on video-related technologies.",https://techxplore.com/news/2023-11-nokia-sues-amazon-india-video.html,techxplore.com,5,finnish telecom giant nokia said tuesday suing amazon five global jurisdiction including united state india patent infringement videorelated technology,-0.1779,-0.08895,0.3362045,-0.4251545,Negative Impact
02/11/2023,138.73,138.81,136.47,138.07,138.07,52236700,2.95,51.45734626,1.192,0,19.59190606,0.6717572755,0.1507120743,5.33,307.051,13294.19043,15332.59961,7446.5,7060.689941,3009.406006,64080.89844,19626.30078,132.2446002,118.0590003,130.7896924,123.6619445,129.5029995,138.4747643,120.5312347,59.96151892,0.5940219332,-0.837895355,1.431917288,4.350001199,120.3266745,10777698700,96.38323427,95.30787233,15.65999985,"Amazon Executives Discussed How Its Policies Hurt Sellers, FTC Suit Says","The executives discussed how its pricing policies had a ÃÂÃÂpunitive aspect' on sellers, according to internal documents quoted in newly unredacted portions of the Federal Trade Commission's monopoly lawsuit against the company.",https://www.wsj.com/articles/amazon-executives-discussed-how-its-policies-hurt-sellers-ftc-suit-says-863e05c4,wsj.com,9,executive discussed pricing policy punitive aspect seller according internal document quoted newly unredacted portion federal trade commission monopoly lawsuit company,-0.6369,-0.57321,0.1807166667,-0.753926667,Negative Impact
03/11/2023,138.99,139.49,137.45,138.60,138.60,44007200,2.95,51.45734626,1.192,0,19.59190606,0.6717572755,0.1507120743,5.33,307.051,13478.28027,15475.2002,7417.700195,7047.5,3030.798096,64363.78125,19824.90039,132.3798004,118.2836003,131.0959793,123.810582,130.0349998,139.8442744,120.2257253,57.69133628,1.158692997,-0.438577684,1.597270682,4.261429378,121.8053403,10821705900,95.7899759,96.77702451,14.90999985,Amazon's Fight with Lina Khan's FTC Intensifies. What's at Stake.,The Federal Trade Commission has accused Amazon of using a secret price-raising algorithm and destroying internal messages in a crucial antitrust case.,https://www.barrons.com/articles/amazon-stock-ftc-lina-khan-e6391009,barrons.com,9,federal trade commission accused amazon using secret priceraising algorithm destroying internal message crucial antitrust case,-0.6249,-0.56241,0.1871194118,-0.749529412,Negative Impact
06/11/2023,138.76,140.73,138.36,139.74,139.74,44970400,2.95,51.45734626,1.192,0,19.59190606,0.6717572755,0.1507120743,5.33,307.051,13518.78027,15440.5,7417.799805,7013.72998,3058.410889,64958.69141,19743.90039,132.5094006,118.4960504,131.4349607,123.9690837,130.6090004,141.2860868,119.931914,60.49759787,1.678834745,-0.015095198,1.693929944,4.154286521,123.5738069,10866676300,95.5764506,95.91655359,14.89000034,Amazon Uses Beatles' Tune ÃÂÃÂIn My Life' For Holiday Joy Ad Campaign,"The musical rendition of The Beatles' ""In My Life"" and the snowy backdrop bring Amazon's Joy Ride ad to life, showing the gift of lifelong friends.",https://www.forbes.com/sites/shelleykohan/2023/11/06/amazon-uses-beatles-tune-in-my-life-for-holiday-joy-ad-campaign/,forbes.com,8,musical rendition beatles life snowy backdrop bring amazon joy ride ad life showing gift lifelong friend,0.891,0.7128,0.3264716667,0.3863283333,Positive Impact
07/11/2023,140.55,143.37,140.50,142.71,142.71,53553500,2.95,51.45734626,1.192,0,19.59190606,0.6717572755,0.1507120743,5.33,307.051,13639.86035,15388.49023,7410,6986.22998,3057.27002,64942.39844,19575.59961,132.7008008,118.7220004,131.8771193,124.1555605,131.2705009,143.2169505,119.3240514,68.68273441,2.304144363,0.448752714,1.855391649,4.130714417,125.6325495,10920229800,97.36215631,96.24286094,14.81000042,"Walmart, Amazon, and others lost millions of dollars to an organized online refund fraud scheme","Retailers, including Walmart and Amazon, lose millions of dollars to refund fraud schemes. One crime ring recruited customers to falsely claim their e-commerce orders were damaged or never arrived.",https://www.businessinsider.com/retailers-lost-millions-in-organized-online-refund-fraud-scheme-2023-11,businessinsider.com,7,retailer including walmart amazon lose million dollar refund fraud scheme one crime ring recruited customer falsely claim ecommerce order damaged never arrived,-0.9042,-0.63294,0.1889373913,-0.821877391,Negative Impact
08/11/2023,142.97,143.12,141.22,142.08,142.08,44521700,2.95,51.45734626,1.192,0,19.59190606,0.6717572755,0.1507120743,5.33,307.051,13650.41016,15352.19043,7401.700195,7034.160156,3052.373047,64975.60938,19530.19922,132.8442007,118.9508004,132.2772324,124.3339132,131.7830009,144.6727195,118.8932824,67.36923088,2.717544451,0.9025110614,1.81503339,3.925713675,128.1157919,10875708100,94.84415084,95.92758592,14.44999981,3 Top Tech Stocks to Buy in November,"Apple is suffering from a market slump, but is still crushing it in digital services. Meanwhile, Microsoft has massive earnings potential in artificial intelligence.",https://www.fool.com/investing/2023/11/08/3-top-tech-stocks-to-buy-in-november/,fool.com,7,apple suffering market slump still crushing digital service meanwhile microsoft massive earnings potential artificial intelligence,-0.3612,-0.25284,0.3496943478,-0.602534348,Negative Impact
09/11/2023,142.02,142.65,139.84,140.60,140.60,36235400,2.95,51.45734626,1.192,0,19.59190606,0.6717572755,0.1507120743,5.33,307.051,13521.4502,15235.17969,7455.700195,7113.660156,3053.279053,64832.19922,19587.40039,132.9548007,119.1679005,132.6036157,124.4957649,132.1965012,145.6771597,118.7158426,70.50226672,2.892401904,1.30048923,1.591912674,3.88142831,130.2513804,10839472700,88.92889934,93.7117355,15.28999996,"How Arm is gaining chip dominance with its architecture in Apple, Nvidia, AMD, Amazon, Qualcomm and more","Arm is seeing a surge of popularity, with its low-power chip architecture used by Apple, Amazon, Nvidia, AMD and more - helping make it the year's biggest IPO.",https://www.cnbc.com/2023/11/09/how-arm-gained-chip-dominance-with-apple-nvidia-amazon-and-qualcomm.html,cnbc.com,9,arm seeing surge popularity lowpower chip architecture used apple amazon nvidia amd helping make year biggest ipo,0.7184,0.64656,0.39942,0.24714,Positive Impact
10/11/2023,140.46,143.65,139.91,143.56,143.56,49287800,2.95,51.45734626,1.192,0,19.59190606,0.6717572755,0.1507120743,5.33,307.051,13798.11035,15388.44043,7360.600098,7045.040039,3038.969971,64904.67969,19654.5,133.0658008,119.3896004,133.0332777,124.6854587,132.8850014,147.2271795,118.5428232,71.68367516,3.232561313,1.686903646,1.545657666,3.869999477,132.0879864,10888760500,99.64428319,94.47244446,14.17000008,Retail Earnings Loom: What's in Store?,"We have started seeing signs of stress at the lower end of income distribution, and one can intuitively project moderation in consumer spending as the economy further slows down under the weight of tighter monetary conditions.",https://www.zacks.com/commentary/2182574/retail-earnings-loom-what-s-in-store,zacks.com,8,started seeing sign stress lower end income distribution one intuitively project moderation consumer spending economy slows weight tighter monetary condition,-0.6124,-0.48992,0.366462,-0.856382,Negative Impact
13/11/2023,142.08,143.23,140.67,142.59,142.59,35680600,2.95,51.45734626,1.192,0,19.59190606,0.6717572755,0.1507120743,5.33,307.051,13767.74023,15403.13965,7425.799805,7087.060059,3046.532959,64933.87109,19709.19922,133.1552008,119.5913504,133.408051,124.8636133,133.387001,148.3683964,118.4056057,68.37830685,3.384850652,2.026493048,1.358357605,3.900713239,133.9379076,10853079900,95.81028557,94.79448937,14.76000023,Amazon cuts 180 jobs in its gaming division,"Amazon.com Inc (NASDAQ:AMZN) has made another round of job cuts in its gaming division, slashing about 180 jobs as part of a broader restructuring. According to media reports, which cited an email from vice president of Amazon Games Christoph Hartmann, the company began telling impacted employees on Monday morning.",https://www.proactiveinvestors.com/companies/news/1032945?SNAPI,proactiveinvestors.com,5,amazoncom inc nasdaqamzn made another round job cut gaming division slashing job part broader restructuring according medium report cited email vice president amazon game christoph hartmann company began telling impacted employee monday morning,-0.3612,-0.1806,0.2377352941,-0.418335294,Negative Impact
14/11/2023,145,147.26,144.68,145.80,145.80,56674600,2.95,51.45734626,1.192,0,19.59190606,0.6717572755,0.1507120743,5.33,307.051,14094.37988,15732.66992,7440.5,7185.680176,3056.070068,64933.87109,20023.69922,133.3258008,119.8176004,133.8940099,125.0719356,134.1035011,150.0391663,118.167836,85.67670107,3.721660777,2.365526593,1.356134183,3.679284777,135.4918414,10909754500,94.94987321,96.80148066,14.15999985,US FDA warns Amazon against sale of unapproved eye drops,The U.S. Food and Drug Administration said on Tuesday it had sent a warning letter to Amazon.com related to sale of seven unapproved eye drops on the company's e-commerce platform.,https://www.reuters.com/business/healthcare-pharmaceuticals/us-fda-warns-amazon-against-sale-unapproved-eye-drops-2023-11-14/,reuters.com,10,u food drug administration said tuesday sent warning letter amazoncom related sale seven unapproved eye drop company ecommerce platform,-0.7096,-0.7096,0.28228,-0.99188,Negative Impact
15/11/2023,147.06,147.29,142.59,143.20,143.20,63875700,2.95,51.45734626,1.192,0,19.59190606,0.6717572755,0.1507120743,5.33,307.051,14103.83984,15765.01953,7486.899902,7209.609863,3072.834961,65675.92969,20057.90039,133.4826007,120.0179504,134.2589506,125.2523143,134.8570007,151.0268174,118.6871841,83.76677392,3.73572337,2.639565949,1.096157421,3.779998779,137.610109,10845878800,81.21269192,90.6576169,14.18000031,Amazon says unapproved eye drops being removed from its platform,Amazon said on Wednesday it was in the process of removing seven unapproved eye drops from its e-commerce platform following a warning letter from the U.S. health regulator earlier this week.,https://www.reuters.com/business/healthcare-pharmaceuticals/amazon-says-unapproved-eye-drops-being-removed-its-platform-2023-11-15/,reuters.com,10,amazon said wednesday process removing seven unapproved eye drop ecommerce platform following warning letter u health regulator earlier week,-0.6369,-0.6369,0.2100063636,-0.846906364,Negative Impact
16/11/2023,140.91,143.32,139.52,142.83,142.83,49653500,2.95,51.45734626,1.192,0,19.59190606,0.6717572755,0.1507120743,5.33,307.051,14113.66992,15716.5498,7411,7168.399902,3050.926025,65982.47656,20053.09961,133.5822006,120.2063504,134.5950702,125.4272167,135.5785011,151.8227789,119.3342233,77.74916951,3.674653445,2.846583448,0.8280699971,3.30499867,147.2899933,10796225300,76.18797399,84.11684637,14.31999969,"Tech Turns Hot, ETFs Touch New 52-Week Highs",The technology sector is back in the groove and dominating the stock market rally once again since the start of November.,https://www.zacks.com/stock/news/2185539/tech-turns-hot-etfs-touch-new-52-week-highs,zacks.com,8,technology sector back groove dominating stock market rally since start november,-0.296,-0.2368,0.2556378261,-0.492437826,Negative Impact
17/11/2023,142.66,145.23,142.54,145.18,145.18,49636700,2.95,51.45734626,1.192,0,19.59190606,0.6717572755,0.1507120743,5.33,307.051,14125.48047,15813.45996,7504.299805,7233.910156,3054.370117,65794.72656,20175.80078,133.7212006,120.3677004,135.0101652,125.6237617,136.5790009,152.587192,120.5708097,75.376455,3.772393903,3.031745539,0.7406483636,3.121427264,147.2899933,10845862000,86.45698056,81.28588216,13.80000019,Amazon and Walmart's Latest Battleground: Digital Holiday Shoppers,"As Thanksgiving approaches, brands and retailers are pulling out all the stops to gobble up hesitant consumers' inflated dollars, and Amazon and Walmart are no exception. However, this time, the two retail giants are going head-to-head, and the battleground is the digital arena.",https://www.pymnts.com/news/retail/2023/amazon-and-walmarts-latest-battleground-digital-holiday-shoppers/?utm_source=snapi,pymnts.com,5,thanksgiving approach brand retailer pulling stop gobble hesitant consumer inflated dollar amazon walmart exception however time two retail giant going headtohead battleground digital arena,-0.6369,-0.31845,0.204625,-0.523075,Negative Impact
20/11/2023,145.13,146.63,144.73,146.13,146.13,41951200,2.95,51.45734626,1.192,0,19.59190606,0.6717572755,0.1507120743,5.33,307.051,14284.53027,15881.62988,7496.399902,7246.930176,3068.319092,65655.14844,20246.5,133.7818005,120.5814004,135.4462374,125.827804,137.5575012,153.3784558,121.7365466,75.9347672,3.88176539,3.201749509,0.6800158806,3.124285017,147.1345935,10887813200,91.45810346,84.70101933,13.40999985,3 AI Stocks Practically Guaranteed to Generate Big Gains,"First, let's acknowledge the elephant in the room. Reasons remain unknown regarding the firing of OpenAI CEO Sam Altman.",https://investorplace.com/2023/11/3-ai-stocks-practically-guaranteed-to-generate-big-gains/,investorplace.com,6,first let acknowledge elephant room reason remain unknown regarding firing openai ceo sam altman,-0.34,-0.204,0.3741311538,-0.578131154,Negative Impact
21/11/2023,143.91,144.05,141.50,143.90,143.90,71226000,2.95,51.45734626,1.192,0,19.59190606,0.6717572755,0.1507120743,5.33,307.051,14199.98047,15861.57031,7482,7229.450195,3067.933105,65930.77344,20110,133.8352005,120.7900004,135.7777572,126.0076267,138.324501,153.7922518,122.8567503,64.70585557,3.745326044,3.310464816,0.4348612282,3.150713239,146.9823017,10816587200,68.6691139,82.19473264,13.35000038,Are Technology Stocks Ready To Lead the Next Bull Market?,The main engine of the domestic economy and stock market indices is the technology sector. No doubt about it.,https://www.seeitmarket.com/are-technology-stocks-ready-to-lead-the-next-bull-market/,seeitmarket.com,5,main engine domestic economy stock market index technology sector doubt,-0.3612,-0.1806,0.2969361905,-0.47753619,Negative Impact
22/11/2023,144.57,147.74,144.57,146.71,146.71,45669100,2.95,51.45734626,1.192,0,19.59190606,0.6717572755,0.1507120743,5.33,307.051,14265.86035,15907.88965,7469.5,7260.72998,3043.611084,66023.24219,20114,133.8724005,121.0130004,136.2064729,126.2136206,139.5905014,153.2628165,125.9181863,67.14283725,3.81990791,3.412353435,0.4075544748,3.257857186,139.5200043,10862256300,89.990302,83.37250645,12.85000038,Wall Street Bulls Look Optimistic About Amazon (AMZN): Should You Buy?,"Investors often turn to recommendations made by Wall Street analysts before making a Buy, Sell, or Hold decision about a stock. While media reports about rating changes by these brokerage-firm employed (or sell-side) analysts often affect a stock's price, do they really matter?",https://www.zacks.com/stock/news/2187819/wall-street-bulls-look-optimistic-about-amazon-amzn-should-you-buy,zacks.com,8,investor often turn recommendation made wall street analyst making buy sell hold decision stock medium report rating change brokeragefirm employed sellside analyst often affect stock price really matter,0.101,0.0808,0.3908405882,-0.310040588,Negative Impact
24/11/2023,146.7,147.20,145.32,146.74,146.74,22378400,2.95,51.45734626,1.192,0,19.59190606,0.6717572755,0.1507120743,5.33,307.051,14250.84961,15983.82031,7488.200195,7292.799805,3040.971924,65970.03906,20103.09961,133.9128006,121.2464504,136.6195526,126.4178632,140.9490017,151.2222415,130.6757619,66.47771324,3.837202346,3.497323217,0.3398791289,3.246427264,139.6844043,10884634700,89.33902474,82.66614688,12.46000004,iRobot Stock Jumps on Report Amazon Deal Set to Win EU Approval,"Amazon's $1.4 billion deal to buy smart vacuum cleaner company iRobot is set to win full EU antitrust approval, according to a report.",https://www.barrons.com/articles/irobot-stock-amazon-eu-approval-report-4fd11168,barrons.com,9,amazon billion deal buy smart vacuum cleaner company irobot set win full eu antitrust approval according report,0.9001,0.81009,0.1980030769,0.6120869231,Positive Impact
27/11/2023,147.53,149.26,146.88,147.73,147.73,53762400,2.95,51.45734626,1.192,0,19.59190606,0.6717572755,0.1507120743,5.33,307.051,14241.01953,15930.88965,7460.700195,7265.490234,3031.699951,65970.03906,20032.69922,134.0596005,121.4939004,137.0552562,126.6299242,141.9485016,150.5671657,133.3298375,66.2728804,3.885996896,3.575057953,0.3109389434,3.257141113,139.8455163,10938397100,84.29157789,87.87363488,12.68999958,The biggest delivery business in the U.S. is no longer UPS or FedEx,"Amazon.com has taken over the largest delivery business in the U.S., surpassing both UPS and FedEx in parcel volumes, postal service remains biggest delivery service.",https://www.foxbusiness.com/markets/biggest-delivery-business-u-s-no-longer-ups-fedex,foxbusiness.com,5,amazoncom taken largest delivery business u surpassing ups fedex parcel volume postal service remains biggest delivery service,0,0,0.3528194118,-0.352819412,Negative Impact
28/11/2023,146.98,147.60,145.53,147.03,147.03,42711700,2.95,51.45734626,1.192,0,19.59190606,0.6717572755,0.1507120743,5.33,307.051,14281.75977,15929.15039,7455.200195,7250.129883,3038.550049,66174.20313,20036.80078,134.2006006,121.7410004,137.4464226,126.83291,142.6645012,150.3839943,134.945008,59.69476962,3.824101168,3.624866596,0.1992345717,3.154998779,140.2220954,10895685400,77.1047437,83.57844878,12.68999958,"Thanksgiving TV broadcasts drew record-breaking ratings, even as industry grapples with cord-cutting","Thanksgiving broadcasts broke ratings records across the board, even as traditional TV grapples with cord-cutting.",https://www.cnbc.com/2023/11/28/thanksgiving-broadcasts-post-record-ratings.html,cnbc.com,9,thanksgiving broadcast broke rating record across board even traditional tv grapple cordcutting,-0.4215,-0.37935,0.2978097619,-0.677159762,Negative Impact
29/11/2023,147.85,148.54,145.97,146.32,146.32,40610900,2.95,51.45734626,1.192,0,19.59190606,0.6717572755,0.1507120743,5.33,307.051,14258.49023,15962.99023,7423.5,7267.640137,3021.687012,66901.90625,20116.19922,134.3744006,121.9749004,137.7944063,127.0268115,143.3260017,149.7495628,136.9024406,59.48122848,3.675390367,3.63497135,0.0404190173,3.202855791,140.5836114,10855074500,69.8152964,77.07053933,12.97999954,Wall Street strategists actually called 2023 correctly ÃÂÃÂ apart from these seven stocks,"As Wall Street strategists roll out their 2024 forecasts, they've been getting plenty of side-eye for largely steering their clients wrong on where stocks would end up in 2023.",https://www.marketwatch.com/story/wall-street-strategists-actually-called-2023-correctly-apart-from-these-seven-stocks-aeaac857,marketwatch.com,8,wall street strategist roll forecast theyve getting plenty sideeye largely steering client wrong stock would end,-0.4767,-0.38136,0.3542281818,-0.735588182,Negative Impact
30/11/2023,144.76,146.93,144.33,146.09,146.09,65814000,2.95,51.45734626,1.192,0,19.59190606,0.6717572755,0.1507120743,5.33,307.051,14226.21973,16088.83984,7453.799805,7310.77002,3029.673096,66988.4375,20236.30078,134.5904007,122.2068504,138.1197236,127.2164949,143.7805016,149.5749657,137.9860374,63.00328306,3.498645812,3.607706242,-0.109060431,3.187855312,140.9306667,10789260500,67.45378494,71.45794168,12.92000008,AMZN Stock Forecast 2024: Why the Hate for Amazon.com?,"Over the last few years, a small army of critics has descended on Amazon (NASDAQ: AMZN ) stock. Financial analysts fear it has lost its momentum.",https://investorplace.com/2023/11/amzn-stock-forecast-2024-why-the-hate-for-amazon-com/,investorplace.com,6,last year small army critic descended amazon nasdaq amzn stock financial analyst fear lost momentum,-0.7096,-0.42576,0.2506766667,-0.676436667,Negative Impact
01/12/2023,146,147.25,145.55,147.03,147.03,39924600,2.95,51.45734626,1.192,0,19.59190606,0.6717572755,0.1507120743,5.33,306.746,14305.03027,16263.75,7529.399902,7346.149902,3031.635986,67481.1875,20452.90039,134.9444006,122.4362004,138.4691461,127.4136442,144.2285011,149.5283628,138.9286395,59.08851844,3.395286074,3.565222209,-0.169936134,3.042141506,141.2638398,10829185100,77.1047437,71.45794168,12.63000011,Should You Really Invest in Stocks Now -- or Wait Until the New Year?,"Markets often rally in the last few trading days of the year, but that isn't necessarily a reason to buy stocks now. In addition, ongoing economic headwinds aren't necessarily a reason to sell or avoid stocks.",https://www.fool.com/investing/2023/12/01/should-you-really-invest-in-stocks-now-or-wait/,fool.com,7,market often rally last trading day year isnt necessarily reason buy stock addition ongoing economic headwind arent necessarily reason sell avoid stock,-0.296,-0.2072,0.2832065385,-0.490406538,Negative Impact
04/12/2023,145.25,145.35,142.81,144.84,144.84,48294200,2.95,51.45734626,1.192,0,19.59190606,0.6717572755,0.1507120743,5.33,306.746,14185.49023,16232.82031,7513,7332.589844,3022.914063,68865.11719,20410.19922,135.2588007,122.6696504,138.7189834,127.5870408,144.5405006,149.1326594,139.9483419,55.53913562,3.100912455,3.472360258,-0.371447803,3.137141636,141.583686,10780890900,54.6200965,66.39287505,13.07999992,Elon Musk Isn't Afraid of Competition. SpaceX to Launch Amazon Satellites.,"Internet services from space hasn't been much of a competition. SpaceX has more than 5,000 Starlink satellites in orbit.",https://www.barrons.com/articles/elon-musk-spacex-amazon-satellites-9f494f39,barrons.com,9,internet service space hasnt much competition spacex starlink satellite orbit,0,0,0.37846625,-0.37846625,Negative Impact
05/12/2023,143.55,148.57,143.13,146.88,146.88,46822400,2.95,51.45734626,1.192,0,19.59190606,0.6717572755,0.1507120743,5.33,306.746,14229.91016,16123.04004,7489.799805,7386.990234,2972.295898,69296.14063,20375.90039,135.5710007,122.9180504,139.0390235,127.7790106,144.8975006,149.0026239,140.7923773,52.82131699,2.997675544,3.377423315,-0.379747771,3.192141942,141.8907384,10827713300,75.56476375,69.09653465,12.85000038,Partake Teams With Amazon to Take a Bite Out of Food Allergies,"The surge in food allergies is molding the culinary scenery, reshaping a once-ignored issue into a major focus within the food industry.",https://www.pymnts.com/news/retail/2023/partake-teams-with-amazon-to-take-a-bite-out-of-food-allergies/?utm_source=snapi,pymnts.com,5,surge food allergy molding culinary scenery reshaping onceignored issue major focus within food industry,0,0,0.2549871429,-0.254987143,Negative Impact
06/12/2023,147.58,147.85,144.28,144.52,144.52,39679000,2.95,51.45734626,1.192,0,19.59190606,0.6717572755,0.1507120743,5.33,306.746,14146.70996,16092.37012,7515.399902,7435.990234,2968.933105,69653.72656,20274.19922,135.9418007,123.1677504,139.2539639,127.9455876,144.9880005,148.96797,141.008031,53.49207836,2.694368222,3.240812297,-0.546444074,3.111428397,142.1855086,10788034300,51.33475373,60.506538,12.97000027,Last Chance Buys: 3 Stocks to Snap Up Before Quarter's End,"The tight monetary policies, high inflation and low consumer spending led to a massive correction in the stock market this year. Several companies suffered from rising interest rates, but the recent quarterly earnings season has shown mixed results.",https://investorplace.com/2023/12/last-chance-buys-3-stocks-to-snap-up-before-quarters-end/,investorplace.com,6,tight monetary policy high inflation low consumer spending led massive correction stock market year several company suffered rising interest rate recent quarterly earnings season shown mixed result,-0.3182,-0.19092,0.3052575,-0.4961775,Negative Impact
07/12/2023,146.15,147.92,145.34,146.88,146.88,52352800,2.95,51.45734626,1.192,0,19.59190606,0.6717572755,0.1507120743,5.33,306.746,14339.99023,16136.84961,7513.700195,7428.52002,2966.206055,69521.6875,20278.5,136.3598007,123.4232005,139.5530243,128.1339898,145.2280006,149.0451908,141.4108105,59.69362674,2.614291387,3.115508115,-0.501216728,3.082856315,142.4684881,10840387100,69.33000891,65.40984213,13.06000042,"It's Not Just AlibabaÃÂÃÂTemu Is Threatening Amazon and Dollar General, Too",The discount online retailer owned by China's PDD has emerged as a competitive threat to a number of players as consumers feel the pinch.,https://www.barrons.com/articles/temu-alibaba-amazon-stocks-retail-dollar-general-372cdf83,barrons.com,9,discount online retailer owned china pdd emerged competitive threat number player consumer feel pinch,-0.34,-0.306,0.2176227273,-0.523622727,Negative Impact
08/12/2023,145.48,147.84,145.40,147.42,147.42,41858000,2.95,51.45734626,1.192,0,19.59190606,0.6717572755,0.1507120743,5.33,306.746,14403.96973,16207.75977,7554.5,7526.549805,2969.559082,69825.60156,20331.5,136.7886006,123.6812004,139.8615331,128.3258904,145.5690002,148.8222698,142.3157307,55.87002541,2.564837018,3.005373895,-0.440536877,3.064999172,142.7401483,10882245100,76.2886902,65.65115095,12.35000038,EXPE or AMZN: Which Is the Better Value Stock Right Now?,Investors looking for stocks in the Internet - Commerce sector might want to consider either Expedia (EXPE) or Amazon (AMZN). But which of these two stocks offers value investors a better bang for their buck right now?,https://www.zacks.com/stock/news/2195637/expe-or-amzn-which-is-the-better-value-stock-right-now,zacks.com,8,investor looking stock internet commerce sector might want consider either expedia expe amazon amzn two stock offer value investor better bang buck right,0.743,0.5944,0.252210625,0.342189375,Positive Impact
11/12/2023,145.66,146.19,143.64,145.89,145.89,50907300,2.95,51.45734626,1.192,0,19.59190606,0.6717572755,0.1507120743,5.33,306.746,14432.49023,16274.44043,7544.899902,7551.529785,2991.438965,69928.53125,20318.40039,137.1640005,123.9431504,140.0979435,128.5006576,145.6855003,148.7997588,142.5712419,49.38961022,2.374810622,2.879261241,-0.504450619,3.199284145,143.0009422,10831337800,56.57219713,67.39696541,12.63000011,"Why Big Tech Stocks Alphabet, Amazon, and Meta Dropped on Monday",Alphabet is selling off after the Google Gemini announcement seems to be overpromising on AI capabilities. Meta has fallen as CEO Mark Zuckerberg's share sales continue.,https://www.fool.com/investing/2023/12/11/why-big-tech-stocks-alphabet-amazon-and-meta-dropp/,fool.com,7,alphabet selling google gemini announcement seems overpromising ai capability meta fallen ceo mark zuckerbergs share sale continue,-0.0772,-0.05404,0.2016945455,-0.255734545,Negative Impact
12/12/2023,145.52,147.50,145.30,147.48,147.48,44944300,2.95,51.45734626,1.192,0,19.59190606,0.6717572755,0.1507120743,5.33,306.746,14533.40039,16285.94043,7542.799805,7543.549805,3003.437988,69551.03125,20233.80078,137.5244003,124.2117504,140.3874358,128.6895067,145.9300003,148.7773755,143.0826251,59.41114886,2.325703488,2.76854969,-0.442846202,3.025712149,143.2513043,10876282100,72.40310664,68.42133132,12.06999969,2 Underrated Warren Buffett Stocks That Are Smart Buys Right Now,Amazon's margin expansion makes it one to watch in 2024. Visa is trading at the lowest levels it has in a while despite strong success.,https://www.fool.com/investing/2023/12/12/2-underrated-warren-buffett-stocks-that-are-smart/,fool.com,7,amazon margin expansion make one watch visa trading lowest level despite strong success,-0.765,-0.5355,0.08400333333,-0.619503333,Negative Impact
13/12/2023,148.12,149.46,146.82,148.84,148.84,52766200,2.95,51.45734626,1.192,0,19.59190606,0.6717572755,0.1507120743,5.33,306.746,14733.95996,16560.71094,7548.399902,7531.220215,2968.760986,69584.60156,20629.5,138.0068002,124.4848004,140.7189087,128.8900091,146.082,149.2108114,142.9531885,56.06144162,2.369215571,2.688682866,-0.319467295,2.939996992,143.4916519,10929048300,90.67654854,73.2172841,12.18999958,"Throw away those target-date funds, and don't hold bonds at all, says this daring new research","The last Fed meeting of the year is upon us, as those record highs for stock markets just keep coming. Can the Fed keep those fires burning?",https://www.marketwatch.com/story/throw-away-those-target-date-funds-and-dont-hold-bonds-at-all-says-this-daring-new-research-ea296169,marketwatch.com,8,last fed meeting year upon u record high stock market keep coming fed keep fire burning,-0.34,-0.272,0.371123,-0.643123,Negative Impact
14/12/2023,149.93,150.54,145.52,147.42,147.42,58400800,2.95,51.45734626,1.192,0,19.59190606,0.6717572755,0.1507120743,5.33,306.746,14761.55957,16723.91992,7649,7575.850098,2958.986084,70514.20313,20778.80078,138.4152002,124.7610504,140.9816966,129.0743871,146.293,149.1618461,143.424154,51.79323044,2.26303042,2.603552377,-0.340521957,3.164282663,143.8497532,10870647500,59.63781576,74.23915698,12.47999954,Amazon boosted by winning legal wrangle with the EU,"The European Commission has lost a landmark case in its efforts to crack down on favourable tax deals between member states and big companies, after the EU's top court ruled on Thursday it could not force Amazon to pay back ÃÂÃÂ250 million in taxes to Luxembourg. The European Court of Justice (ECJ) upheld the findings of the lower court which dismissed the argument that the US ecommerce group's tax arrangements in the bloc amounted to illegal state aid.",https://www.proactiveinvestors.com/companies/news/1036200?SNAPI,proactiveinvestors.com,5,european commission lost landmark case effort crack favourable tax deal member state big company eu top court ruled thursday could force amazon pay back million tax luxembourg european court justice ecj upheld finding lower court dismissed argument u ecommerce group tax arrangement bloc amounted illegal state aid,-0.5859,-0.29295,0.2417577778,-0.534707778,Negative Impact
15/12/2023,148.38,150.57,147.88,149.97,149.97,110039100,2.95,51.45734626,1.192,0,19.59190606,0.6717572755,0.1507120743,5.33,306.746,14813.91992,16609.83984,7576.399902,7596.910156,2942.556885,71483.75,20529.19922,138.8954002,125.0502504,141.3341791,129.2823037,146.65,149.4811359,143.8188641,55.45810192,2.357466452,2.554335192,-0.19686874,3.209284101,144.3849724,10980686600,92.26797231,80.86077887,12.27999973,Next-Generation Retail: 7 Stocks Innovating in E-Commerce,E-commerce has revolutionized the way people buy products and services. The convenience of e-commerce has led to the collapse of American shopping malls.,https://investorplace.com/2023/12/next-generation-retail-7-stocks-innovating-in-e-commerce/,investorplace.com,6,ecommerce revolutionized way people buy product service convenience ecommerce led collapse american shopping mall,-0.4939,-0.29634,0.4096494118,-0.705989412,Negative Impact
18/12/2023,150.56,154.85,150.05,154.07,154.07,62512800,2.95,51.45734626,1.192,0,19.59190606,0.6717572755,0.1507120743,5.33,306.746,14904.80957,16656.75977,7614.5,7568.859863,2930.800049,71315.09375,20622.69922,139.4176004,125.3461004,141.8336233,129.5289475,147.0945007,151.3746087,142.8143928,64.71572866,2.731655095,2.589799173,0.1418559226,3.400713239,145.0034759,11043199400,93.52160942,81.8091325,12.56000042,"3 Stock-Split Stocks With 51% to 128% Upside in 2024, According to Select Wall Street Analysts","When volatility picks up on Wall Street, investors usually seek out time-tested outperformers. Since July 2021, nine industry-leading businesses have conducted forward-stock splits.",https://www.fool.com/investing/2023/12/18/3-stock-split-stocks-51-to-128-upside-wall-street/,fool.com,7,volatility pick wall street investor usually seek timetested outperformers since july nine industryleading business conducted forwardstock split,0,0,0.3840645455,-0.384064545,Negative Impact
19/12/2023,154.4,155.12,152.69,153.79,153.79,43171300,2.95,51.45734626,1.192,0,19.59190606,0.6717572755,0.1507120743,5.33,306.746,15003.21973,16798.40039,7638,7574.669922,2932.391113,71437.1875,20839.59961,139.9282004,125.6463004,142.3025006,129.7703509,147.4775002,152.6682284,142.2867719,65.90032889,2.971355561,2.66611045,0.3052451107,3.390713283,146.1850595,11000028100,89.19575877,91.66178017,12.52999973,"BEVs are out, hybrids are in; here's where to invest","The BEV battery electric vehicle market isn't extinct or even dying. Still, several developments suggest that it has matured quicker than expected, demand is less than forecast, and the hybrid vehicle market is getting a lift.",https://www.marketbeat.com/originals/bevs-are-out-hybrids-are-in-heres-where-to-invest/?utm_source=snapi,marketbeat.com,5,bev battery electric vehicle market isnt extinct even dying still several development suggest matured quicker expected demand less forecast hybrid vehicle market getting lift,-0.128,-0.064,0.4288553333,-0.492855333,Negative Impact
20/12/2023,152.9,155.63,151.56,152.12,152.12,50322100,2.95,51.45734626,1.192,0,19.59190606,0.6717572755,0.1507120743,5.33,306.746,14777.94043,16534.7207,7715.700195,7583.430176,2902.110107,70506.3125,20600.80078,140.3810004,125.9391504,142.6875004,129.9927355,147.8885002,153.1871231,142.5898773,62.09384912,2.992074242,2.731303209,0.2607710336,3.49571446,147.4359505,10949706000,72.6208443,85.1127375,13.67000008,The AI Revolution May Favor Amazon and Meta More Than Alphabet,"Artificial intelligence could be the next big step for digital platforms. Amazon.com and Facebook-owner Meta may be the best bets, according to Raymond James.",https://www.barrons.com/articles/ai-stocks-amazon-meta-google-656886aa,barrons.com,9,artificial intelligence could next big step digital platform amazoncom facebookowner meta may best bet according raymond james,0.8074,0.72666,0.30931125,0.41734875,Positive Impact
21/12/2023,153.3,153.97,152.10,153.84,153.84,36305700,2.95,51.45734626,1.192,0,19.59190606,0.6717572755,0.1507120743,5.33,306.746,14963.87012,16724.91992,7694.700195,7571.399902,2918.715088,70865.10156,20765.69922,140.8212003,126.2387503,143.1248532,130.2300216,148.2449997,154.1360776,142.3539218,63.24385791,3.11141719,2.807326005,0.3040911848,3.507857186,148.7469992,10986011700,86.03738282,82.6179953,13.64999962,"It's ÃÂÃÂStill Day One for Amazon Ads,' Bull Argues. The Stock Is Rising.","Shares of the retail giant have posted stellar gains in 2023. Next year looks bright too, analysts say.",https://www.barrons.com/articles/amazon-ads-bull-stock-39954f2a,barrons.com,9,share retail giant posted stellar gain next year look bright analyst say,0.8176,0.73584,0.2820254545,0.4538145455,Positive Impact
22/12/2023,153.77,154.35,152.71,153.42,153.42,29480100,2.95,51.45734626,1.192,0,19.59190606,0.6717572755,0.1507120743,5.33,306.746,14992.96973,16770.44922,7697.5,7568.819824,2914.774902,71106.96094,20881.19922,141.2430002,126.5446003,143.5285843,130.4607677,148.5789993,154.8556441,142.3023545,67.91979007,3.135957626,2.873052329,0.2629052967,3.323571341,149.8482801,10956531600,82.31994629,80.3260578,13.02999973,5 S&P 500 Winners of 2023 That Are Must Buys for 2024,"We have narrowed our search to five S&P 500 stocks. These are: RCL, LYV, AIZ, DVA, AMZN.",https://www.zacks.com/stock/news/2201424/5-s-p-500-winners-of-2023-that-are-must-buys-for-2024,zacks.com,8,narrowed search five sp stock rcl lyv aiz dva amzn,0,0,0.3907388889,-0.390738889,Negative Impact
26/12/2023,153.56,153.98,153.03,153.41,153.41,25067200,2.95,51.45734626,1.192,0,19.59190606,0.6717572755,0.1507120743,5.33,306.746,15074.57031,16859.49023,7697.5,7568.819824,2898.879883,71336.79688,20881.19922,141.7154004,126.8580003,143.916091,130.6891183,148.8629997,155.4825394,142.24346,64.90186602,3.118649772,2.922171818,0.1964779541,3.002856663,150.7733561,10931464400,81.48456878,83.28063263,12.98999977,The Smart Money: 3 Stocks the ÃÂÃÂSuper Investors' Are Buying,ÃÂÃÂYou can't beat the market so don't even try. Just buy an index fund instead.,https://investorplace.com/2023/12/the-smart-money-3-stocks-the-super-investors-are-buying/,investorplace.com,6,cant beat market dont even try buy index fund instead,0,0,0.3792775,-0.3792775,Negative Impact
27/12/2023,153.56,154.78,153.12,153.34,153.34,31434700,2.95,51.45734626,1.192,0,19.59190606,0.6717572755,0.1507120743,5.33,306.746,15099.17969,16898.33984,7725,7571.819824,2914.614014,72038.42969,21015.90039,142.1312003,127.1625503,144.2856559,130.9145002,149.1784996,156.0276986,142.3293006,72.47703211,3.063964689,2.950530392,0.1134342971,2.86642783,151.5504199,10900029700,80.90068811,81.56840106,12.43000031,Amazon's Prime Video to start showing ads starting Jan. 29,Subscribers of Amazon's Prime Video have one more month before they start seeing commercials ÃÂÃÂ or have to pay more to avoid them.,https://www.marketwatch.com/story/amazons-prime-video-to-start-showing-ads-starting-jan-29-28029eb4,marketwatch.com,8,subscriber amazon prime video one month start seeing commercial pay avoid,-0.2263,-0.18104,0.2780305263,-0.459070526,Negative Impact
28/12/2023,153.72,154.08,152.95,153.38,153.38,27057000,2.95,51.45734626,1.192,0,19.59190606,0.6717572755,0.1507120743,5.33,306.746,15095.13965,16890.58008,7722.700195,7535.160156,2954.704102,72410.38281,20929.40039,142.5694003,127.4550504,144.642297,131.1380375,149.5314995,156.4872884,142.5757106,68.78610728,2.989394839,2.958303281,0.03109155794,2.704285758,152.2031535,10927086700,81.23437057,81.20654248,12.47000027,Amazon to run ads on Prime Video ÃÂÃÂ unless subscribers pay more,Customers can receive ad-free service if they are willing to pay an additional $2.99 per month.,https://nypost.com/2023/12/28/business/amazon-to-run-ads-on-prime-video-unless-subscribers-pay-more/,nypost.com,5,customer receive adfree service willing pay additional per month,-0.1027,-0.05135,0.3640475,-0.4153975,Negative Impact
29/12/2023,153.1,153.89,151.03,151.94,151.94,39789000,2.95,51.45734626,1.192,0,19.59190606,0.6717572755,0.1507120743,5.33,306.746,15011.34961,16852.89063,7733.200195,7543.180176,2974.935059,72240.25781,20958.40039,143.0456003,127.7337504,144.9284816,131.3450222,149.8239998,156.6614364,142.9865632,62.41757542,2.782032001,2.923049025,-0.141017025,2.734285627,155.6300049,10887297700,69.22434737,77.11980201,12.44999981,Apple Is the American Company People Quit the Fastest,What's wrong with Apple Inc. (NASDAQ: AAPL) that people quit their jobs faster than at any other large American company?,https://247wallst.com/jobs/2023/12/29/apple-is-the-american-company-people-quit-the-fastest/,24/7 Wall Street,5,whats wrong apple inc nasdaq aapl people quit job faster large american company,-0.4767,-0.23835,0.335395,-0.573745,Negative Impact
02/01/2024,151.54,152.38,148.39,149.93,149.93,47339400,5.66,38.78057437,1.192,0,27.30545211,0.4577403224,0.2071825716,5.33,308.417,14765.94043,16841.61914,7721.5,7530.859863,2962.275879,71892.47656,20872.09961,143.4762003,127.9832003,145.1246193,131.5299473,149.9689995,156.6787623,143.2592367,60.81366427,2.42752151,2.823943522,-0.396422012,2.749286107,155.5380048,10839958300,44.82080158,65.09317317,13.19999981,Why the Magnificent 7 Aren't the Big Risk Everyone Says They Are,"Rallies by the big tech companies lifted the S&P 500 last year, raising concern that the index could fall if that group headed lower.",https://www.barrons.com/articles/magnificent-7-tech-stocks-risk-cea44f9a,barrons.com,9,rally big tech company lifted sp last year raising concern index could fall group headed lower,-0.296,-0.2664,0.29809375,-0.56449375,Negative Impact
03/01/2024,149.2,151.05,148.33,148.47,148.47,49425500,5.66,38.78057437,1.192,0,27.30545211,0.4577403224,0.2071825716,5.33,308.417,14592.20996,16718.65039,7682.299805,7411.859863,2967.24707,71356.60156,20818.59961,143.9422003,128.2308004,145.2558107,131.6985051,150.1504997,156.4605724,143.8404271,52.66847359,2.005640509,2.66028292,-0.654642411,2.786429269,155.2520845,10790532800,29.17899872,47.74138255,14.03999996,3 Undeniable Reasons Amazon Could Explode Higher in 2024,Amazon faced tough times in 2022 amid rising inflation and general economic woes. The company decided to revamp its cost structure -- and the effort has started to bear fruit.,https://www.fool.com/investing/2024/01/03/3-reasons-amazon-could-explode-higher-in-2024/,fool.com,7,amazon faced tough time amid rising inflation general economic woe company decided revamp cost structure effort started bear fruit,-0.3818,-0.26726,0.3046218182,-0.571881818,Negative Impact
04/01/2024,145.59,147.38,144.05,144.57,144.57,56039800,5.66,38.78057437,1.192,0,27.30545211,0.4577403224,0.2071825716,5.33,308.417,14510.2998,16715.71094,7723.100098,7450.629883,2954.349121,71847.57031,20871.40039,144.3024005,128.4651004,145.2289165,131.8265797,150.0349998,156.6731636,143.3968361,39.87675776,1.341140034,2.396454342,-1.055314308,2.913572039,154.8367596,10734493000,4.490537049,26.16344578,14.13000011,Why Amazon.com Stock Just Dropped,"Bloomberg reported on TikTok's growing e-commerce business last night -- and the threat it poses to Amazon. According to the news source, TikTok Shop could grow its U.S. sales 10x in one year.",https://www.fool.com/investing/2024/01/04/why-amazoncom-stock-just-dropped/,fool.com,7,bloomberg reported tiktoks growing ecommerce business last night threat pose amazon according news source tiktok shop could grow u sale x one year,-0.25,-0.175,0.2915790476,-0.466579048,Negative Impact
05/01/2024,144.69,146.59,144.53,145.24,145.24,45124800,5.66,38.78057437,1.192,0,27.30545211,0.4577403224,0.2071825716,5.33,308.417,14524.07031,16758.24023,7689.600098,7420.689941,2929.179932,72026.14844,20937.59961,144.6360007,128.6882504,145.2293513,131.9600466,150.0709999,156.5899708,143.5520291,44.64112636,0.8586835042,2.088900175,-1.230216671,2.702144078,153.9738191,10779617800,10.27635797,14.64863125,13.35000038,How I Beat The Market Again In 2023,"I express frustration with the constant negativity surrounding the idea that beating the market is impossible for the average investor. I share my personal success in beating the market in 2023, with a time-weighted return of 28.02%. I emphasize the importance of buying high-quality companies at fair prices and holding them for the long term, while also highlighting the power of compounding dividends.",https://seekingalpha.com/article/4661403-how-i-beat-the-market-again-in-2023,seekingalpha.com,6,express frustration constant negativity surrounding idea beating market impossible average investor share personal success beating market timeweighted return emphasize importance buying highquality company fair price holding long term also highlighting power compounding dividend,-0.4019,-0.24114,0.3569044444,-0.598044444,Negative Impact
08/01/2024,146.74,149.40,146.15,149.10,149.10,46757100,5.66,38.78057437,1.192,0,27.30545211,0.4577403224,0.2071825716,5.33,308.417,14843.76953,16885.36914,7694.200195,7450.240234,2887.538086,71355.21875,21074.90039,145.1902008,128.9402505,145.3811417,132.1305935,150.182,156.5459547,143.8180452,47.99077567,0.7788252062,1.826885181,-1.048059975,2.774285453,153.1799138,10826374900,43.60969131,19.45886211,13.07999992,"If You Can Only Buy One Growth Stock in January, It Better Be One of These 3 Names","Markets have gotten off to a rocky start in 2024. Stocks of the fastest growing technology companies have slipped the last several days, throwing a scare into many investors.",https://investorplace.com/2024/01/if-you-can-only-buy-one-growth-stock-in-january-it-better-be-one-of-these-3-names/,investorplace.com,6,market gotten rocky start stock fastest growing technology company slipped last several day throwing scare many investor,-0.3612,-0.21672,0.3939,-0.61062,Negative Impact
09/01/2024,148.33,151.71,148.21,151.37,151.37,43812600,5.66,38.78057437,1.192,0,27.30545211,0.4577403224,0.2071825716,5.33,308.417,14857.70996,16773.07031,7684,7426.620117,2893.25,71386.21094,20971,145.8262007,129.2035505,145.6159987,132.3220303,150.3794998,156.626641,144.1323586,43.18867001,0.8884644073,1.639201026,-0.750736619,2.675713675,152.4495209,10870187500,63.21235672,39.032802,12.76000023,Amazon's Twitch plans to slash staff: report,"Twitch ÃÂÃÂ the live-streaming platform run by Amazon.com Inc. AMZN, +1.52% ÃÂÃÂ plans to cut 500 jobs, or 35% of its workforce, amid worries about losses and steep costs of operations, Bloomberg reported on Tuesday. Bloomberg said the departures could be announced as early as Wednesday, and noted that they would come after other rounds of layoffs and after a handful of senior executives left the platform last year.",https://www.marketwatch.com/story/amazons-twitch-plans-to-slash-staff-report-ff30ddeb,marketwatch.com,8,twitch livestreaming platform run amazoncom inc amzn plan cut job workforce amid worry loss steep cost operation bloomberg reported tuesday bloomberg said departure could announced early wednesday noted would come round layoff handful senior executive left platform last year,-0.743,-0.5944,0.148911,-0.743311,Negative Impact
10/01/2024,152.06,154.42,151.88,153.73,153.73,44421800,5.66,38.78057437,1.192,0,27.30545211,0.4577403224,0.2071825716,5.33,308.417,14969.65039,16818.88086,7651.799805,7426.080078,2877.701904,71657.71094,20989.40039,146.3460007,129.4815504,145.9341947,132.5350449,150.7714996,156.813007,144.7299922,49.86301923,1.152501273,1.541861076,-0.389359803,2.720000131,144.0500031,10914609300,83.59232422,63.47145742,12.68999958,iRobot shares plunge 19% on report Amazon won't offer concessions to resolve EU probe,The European Commission last November warned the deal could harm competition.,https://www.cnbc.com/2024/01/10/irobot-shares-dip-on-report-amazon-wont-offer-eu-concessions.html,cnbc.com,9,european commission last november warned deal could harm competition,-0.6808,-0.61272,0.1286590909,-0.741379091,Negative Impact
11/01/2024,155.04,157.17,153.12,155.18,155.18,49072700,5.66,38.78057437,1.192,0,27.30545211,0.4577403224,0.2071825716,5.33,308.417,14970.19043,16781.11914,7576.600098,7387.620117,2886.649902,71721.17969,20918.40039,146.7954004,129.7672504,146.296775,132.7603678,151.1564995,157.2954248,145.0175741,57.05719233,1.461903117,1.525869484,-0.063966367,2.718571254,144.257403,10963682000,84.83226956,77.21231683,12.43999958,Amazon Misses EU Deadline for Concessions Over iRobot Deal,Amazon.com missed a deadline to offer remedies to the European Union over its $1.7 billion acquisition of Roomba maker iRobot.,https://www.wsj.com/articles/amazon-misses-eu-deadline-for-concessions-over-irobot-deal-14d68767,wsj.com,9,amazoncom missed deadline offer remedy european union billion acquisition roomba maker irobot,-0.296,-0.2664,0.2004616,-0.4668616,Negative Impact
12/01/2024,155.39,156.20,154.01,154.62,154.62,40460300,5.66,38.78057437,1.192,0,27.30545211,0.4577403224,0.2071825716,5.33,308.417,14972.75977,16799.53906,7624.899902,7465.140137,2881.977051,72568.45313,20990.19922,147.2260004,130.0541504,146.6231758,132.9778765,151.4454994,157.6688784,145.2221205,51.90058284,1.642979936,1.549291574,0.09368836124,2.74142892,144.7739068,10923221700,80.5639939,82.99619589,12.69999981,"Amazon, Google, Duolingo Cut Hundreds Of Jobs: Here Are The 2024 Tech Layoffs","Hundreds of employees were cut from major tech companies this week, including at Amazon, Google and Duolingo, as businesses look to ÃÂÃÂrightsizeÃÂÃÂ their workforces and cut costs, following up on a parade of layoffs that dominated the news cycle and led to even steeper cuts amid lingering recession fears in 2022 and 2023.",https://www.forbes.com/sites/brianbushard/2024/01/12/amazon-google-duolingo-cut-hundreds-of-jobs-here-are-the-2024-tech-layoffs/,forbes.com,8,hundred employee cut major tech company week including amazon google duolingo business look rightsize workforce cut cost following parade layoff dominated news cycle led even steeper cut amid lingering recession fear,-0.8625,-0.69,0.09393777778,-0.783937778,Negative Impact
16/01/2024,153.53,154.99,152.15,153.16,153.16,41384600,5.66,38.78057437,1.192,0,27.30545211,0.4577403224,0.2071825716,5.33,308.417,14944.34961,16639.38086,7558.299805,7398,2893.989014,73128.77344,20948.09961,147.5492004,130.3187004,146.879522,133.1786937,151.7324997,157.6983163,145.7666831,49.39704378,1.649659265,1.569365112,0.08029415223,2.827144078,145.2697504,10881837100,69.4360061,78.27742319,13.84000015,Small-Cap Stocks Continue to Warn of a Struggling Bull Market,"Small-cap stocks have reached a potential critical moment. In 2021, the Russell 2000 went sideways, had a false breakout toward the end of the year, then plummeted into the 2022 bear market.",https://investorplace.com/2024/01/small-cap-stocks-continue-to-warn-of-a-struggling-bull-market/,investorplace.com,6,smallcap stock reached potential critical moment russell went sideways false breakout toward end year plummeted bear market,-0.2263,-0.13578,0.3004378571,-0.436217857,Negative Impact
17/01/2024,151.49,152.15,149.91,151.71,151.71,34953400,5.66,38.78057437,1.192,0,27.30545211,0.4577403224,0.2071825716,5.33,308.417,14855.62012,16522.83008,7446.299805,7318.689941,2833.61499,71500.75781,20695,147.8220004,130.5672504,147.0689527,133.3630849,151.8195,157.7275644,145.9114355,46.30435201,1.520423549,1.5595768,-0.039153251,2.99143001,145.7457603,10846883700,58.38419598,69.46139866,14.78999996,"Google, Amazon Duolingo Cut Hundreds Of Jobs: Here Are The 2024 Tech Layoffs","Google this week announced plans to let go of ÃÂÃÂa few hundredÃÂÃÂ employees in its sales division, marking the latest round of layoffs at a major tech company this year, following cuts at Amazon, Discord and Duolingo, as businesses look to ÃÂÃÂrightsizeÃÂÃÂ their workforces and cut costs, following up on a parade of layoffs in 2022 and 2023.",https://www.forbes.com/sites/brianbushard/2024/01/17/google-amazon-duolingo-cut-hundreds-of-jobs-here-are-the-2024-tech-layoffs/,forbes.com,8,google week announced plan let go hundred employee sale division marking latest round layoff major tech company year following cut amazon discord duolingo business look rightsize workforce cut cost following parade layoff,-0.6369,-0.50952,0.2888871429,-0.798407143,Negative Impact
18/01/2024,152.77,153.78,151.82,153.50,153.50,37850200,5.66,38.78057437,1.192,0,27.30545211,0.4577403224,0.2071825716,5.33,308.417,15055.65039,16616.28906,7459.100098,7401.350098,2845.780029,71186.85938,20756.69922,148.1200003,130.8183004,147.3211507,133.5634522,151.7909996,157.6587145,145.9232847,50.32363239,1.544635219,1.556588484,-0.011953265,3.020714896,146.2027298,10884733900,72.02744257,66.61588155,14.13000011,EU antitrust regulator intends to block Amazon's iRobot acquisition - WSJ,"The European Union's competition watchdog plans to block Amazon.com's $1.4-billion deal for robot vacuum maker iRobot , The Wall Street Journal said on Thursday, citing people familiar with the matter.",https://www.reuters.com/markets/deals/eu-antitrust-regulator-intends-block-amazons-irobot-acquisition-wsj-2024-01-18/,reuters.com,10,european union competition watchdog plan block amazoncoms billion deal robot vacuum maker irobot wall street journal said thursday citing people familiar matter,-0.4215,-0.4215,0.151444,-0.572944,Negative Impact
19/01/2024,153.83,155.76,152.74,155.34,155.34,51033700,5.66,38.78057437,1.192,0,27.30545211,0.4577403224,0.2071825716,5.33,308.417,15310.96973,16729.55078,7461.899902,7371.640137,2832.279053,71683.22656,20906.5,148.4320001,131.0829504,147.6356152,133.7801342,151.8684998,157.8864055,145.850594,53.69531396,1.69278213,1.583827213,0.108954917,3.155713763,146.6414206,10935767600,86.05181012,72.15448289,13.30000019,"Wayfair, Google, Amazon Duolingo Cut Hundreds Of Jobs: Here Are The 2024 Tech Layoffs","Furniture e-commerce company Wayfair announced plans Friday morning to cut 13% of its workforce, amid a string of corporate layoffs this year at Google, Amazon, Discord and Duolingo, as businesses look to ÃÂÃÂrightsizeÃÂÃÂ their workforces and cut costs, following up on a parade of layoffs in 2022 and 2023.",https://www.forbes.com/sites/brianbushard/2024/01/19/wayfair-google-amazon-duolingo-cut-hundreds-of-jobs-here-are-the-2024-tech-layoffs/,forbes.com,8,furniture ecommerce company wayfair announced plan friday morning cut workforce amid string corporate layoff year google amazon discord duolingo business look rightsize workforce cut cost following parade layoff,-0.6369,-0.50952,0.1005531818,-0.610073182,Negative Impact
22/01/2024,156.89,157.05,153.90,154.78,154.78,43687500,5.66,38.78057437,1.192,0,27.30545211,0.4577403224,0.2071825716,5.33,308.417,15360.29004,16779.49023,7487.700195,7413.25,2756.340088,71683.22656,20924.30078,148.6734,131.3371004,147.9157871,133.9890881,152.0014999,158.1587711,145.8442287,55.53822441,1.744888513,1.616039473,0.1288490399,3.176428659,147.0625637,10892080100,81.78353446,79.95426238,13.18999958,"Amazon Pharmacy is Piloting A Consultation Program With One Medical, Further Bolstering Amazon's Healthcare Ecosystem",Amazon is forging ahead with its ambitious vision to re-imagine healthcare. Its latest initiative in this effort is to start integrating two of its most successful ventures: Amazon Pharmacy and One Medical.,https://www.forbes.com/sites/saibala/2024/01/22/amazon-pharmacy-is-piloting-a-consultation-program-with-one-medical-further-bolstering-amazons-healthcare-ecosystem/,forbes.com,8,amazon forging ahead ambitious vision reimagine healthcare latest initiative effort start integrating two successful venture amazon pharmacy one medical,0.8834,0.70672,0.3336683333,0.3730516667,Positive Impact
23/01/2024,154.85,156.21,153.93,156.02,156.02,37986000,5.66,38.78057437,1.192,0,27.30545211,0.4577403224,0.2071825716,5.33,308.417,15425.94043,16800.85938,7485.700195,7388.040039,2770.976074,70370.54688,21034.59961,148.9522,131.6117004,148.2335995,134.2083012,152.1105003,158.4783907,145.74261,62.24371532,1.864745649,1.665780708,0.1989649414,3.054286412,147.4668611,10930066100,91.23479936,86.35671465,12.55000019,The Labor Union That Defeated Amazon Is Fighting for Survival,"The Amazon Labor Union's leadership has been in turmoil following internal clashes with its president, who said funding for the organization has decreased.",https://www.wsj.com/articles/the-labor-union-that-defeated-amazon-is-fighting-for-survival-e9553de0,wsj.com,9,amazon labor union leadership turmoil following internal clash president said funding organization decreased,-0.2023,-0.18207,0.2618676923,-0.443937692,Negative Impact
24/01/2024,157.8,158.51,156.48,156.87,156.87,48547300,5.66,38.78057437,1.192,0,27.30545211,0.4577403224,0.2071825716,5.33,308.417,15481.91992,16769.25,7527.700195,7455.640137,2820.771973,71060.3125,21025.80078,149.2775998,131.8857504,148.5722817,134.4337907,152.2830002,158.9787257,145.5872747,67.31247248,2.005205688,1.733665704,0.2715399843,3.037857056,147.8549865,10978613400,88.65836543,87.22556641,13.14000034,Amazon's Ring will no longer allow police to request doorbell-camera footage from users,"NEW YORK ÃÂÃÂ Amazon AMZN, +0.54% -owned Ring will stop allowing police departments to request doorbell-camera footage from users, marking an end to a feature that has drawn criticism from privacy advocates.",https://www.marketwatch.com/story/amazons-ring-will-no-longer-allow-police-to-request-doorbell-camera-footage-from-users-1a39119b,marketwatch.com,8,new york amazon amzn owned ring stop allowing police department request doorbellcamera footage user marking end feature drawn criticism privacy advocate,-0.5267,-0.42136,0.2297335,-0.6510935,Negative Impact
25/01/2024,156.95,158.51,154.55,157.75,157.75,43638600,5.66,38.78057437,1.192,0,27.30545211,0.4577403224,0.2071825716,5.33,308.417,15510.5,16889.51953,7529.700195,7464.200195,2906.108887,70700.67188,21101.5,149.5613998,132.1636504,148.9321922,134.6657928,152.5,159.6175348,145.3824652,81.02640695,2.1626012,1.819452803,0.343148397,3.004999433,148.494287,11022252000,94.56370001,91.4856216,13.44999981,"Why it's time to avoid the Magnificent Seven stocks, says equity strategist","Easing inflation and a few Federal Reserve rate cuts this year could help bolster laggards of the U.S. stock market, especially if the economy avoids a recession, says Craig Sterling, head of equity research, U.S., at Amundi's investment institute.",https://www.marketwatch.com/story/why-its-time-to-avoid-the-magnificent-seven-stocks-says-equity-strategist-b74d3710,marketwatch.com,8,easing inflation federal reserve rate cut year could help bolster laggard u stock market especially economy avoids recession say craig sterling head equity research u amundis investment institute,-0.3489,-0.27912,0.2512258333,-0.530345833,Negative Impact
26/01/2024,158.42,160.72,157.91,159.12,159.12,51047400,5.66,38.78057437,1.192,0,27.30545211,0.4577403224,0.2071825716,5.33,308.417,15455.36035,16949.10938,7635.100098,7634.140137,2910.2229,70700.67188,21125.30078,149.8919998,132.4596504,149.3317139,134.9091182,152.7889999,160.4951835,145.0828164,81.63176171,2.370559104,1.929674064,0.4408850407,3.069999695,149.0952295,11073299400,89.01849486,90.74685343,13.26000023,Earnings Countdown: Mega-Cap Stocks Take the Stage Next Week,"Although next week will not be the most numerous in earnings reports, it will be the most important. Five of the ÃÂÃÂMagnificent Seven' stocks will be reporting and the two largest American energy companies ÃÂÃÂ sharing with investors some of the most valuable economic data in the world.",https://www.zacks.com/commentary/2216627/earnings-countdown-mega-cap-stocks-take-the-stage-next-week?cid=CS-STOCKNEWSAPI-FT-investment_ideas-2216627,zacks.com,8,although next week numerous earnings report important five magnificent seven stock reporting two largest american energy company sharing investor valuable economic data world,0.9136,0.73088,0.35053,0.38035,Positive Impact
29/01/2024,159.34,161.29,158.90,161.26,161.26,45270400,5.66,38.78057437,1.192,0,27.30545211,0.4577403224,0.2071825716,5.33,308.417,15628.04004,17040.59961,7632.700195,7640.810059,2883.360107,71941.57031,21200.09961,150.2011996,132.7768004,149.7994896,135.1713159,153.1829994,161.7716548,144.594344,80.06927596,2.677186369,2.079176525,0.5980098446,2.943571908,150.0252112,11118569800,99.7706513,94.45094872,13.60000038,Better Bull Market Buy: Amazon vs. Alibaba Stock,A cheaper valuation may assuage investor concerns about Alibaba's geopolitical risks. Those preferring to avoid such risks might choose Amazon instead.,https://www.fool.com/investing/2024/01/29/better-bull-market-buy-amazon-vs-alibaba-stock/,fool.com,7,cheaper valuation may assuage investor concern alibabas geopolitical risk preferring avoid risk might choose amazon instead,-0.5719,-0.40033,0.2758979545,-0.676227955,Negative Impact
30/01/2024,160.7,161.73,158.49,159.00,159.00,45207400,5.66,38.78057437,1.192,0,27.30545211,0.4577403224,0.2071825716,5.33,308.417,15509.90039,17089.46094,7666.299805,7677.470215,2830.5271,71139.89844,21227.90039,150.5171997,133.0598004,150.160294,135.4084173,153.5359993,162.4824368,144.5895618,68.87684223,2.706627698,2.204666759,0.5019609384,2.924999782,151.1516894,11073362400,76.90357394,88.56424003,13.31000042,"Five-star fund manager bets on cheap AI, beer and China plays",What are big money managers worried about? ÃÂÃÂThe problem is we're priced for a soft landing.,https://www.marketwatch.com/story/five-star-fund-manager-bets-on-cheap-ai-beer-and-china-plays-8b82bf57,marketwatch.com,8,big money manager worried problem priced soft landing,-0.5994,-0.47952,0.3647466667,-0.844266667,Negative Impact
31/01/2024,157,159.01,154.81,155.20,155.20,50284400,5.66,38.78057437,1.192,0,27.30545211,0.4577403224,0.2071825716,5.33,308.417,15164.00977,16911.13086,7630.600098,7656.75,2788.548096,71752.10938,21021.90039,150.7645996,133.3232504,150.3579294,135.6053484,153.7994995,162.6081196,144.9908794,53.39492773,2.395715359,2.242876479,0.1528388796,3.007142203,152.4210862,11023078000,44.75462637,73.8096172,14.35000038,"Red Sea container traffic is down almost 30% amid Houthi attacks, says IMF, as experts weigh wider impact","Houthi attacks on cargo ships have cut Red Sea container traffic by almost 30% since late last year, according to the International Monetary Fund.",https://www.marketwatch.com/story/red-sea-container-traffic-is-down-almost-30-amid-houthi-attacks-says-imf-as-experts-weigh-wider-impact-94079d97,marketwatch.com,8,houthi attack cargo ship cut red sea container traffic almost since late last year according international monetary fund,-0.6369,-0.50952,0.3235805,-0.8331005,Negative Impact
01/02/2024,155.87,159.76,155.62,159.28,159.28,76542400,5.66,38.78057437,1.192,0,27.30545211,0.4577403224,0.2071825716,5.33,310.326,15361.63965,17115.58008,7622.200195,7588.75,2770.73999,71645.29688,21119.19922,151.0465997,133.6059504,150.7078144,135.8409171,154.3399994,163.0981596,145.5818392,58.4431867,2.450291702,2.284359524,0.1659321786,3.043570382,153.5381553,11099620400,79.27243153,66.97687728,13.88000011,Russian court fines Amazon 2 mln roubles for failing to remove banned content -court,"A Russian court on Thursday said it had fined U.S. e-commerce giant Amazon 2 million roubles ($22,254) for failing to remove what it said was illegal content.",https://www.reuters.com/technology/russian-court-fines-amazon-2-mln-roubles-failing-remove-banned-content-court-2024-02-01/,reuters.com,10,russian court thursday said fined u ecommerce giant amazon million rouble failing remove said illegal content,-0.7351,-0.7351,0.2486581132,-0.983758113,Negative Impact
02/02/2024,169.19,172.50,167.33,171.81,171.81,117154900,5.66,38.78057437,1.192,0,27.30545211,0.4577403224,0.2071825716,5.33,310.326,15628.9502,17101.9707,7615.5,7592.259766,2730.1521,72085.63281,21085.09961,151.5601996,133.9535003,151.535351,136.1988184,155.7019989,166.3345977,145.0694001,73.71036816,3.464671456,2.52042191,0.9442495458,3.831427438,154.5211762,11216775300,96.94553983,73.65753258,13.85000038,Amazon warns climate change could disrupt its business in annual filing,Amazon is telling investors that the climate crisis could start having a material impact on its business.,https://www.cnbc.com/2024/02/02/amazon-warns-climate-change-could-disrupt-its-business-in-sec-filing.html,cnbc.com,9,amazon telling investor climate crisis could start material impact business,-0.5267,-0.47403,0.32285,-0.79688,Negative Impact
05/02/2024,170.2,170.55,167.70,170.31,170.31,55081300,5.66,38.78057437,1.192,0,27.30545211,0.4577403224,0.2071825716,5.33,310.326,15597.67969,17004.7793,7612.899902,7589.959961,2702.185059,71731.42188,20871.90039,152.0883997,134.2835503,152.2716117,136.5382331,156.9554985,168.2832738,145.6277232,73.62910482,4.100271873,2.836391903,1.26387997,3.922140939,155.6199951,11161694000,90.30543251,88.84113462,13.67000008,"Turkey's new central bank governor, formerly at Amazon and New York Fed, seen as a 'credible choice'","With Turkey's inflation at 65%, the 42-year-old economist has his work cut out for him.",https://www.cnbc.com/2024/02/05/turkeys-new-central-bank-governor-seen-as-a-credible-choice.html,cnbc.com,9,turkey inflation yearold economist work cut,-0.2732,-0.24588,0.3763385,-0.6222185,Negative Impact
06/02/2024,169.39,170.71,167.65,169.15,169.15,42505500,5.66,38.78057437,1.192,0,27.30545211,0.4577403224,0.2071825716,5.33,310.326,15609,17135.48047,7681,7638.970215,2789.486084,72186.09375,20957.69922,152.5371994,134.6102503,152.933509,136.8627282,157.9579979,169.8912305,146.0247652,74.22221469,4.458986758,3.160910874,1.298075884,3.908570426,157.9831958,11119188500,83.80073844,90.35057026,13.06000042,The U.S. Banned Xinjiang Tomatoes Over Uyghur Forced Labor Fears. Amazon And Walmart Still Sell Them,"American shoppers at Amazon, Walmart, Etsy and grocery delivery apps Instacart and Uber Eats may have unwittingly bought canned tomatoes and pastes produced by Uyghur forced laborers in China's far west region of Xinjiang, which are banned by the U.S. government, according to a Forbes review of product listings.",https://www.forbes.com/sites/iainmartin/2024/02/06/xinjiang-tomatoes-uyghur-forced-labor-amazon-walmart/,forbes.com,8,american shopper amazon walmart etsy grocery delivery apps instacart uber eats may unwittingly bought canned tomato paste produced uyghur forced laborer china far west region xinjiang banned u government according forbes review product listing,-0.6486,-0.51888,0.2122009091,-0.731080909,Negative Impact
07/02/2024,169.48,170.88,168.94,170.53,170.53,47174100,5.66,38.78057437,1.192,0,27.30545211,0.4577403224,0.2071825716,5.33,310.326,15756.63965,17212.32031,7628.799805,7611.259766,2829.696045,72152,20969.19922,153.0129993,134.9281003,153.6235675,137.1977259,158.9159981,171.6704222,146.161574,73.92526065,4.79930238,3.488589175,1.310713205,3.899285453,160.0155484,11166362600,90.03035542,88.04550879,12.82999992,Analysts jumped on this stock ahead of earnings; markets love it,"Analysts on Wall Street talk to each other about where a stock should or could head shortly, especially when earnings season starts, as their reputations often hang on the power of their predictions and projections for a stock's valuation. Today, most of Wall Street's biggest names have cornered one real estate stock.",https://www.marketbeat.com/originals/analysts-jumped-on-this-stock-ahead-of-earnings-markets-love-it/?utm_source=snapi,marketbeat.com,5,analyst wall street talk stock could head shortly especially earnings season start reputation often hang power prediction projection stock valuation today wall street biggest name cornered one real estate stock,-0.2732,-0.1366,0.2919528571,-0.428552857,Negative Impact
08/02/2024,169.65,171.43,168.88,169.84,169.84,42316500,5.66,38.78057437,1.192,0,27.30545211,0.4577403224,0.2071825716,5.33,310.326,15793.70996,17252.32031,7595.5,7665.629883,2865.903076,71428.42969,20919.59961,153.4551993,135.2462503,154.2595058,137.5225246,159.7214981,173.1156865,146.3273097,71.05110188,4.956195593,3.782110459,1.174085135,3.865713937,161.7633716,11124046100,85.69890974,86.5100012,12.78999996,Amazon's Global Head of Corporate Risk to Speak at 2024 Bermuda Risk Summit,"HAMILTON, Bermuda--(BUSINESS WIRE)--Soraya Wright, Global Head of Corporate Risk & Claims at Amazon, will close the second day of the 2024 Bermuda Risk Summit, presented by the Bermuda Business Development Agency (BDA), in partnership with the Association of Bermuda Insurers and Reinsurers (ABIR) and EY. Ms. Wright has over 30 years of experience managing complex risks of global companies and currently serves as Global Head of Corporate Risk & Claims at tech giant, Amazon, and also serv.",https://www.businesswire.com/news/home/20240208851367/en/Amazon%E2%80%99s-Global-Head-of-Corporate-Risk-to-Speak-at-2024-Bermuda-Risk-Summit/,businesswire.com,5,hamilton bermudabusiness wiresoraya wright global head corporate risk claim amazon close second day bermuda risk summit presented bermuda business development agency bda partnership association bermuda insurer reinsurers abir ey m wright year experience managing complex risk global company currently serf global head corporate risk claim tech giant amazon also serv,-0.6124,-0.3062,0.2763868421,-0.582586842,Negative Impact
09/02/2024,170.9,175.00,170.58,174.45,174.45,56986000,5.66,38.78057437,1.192,0,27.30545211,0.4577403224,0.2071825716,5.33,310.326,15990.66016,17275.86914,7572.600098,7647.52002,2865.903076,71595.49219,21009.59961,154.0035992,135.6056503,155.0512898,137.8899622,160.6849983,175.4098938,145.9601028,75.55208543,5.390386102,4.103765587,1.286620515,4.009284973,163.2664996,11181032100,97.38963996,91.03963504,12.93000031,"Amazon steers consumers to higher-priced items, lawsuit claims",Amazon.com was sued in a proposed U.S. class action accusing the online retailer of violating a consumer protection law by steering hundreds of millions of shoppers to higher-priced items in order to earn extra fees.,https://www.reuters.com/technology/amazon-steers-consumers-higher-priced-items-lawsuit-claims-2024-02-09/,reuters.com,10,amazoncom sued proposed u class action accusing online retailer violating consumer protection law steering hundred million shopper higherpriced item order earn extra fee,-0.6369,-0.6369,0.1801253333,-0.817025333,Negative Impact
12/02/2024,174.8,175.39,171.54,172.34,172.34,51050400,5.66,38.78057437,1.192,0,27.30545211,0.4577403224,0.2071825716,5.33,310.326,15942.5498,17332.46094,7573.700195,7689.799805,2865.903076,71072.49219,21067.30078,154.523999,135.9424502,155.7292783,138.2327486,161.5709984,176.8801762,146.2618206,70.73169692,5.500815812,4.383175632,1.11764018,4.121427264,165.1438597,11129981700,85.36466609,89.48440526,13.93000031,AI frenzy puts Nvidia ahead of Amazon in market value,"Nvidia surpassed Amazon.com Inc in market capitalization on Monday, as the euphoria around artificial intelligence catapulted the chipmaker to the fourth most valuable U.S. company.",https://www.reuters.com/technology/ai-frenzy-puts-nvidia-ahead-amazon-market-value-2024-02-12/,reuters.com,10,nvidia surpassed amazoncom inc market capitalization monday euphoria around artificial intelligence catapulted chipmaker fourth valuable u company,0.8885,0.8885,0.2988409091,0.5896590909,Positive Impact
13/02/2024,167.73,170.95,165.75,168.64,168.64,56345100,5.66,38.78057437,1.192,0,27.30545211,0.4577403224,0.2071825716,5.33,310.326,15655.59961,17068.53906,7512.299805,7625.310059,2865.903076,71555.1875,20585,154.9749991,136.2365502,156.2355811,138.5353083,162.3449982,177.427273,147.2627233,63.94219664,5.229491005,4.552438707,0.6770522979,4.414284842,175.3899994,11073636600,67.61035899,83.45488835,15.85000038,Jeff Bezos Sells Amazon Shares Worth Over $2 Billion,"Jeff Bezos has sold a stake valued at $2.08 billion in Amazon, according to a U.S. Securities and Exchange Commission filing.",https://www.wsj.com/articles/jeff-bezos-sells-amazon-shares-worth-over-2-billion-d8a5216b,wsj.com,9,jeff bezos sold stake valued billion amazon according u security exchange commission filing,0.7184,0.64656,0.1626856522,0.4838743478,Positive Impact
14/02/2024,169.21,171.21,168.28,170.98,170.98,42815500,5.66,38.78057437,1.192,0,27.30545211,0.4577403224,0.2071825716,5.33,310.326,15859.15039,17240.18945,7568.399902,7677.350098,2865.903076,71822.82813,20889.40039,155.453999,136.5642002,156.8137934,138.858141,163.3084976,177.9868013,148.630194,65.14769439,5.143985624,4.67074809,0.4732375337,4.340714591,175.3899994,11116452100,78.57141268,77.18214592,14.38000011,Nvidia Stock Gains. Why It Can Cement Its Lead Over Amazon.,Nvidia was rising early on Wednesday as the technology sector looks to recover from the shock of a higher-than-expected inflation reading. The chip maker was set to cement its newfound lead over Amazon.com in terms of market capitalization.,https://www.barrons.com/articles/nvidia-stock-price-buy-sell-cd86f6e2,barrons.com,9,nvidia rising early wednesday technology sector look recover shock higherthanexpected inflation reading chip maker set cement newfound lead amazoncom term market capitalization,-0.3818,-0.34362,0.2340494737,-0.577669474,Negative Impact
15/02/2024,170.58,171.17,167.59,169.80,169.80,49855200,5.66,38.78057437,1.192,0,27.30545211,0.4577403224,0.2071825716,5.33,310.326,15906.16992,17434.92969,7597.5,7743.419922,2865.903076,72050.38281,21222.69922,155.9531992,136.9029502,157.3230565,139.1660202,164.1234978,178.3105812,149.9364143,62.28151907,4.92424284,4.72144704,0.2027957999,4.384286063,175.1971994,11066596900,72.83772672,73.00649947,14.01000023,Shocking parallels between S&P 500 and 1929 stock market crash,"Although stocks surged during February 2021 amidst the meme-stock craze, the index suffered an 8.4% slump in February 2020 as the COVID-19 pandemic disrupted the global economy.",https://finbold.com/shocking-parallels-between-sp-500-and-1929-stock-market-crash/?utm_source=snapi,finbold.com,5,although stock surged february amidst memestock craze index suffered slump february covid pandemic disrupted global economy,-0.5859,-0.29295,0.3090136364,-0.601963636,Negative Impact
16/02/2024,168.74,170.42,167.17,169.51,169.51,48074600,5.66,38.78057437,1.192,0,27.30545211,0.4577403224,0.2071825716,5.33,310.326,15775.65039,17409.30078,7711.700195,7768.180176,2865.903076,72426.64063,21255.59961,156.405799,137.2323502,157.8009757,139.4679503,164.8319977,178.5806693,151.0833261,59.90871851,4.672828378,4.711723308,-0.03889493,4.445714678,175.0082554,11018522300,71.42855024,74.27922988,14.23999977,Amazon joins companies arguing US labor board is unconstitutional,"Amazon.com has joined rocket maker SpaceX and grocery chain Trader Joe's in claiming that a U.S. labor agency's in-house enforcement proceedings violate the U.S. Constitution, as the retail giant faces scores of cases claiming it interfered with workers' rights to organize.",https://www.reuters.com/technology/amazon-joins-companies-arguing-us-labor-board-is-unconstitutional-2024-02-16/,reuters.com,10,amazoncom joined rocket maker spacex grocery chain trader joes claiming u labor agency inhouse enforcement proceeding violate u constitution retail giant face score case claiming interfered worker right organize,-0.4939,-0.4939,0.2514995,-0.7453995,Negative Impact
20/02/2024,167.83,168.71,165.74,167.08,167.08,41980300,5.66,38.78057437,1.192,0,27.30545211,0.4577403224,0.2071825716,5.33,310.326,15630.78027,17340.16992,7719.200195,7795.220215,2922.72998,73057.39844,21217.5,156.8569989,137.5495002,158.1648591,139.7426971,165.4469978,178.3785561,152.5154396,59.66507325,4.228754061,4.615129458,-0.386375398,4.483571734,174.8230903,10976542000,59.62100671,67.96242789,15.42000008,Amazon set to join Dow Jones Index,"Amazon is set to join the Dow Jones Industrial Average, replacing Walgreens Boots Alliance effective Feb. 26, S&P Dow Jones Indices said on Tuesday.",https://www.reuters.com/business/retail-consumer/amazon-set-join-dow-jones-index-2024-02-20/,reuters.com,10,amazon set join dow jones industrial average replacing walgreens boot alliance effective feb sp dow jones index said tuesday,0.7184,0.7184,0.1940731818,0.5243268182,Positive Impact
21/02/2024,168.94,170.23,167.14,168.59,168.59,44575600,5.66,38.78057437,1.192,0,27.30545211,0.4577403224,0.2071825716,5.33,310.326,15580.87012,17382.67969,7662.5,7812.089844,2950.956055,72623.09375,21172.40039,157.2911987,137.8724502,158.573688,140.0297349,166.0754974,178.2792906,153.8717043,66.94507878,3.953097059,4.482722979,-0.529625919,4.408571516,174.4597669,11021117600,65.60444319,65.55133338,15.34000015,The AI boom of today and the telecom bubble of 1990s share these similarities,"The stock market can be fickle, and it doesn't always reward the pioneers of a new technology over the long term.",https://www.marketwatch.com/story/the-ai-boom-of-today-and-the-telecom-bubble-of-1990s-share-these-similarities-0aa3a40e,marketwatch.com,8,stock market fickle doesnt always reward pioneer new technology long term,-0.4585,-0.3668,0.3297857692,-0.696585769,Negative Impact
22/02/2024,173.1,174.80,171.77,174.58,174.58,55392400,5.66,38.78057437,1.192,0,27.30545211,0.4577403224,0.2071825716,5.33,310.326,16041.62012,17565.07031,7684.5,7911.600098,2988.35791,73158.24219,21318.09961,157.8343988,138.2170502,159.2013866,140.3735187,166.9609978,178.9199873,155.0020082,68.46934298,4.169912131,4.420160809,-0.250248678,4.526429313,165.7400055,11076510000,91.60623761,72.27722917,14.53999996,My Dividend Growth Income: January 2024 Update,I experienced a slowdown in new invested capital due to life changes recently and suffered from some unfortunate dividend announcements in my portfolio.,https://seekingalpha.com/article/4672289-my-dividend-growth-income-january-2024-update,seekingalpha.com,6,experienced slowdown new invested capital due life change recently suffered unfortunate dividend announcement portfolio,-0.7351,-0.44106,0.3025822222,-0.743642222,Negative Impact
23/02/2024,174.28,175.75,173.70,174.99,174.99,59715200,5.66,38.78057437,1.192,0,27.30545211,0.4577403224,0.2071825716,5.33,310.326,15996.82031,17616.01953,7706.299805,7966.680176,3004.881104,73142.79688,21413.19922,158.4163989,138.5628502,159.8205481,140.7179613,167.822998,179.4676887,156.1783074,55.42663414,4.324967968,4.401122241,-0.076154273,3.728572301,165.9212054,11136225200,92.40764312,83.20610797,13.75,Amazon to pay $1.9 million to migrant contract workers to settle claims of human rights abuses,A report from Amnesty International and a separate investigation last year alleged abuses at Amazon warehouses in Saudi Arabia.,https://www.cnbc.com/2024/02/23/amazon-to-pay-1point9-million-in-contract-worker-exploitation-settlement.html,cnbc.com,9,report amnesty international separate investigation last year alleged abuse amazon warehouse saudi arabia,-0.5423,-0.48807,0.2471833333,-0.735253333,Negative Impact
26/02/2024,175.7,176.37,174.26,174.73,174.73,44368600,5.66,38.78057437,1.192,0,27.30545211,0.4577403224,0.2071825716,5.33,310.326,15976.25,17566.60938,7684.299805,7929.819824,2977.021973,72790.13281,21324.30078,158.9613989,138.9034002,160.4052323,141.0563895,168.6034981,179.8787635,157.3282327,57.87597318,4.376421558,4.396182104,-0.019760547,3.585715158,166.3143572,11091856600,84.57195682,89.52861251,13.73999977,"Jeff Bezos, Jamie Dimon, and Mark Zuckerberg have sold stock worth about $9 billion. They might think markets can't go much higher.","Jeff Bezos, Jamie Dimon, and Mark Zuckerberg have all been selling shares in their companies. The Amazon founder and JPMorgan and Meta CEOs risk sending a worrying message to markets.",https://www.businessinsider.com/bezos-dimon-zuckerberg-amazon-jpmorgan-meta-stock-sales-billionaires-wealth-2024-2,businessinsider.com,7,jeff bezos jamie dimon mark zuckerberg selling share company amazon founder jpmorgan meta ceo risk sending worrying message market,-0.1531,-0.10717,0.296281875,-0.403451875,Negative Impact
27/02/2024,174.08,174.62,172.86,173.54,173.54,31141700,5.66,38.78057437,1.192,0,27.30545211,0.4577403224,0.2071825716,5.33,310.326,16035.2998,17598.32031,7683,7948.399902,3015.480957,73095.21875,21318.90039,159.4553989,139.2201501,160.920321,141.3796095,169.217498,180.1409365,158.2940595,57.81416443,4.271931479,4.371331979,-0.0994005,3.500713893,166.9176955,11060714900,73.37719103,83.45226365,13.43000031,Road House' screenwriter sues Amazon to block movie remake,"Writer Lance Hill sued Amazon.com on Tuesday to halt its upcoming remake of the 1989 film ""Road House,"" arguing that the film violates his rights in the original's screenplay.",https://www.reuters.com/legal/road-house-screenwriter-sues-amazon-block-movie-remake-2024-02-27/,reuters.com,10,writer lance hill sued amazoncom tuesday halt upcoming remake film road house arguing film violates right original screenplay,-0.6124,-0.6124,0.07803,-0.69043,Negative Impact
28/02/2024,172.44,174.05,172.27,173.16,173.16,28180500,5.66,38.78057437,1.192,0,27.30545211,0.4577403224,0.2071825716,5.33,310.326,15947.74023,17573.68945,7625,7954.390137,2957.852051,72304.88281,21243.80078,159.970199,139.5250501,161.4003085,141.6958323,169.9254982,179.8504584,160.000538,54.85419941,4.111070491,4.319279682,-0.208209191,3.48928506,167.4848335,11032534400,69.80249682,75.91721489,13.84000015,Wall Street Bulls Look Optimistic About Amazon (AMZN): Should You Buy?,"Investors often turn to recommendations made by Wall Street analysts before making a Buy, Sell, or Hold decision about a stock. While media reports about rating changes by these brokerage-firm employed (or sell-side) analysts often affect a stock's price, do they really matter?",https://www.zacks.com/stock/news/2233169/wall-street-bulls-look-optimistic-about-amazon-amzn-should-you-buy?cid=CS-STOCKNEWSAPI-FT-fundamental_analysis|average_broker_rating-2233169,zacks.com,8,investor often turn recommendation made wall street analyst making buy sell hold decision stock medium report rating change brokeragefirm employed sellside analyst often affect stock price really matter,0.101,0.0808,0.3497827273,-0.268982727,Negative Impact
29/02/2024,173.01,177.22,172.85,176.76,176.76,53805400,5.66,38.78057437,1.192,0,27.30545211,0.4577403224,0.2071825716,5.33,310.326,16091.91992,17607.42969,7630,7927.430176,3015.170898,72500.29688,21363.59961,160.5059988,139.8575501,162.0026492,142.0447294,171.0034981,178.6058003,163.4011959,61.53333615,4.225368753,4.300497496,-0.075128743,3.619285583,168.0179432,11086339800,95.99297138,79.72421974,13.39999962,Raging fires in northern Amazon state threaten Brazil's Yanomami people,"Brazil's northernmost state of Roraima is suffering a sharp spike in wildfires, threatening the crisis-wracked Yanomami Indigenous people and reigniting fears of catastrophe in the Amazon rainforest after months of improved deforestation data.",https://www.reuters.com/world/americas/raging-fires-northern-amazon-state-threaten-brazils-yanomami-people-2024-02-29/,reuters.com,10,brazil northernmost state roraima suffering sharp spike wildfire threatening crisiswracked yanomami indigenous people reigniting fear catastrophe amazon rainforest month improved deforestation data,-0.8834,-0.8834,0.1152707143,-0.998670714,Negative Impact
01/03/2024,176.75,178.73,176.07,178.22,178.22,31956200,5.66,38.78057437,1.192,0,27.30545211,0.4577403224,0.2071825716,5.33,312.332,16274.94043,17728.26953,7682.5,7934.169922,3027.02002,73745.35156,21552.40039,160.9889987,140.1926501,162.6386237,142.4046824,171.9504982,177.9544888,165.9465076,57.02049452,4.383234094,4.317044816,0.06618927885,3.440713065,168.7541078,11118296000,96.07394234,87.28980351,13.10999966,2 Artificial Intelligence (AI) Stocks That Could Go Parabolic,"The AI market is projected to hit a valuation close to $2 trillion by 2030. Meanwhile, AMD is moving to steal market share from Nvidia in AI chips and lead in AI-powered PCs.",https://www.fool.com/investing/2024/03/01/2-artificial-intelligence-ai-stocks-that-could-go/,fool.com,7,ai market projected hit valuation close trillion meanwhile amd moving steal market share nvidia ai chip lead aipowered pc,-0.25,-0.175,0.284766875,-0.459766875,Negative Impact
04/03/2024,177.53,180.14,177.49,177.58,177.58,37381500,5.66,38.78057437,1.192,0,27.30545211,0.4577403224,0.2071825716,5.33,312.332,16207.50977,17748.69922,7640.299805,7956.410156,3039.305908,73872.28906,21531.09961,161.4647989,140.5135501,163.2245601,142.7546856,172.2389984,178.7478501,165.7301467,60.32310409,4.405912299,4.334818312,0.07109398648,3.354997907,169.7516966,11080914500,82.22223164,91.42971512,13.48999977,2024 Refresh: 3 Stocks With New Potential After Layoffs News,"Layoffs are, without a doubt, no fun. Massive rounds of layoffs in companies create significant stress and anxiety, and can be expensive to implement with severance costs and payouts that accompany such moves.",https://investorplace.com/2024/03/2024-refresh-3-stocks-with-new-potential-after-layoffs-news/,investorplace.com,6,layoff without doubt fun massive round layoff company create significant stress anxiety expensive implement severance cost payouts accompany move,-0.2942,-0.17652,0.3291958824,-0.505715882,Negative Impact
05/03/2024,176.93,176.93,173.30,174.12,174.12,37228300,5.66,38.78057437,1.192,0,27.30545211,0.4577403224,0.2071825716,5.33,312.332,15939.58984,17669.49023,7646.200195,7932.819824,3047.792969,73677.13281,21525.90039,161.9047989,140.8066501,163.6518321,143.0667782,172.4294983,178.9236376,165.935359,60.89895756,4.097458364,4.287346323,-0.189887958,3.189998082,170.9982929,11043686200,58.19439706,78.83019034,14.46000004,"Dell Just Gave Nvidia and AMD Investors Something to Cheer -- and Amazon, Microsoft, and Google Investors Something to Perhaps Fear","Dell COO Jeff Clark recently said that the demand for Nvidia's and AMD's GPUs continues to soar. He also made a prediction that was bad news for Amazon, Microsoft, and Google parent Alphabet.",https://www.fool.com/investing/2024/03/05/dell-nvidia-amd-amazon-microsoft-google-investors/,fool.com,7,dell coo jeff clark recently said demand nvidias amd gpus continues soar also made prediction bad news amazon microsoft google parent alphabet,-0.5106,-0.35742,0.2785408333,-0.635960833,Negative Impact
06/03/2024,175.54,176.46,173.26,173.51,173.51,32090900,5.66,38.78057437,1.192,0,27.30545211,0.4577403224,0.2071825716,5.33,312.332,16031.54004,17801.03906,7679.299805,7954.740234,3039.930908,74085.99219,21594,162.2981989,141.0834501,164.0384267,143.3696958,172.6474983,178.9685177,166.326479,55.40367019,3.760436477,4.181964353,-0.421527877,3.209284101,172.0952977,11011595300,53.95827991,64.7916362,14.5,"Jason and Travis Kelce's ÃÂÃÂNew Heights' podcast could be in line for $100 million deal, expert says","Pro Bowl offensive lineman Jason Kelce retired from the NFL on Monday after 13 seasons with the Philadelphia Eagles, but he will continue his burgeoning career as a podcaster.",https://www.marketwatch.com/story/why-jason-and-travis-kelce-could-be-the-next-100-million-podcasters-91400853,marketwatch.com,8,pro bowl offensive lineman jason kelce retired nfl monday season philadelphia eagle continue burgeoning career podcaster,-0.4588,-0.36704,0.2218514286,-0.588891429,Negative Impact
07/03/2024,174.83,177.99,173.72,176.82,176.82,34063300,5.66,38.78057437,1.192,0,27.30545211,0.4577403224,0.2071825716,5.33,312.332,16273.37988,17927.61914,7692.5,8016.220215,3027.400879,74119.39063,21794.59961,162.766199,141.3863001,164.5396652,143.7025347,172.9619987,179.4627748,166.4612227,63.74314356,3.717580619,4.089087607,-0.371506988,3.273570469,173.0606619,11045658600,76.94448977,63.03238891,14.43999958,Do These 2 Stocks Belong in the Magnificent 7?,"The so-called ÃÂÃÂMagnificent 7' group, consisting of Apple AAPL, Meta Platforms META, Alphabet GOOGL, Microsoft MSFT, Tesla TSLA, NVIDIA NVDA, and Amazon AMZN, has been a dominant story within the market for some time, performing remarkably and providing stellar gains.",https://www.zacks.com/commentary/2237587/do-these-2-stocks-belong-in-the-magnificent-7?cid=CS-STOCKNEWSAPI-FT-investment_ideas-2237587,zacks.com,8,socalled magnificent group consisting apple aapl meta platform meta alphabet googl microsoft msft tesla tsla nvidia nvda amazon amzn dominant story within market time performing remarkably providing stellar gain,0.8505,0.6804,0.310995,0.369405,Positive Impact
08/03/2024,176.44,178.79,174.33,175.35,175.35,37853500,5.66,38.78057437,1.192,0,27.30545211,0.4577403224,0.2071825716,5.33,312.332,16085.11035,17889.61914,7659.700195,8028.009766,3046.019043,74119.39063,21737.5,163.2049991,141.6880001,164.9636001,144.0174349,173.2374992,179.6475751,166.8274234,60.92815867,3.524373446,3.976144774,-0.451771328,3.359998431,173.2599945,11007805100,66.73614364,65.87963777,14.73999977,"Microsoft destroys rival cloud firms' profit margins, Amazon-backed group alleges","Between 2018 and 2023, one cloud firm saw revenues from selling Microsoft products climb over 300% ÃÂÃÂ but profit margins plunged, according to a complaint.",https://www.cnbc.com/2024/03/08/microsoft-accused-by-rivals-of-squeezing-cloud-firms-profit-margins.html,cnbc.com,9,one cloud firm saw revenue selling microsoft product climb profit margin plunged according complaint,0.1779,0.16011,0.4528133333,-0.292703333,Negative Impact
11/03/2024,174.31,174.47,171.47,171.96,171.96,28484800,5.66,38.78057437,1.192,0,27.30545211,0.4577403224,0.2071825716,5.33,312.332,16019.26953,17863.68945,7669.200195,8019.72998,3068.455078,73502.64063,21769.19922,163.5773993,141.9728502,165.237969,144.2954704,173.1129997,179.520642,166.7053575,58.81503034,3.062409204,3.79339766,-0.730988457,3.367856707,180.1399994,10979320300,37.07697942,60.25253761,15.22000027,"AI craze stokes ÃÂÃÂbubble within a bubble,' says GMO's Jeremy Grantham","The U.S. stocks appear expensive after investor mania surrounding artificial-intelligence interrupted the bursting of an initial market bubble that was deflating in 2022, according to GMO's Jeremy Grantham.",https://www.marketwatch.com/story/ai-craze-stokes-bubble-within-a-bubble-says-gmos-jeremy-grantham-24404ef9,marketwatch.com,8,u stock appear expensive investor mania surrounding artificialintelligence interrupted bursting initial market bubble deflating according gmos jeremy grantham,-0.296,-0.2368,0.200702,-0.437502,Negative Impact
12/03/2024,173.5,176.76,171.98,175.39,175.39,36610600,5.66,38.78057437,1.192,0,27.30545211,0.4577403224,0.2071825716,5.33,312.332,16265.63965,17974.06055,7747.799805,8087.47998,3055.935059,73667.96094,21831,164.0175992,142.2660501,165.6360878,144.6048687,173.2654999,179.7405044,166.7904954,61.48648335,2.939189806,3.622556089,-0.683366283,3.485713414,179.9665994,11015930900,45.2133679,49.67549698,13.84000015,Amazon UK staff announce strikes in Birmingham and Coventry,"Workers at Amazon.com Inc (NASDAQ:AMZN, ETR:AMZ)'s Coventry and Birmingham-based fulfilment centres will down tools in the coming weeks in the latest round of strikes to hit the e-commerce giant's UK operations. Strike action will take place in Coventry on March 19-20 and 27 in Birmingham on March 27-28.",https://www.proactiveinvestors.co.uk/companies/news/1042953?SNAPI,proactiveinvestors.co.uk,5,worker amazoncom inc nasdaqamzn etramzs coventry birminghambased fulfilment centre tool coming week latest round strike hit ecommerce giant uk operation strike action take place coventry march birmingham march,-0.25,-0.125,0.37647,-0.50147,Negative Impact
13/03/2024,175.9,177.62,175.55,176.56,176.56,30772600,5.66,38.78057437,1.192,0,27.30545211,0.4577403224,0.2071825716,5.33,312.332,16177.76953,18018.63086,7772.200195,8137.580078,3043.834961,72761.89063,21970.09961,164.5099991,142.5738501,166.0644764,144.9228302,173.6614998,179.9101904,167.4128092,53.9951465,2.902488539,3.478542579,-0.576054041,3.201426915,179.7966675,11046703500,58.70815932,46.99950221,13.75,Dave Ramsey Has A Warning About Amazon Shopping,"Many consumers have short-term memory loss when the economy is thriving. Rather than saving and preparing for a time when it isn't so great, they make big purchases they can't afford.",https://247wallst.com/retail/2024/03/13/dave-ramsey-has-a-warning-about-amazon-shopping/,247wallst.com,5,many consumer shortterm memory loss economy thriving rather saving preparing time isnt great make big purchase cant afford,-0.6802,-0.3401,0.2694004348,-0.609500435,Negative Impact
14/03/2024,177.69,179.53,176.47,178.75,178.75,43705800,5.66,38.78057437,1.192,0,27.30545211,0.4577403224,0.2071825716,5.33,312.332,16128.53027,17886.26953,7743.200195,8161.419922,3038.233887,73097.28125,21829.90039,165.0863992,142.8670501,166.561948,145.259419,174.05,180.5575318,167.5424682,57.0782995,3.015358241,3.385905712,-0.37054747,3.27356938,179.6301341,11090409300,83.96770838,62.6297452,14.39999962,"Refund fraud schemes promoted on TikTok, Telegram are costing Amazon and other retailers billions of dollars","Amazon suffered more than $700,000 in losses at the hands of one refund fraud ring indicted last year, according to court documents.",https://www.cnbc.com/2024/03/14/amazon-and-other-retailers-hit-by-refund-fraud-costing-them-billions.html,cnbc.com,9,amazon suffered loss hand one refund fraud ring indicted last year according court document,-0.6597,-0.59373,0.194867,-0.788597,Negative Impact
15/03/2024,176.64,177.93,173.90,174.42,174.42,72115500,5.66,38.78057437,1.192,0,27.30545211,0.4577403224,0.2071825716,5.33,312.332,15973.16992,17848.08008,7727.399902,8164.350098,3054.635986,72643.42969,21849.19922,165.6053992,143.1308501,166.8701068,145.549574,174.2809998,180.473696,168.0883035,49.49396424,2.724012612,3.253527092,-0.52951448,3.469284058,179.5299988,11018293800,34.02534684,58.90040485,14.40999985,Retail's hidden champion: The stock that's beating the odds and making investors rich,"The global pandemic has profoundly reshaped the retail stock market. Due to movement restrictions and safety measures, customers avoided going to stores and turned to e-commerce instead.",https://finbold.com/retail-stock-thats-beating-the-odds-and-making-investors-rich/?utm_source=snapi,finbold.com,5,global pandemic profoundly reshaped retail stock market due movement restriction safety measure customer avoided going store turned ecommerce instead,-0.1779,-0.08895,0.3275875,-0.4165375,Negative Impact
18/03/2024,175.8,176.69,174.28,174.48,174.48,31250700,5.66,38.78057437,1.192,0,27.30545211,0.4577403224,0.2071825716,5.33,312.332,16103.4502,17882.31055,7722.600098,8148.140137,3084.926025,72748.42188,21837.19922,166.2035989,143.4003501,167.1685338,145.8374389,174.5294998,180.3006099,168.7583898,51.59322448,2.469493618,3.096720397,-0.627226779,3.507856097,179.5299988,11049544500,34.71736035,50.90347186,14.32999992,"Forget Nvidia: Billionaires Are Selling It and Buying This ""Magnificent Seven"" Stock Instead","The Magnificent Seven -- Microsoft, Apple, Nvidia, Amazon, Alphabet, Meta Platforms, and Tesla -- are largely responsible for the current bull market rally. More than a half-dozen highly successful billionaire asset managers sold shares of AI juggernaut Nvidia during the fourth quarter.",https://www.fool.com/investing/2024/03/18/forget-nvidia-billionaire-sell-buy-mag-seven-stock/,fool.com,7,magnificent seven microsoft apple nvidia amazon alphabet meta platform tesla largely responsible current bull market rally halfdozen highly successful billionaire asset manager sold share ai juggernaut nvidia fourth quarter,0.9428,0.65996,0.3532325,0.3067275,Positive Impact
19/03/2024,174.22,176.09,173.52,175.90,175.90,26880900,5.66,38.78057437,1.192,0,27.30545211,0.4577403224,0.2071825716,5.33,312.332,16166.79004,17975.78906,7738.299805,8201.049805,3062.756104,72012.04688,21860.59961,166.8167987,143.6660001,167.510944,146.1365688,174.9704994,179.574748,170.3662508,54.48590286,2.355217979,2.948419913,-0.593201934,3.564284188,179.3687988,11076425400,51.09565872,39.94612197,13.81999969,"After Surviving Amazon's Galen, Why Allbirds Stock Is Still Overpriced","Since peaking at $26 a share in November 2021, San Francisco-based shoe and apparel retailer Allbirds has suffered a 97% drop in its stock price.",https://www.forbes.com/sites/petercohan/2024/03/19/after-surviving-amazons-galen-why-allbirds-stock-is-still-overpriced/,forbes.com,8,since peaking share november san franciscobased shoe apparel retailer allbirds suffered drop stock price,-0.4767,-0.38136,0.1590569231,-0.540416923,Negative Impact
20/03/2024,176.14,178.53,174.64,178.15,178.15,29947200,5.66,38.78057437,1.192,0,27.30545211,0.4577403224,0.2071825716,5.33,312.332,16369.41016,18130.08008,7737.399902,8161.410156,3079.686035,72101.6875,22045.69922,167.3977985,143.9355,167.9281616,146.4551103,175.4484993,179.16261,171.7343886,52.38094989,2.418332872,2.842402505,-0.424069633,3.529998779,179.2108229,11106372600,77.0472213,54.28674679,13.03999996,3 Tech Stocks Poised to Become the Market's Most Coveted Assets in 2024,"It's 2024, and it is impossible to talk about tech stocks without mentioning artificial intelligence (AI). Everyone has been talking about AI on earnings calls and we are hearing about an AI Act too.",https://investorplace.com/2024/03/3-tech-stocks-poised-to-become-the-markets-most-coveted-assets-in-2024/,investorplace.com,6,impossible talk tech stock without mentioning artificial intelligence ai everyone talking ai earnings call hearing ai act,-0.3724,-0.22344,0.2938007692,-0.517240769,Negative Impact
21/03/2024,179.99,181.42,178.15,178.15,178.15,32824300,5.66,38.78057437,1.192,0,27.30545211,0.4577403224,0.2071825716,5.33,312.332,16401.83984,18214.11914,7882.600098,8179.720215,3077.113037,72641.1875,22087.30078,167.9333984,144.19975,168.3290178,146.7704823,175.6269989,179.5048979,171.7490999,49.87376975,2.440222514,2.761966507,-0.321743993,3.573571341,171.4700012,11139196900,67.13562537,65.09283513,12.92000008,"Down By 2.6 Million Users, Amazon Could Keep Losing Customers To Temu","In the battle for U.S. retail shoppers, Amazon is aiming to fend off emerging e-commerce players ÃÂÃÂ such as Temu, according to the Wall Street Journal.",https://www.forbes.com/sites/petercohan/2024/03/21/down-by-26-million-users-amazon-could-keep-losing-customers-to-temu/,forbes.com,8,battle u retail shopper amazon aiming fend emerging ecommerce player temu according wall street journal,-0.2263,-0.18104,0.3575638462,-0.538603846,Negative Impact
22/03/2024,177.75,179.26,176.75,178.87,178.87,27964100,5.66,38.78057437,1.192,0,27.30545211,0.4577403224,0.2071825716,5.33,312.332,16428.82031,18112.03906,7930.899902,8151.919922,3048.033936,72831.9375,21984.09961,168.4361984,144.46105,168.7423895,147.0898804,175.8209984,179.945113,171.6968837,52.31929646,2.486999709,2.706973147,-0.219973438,3.563571385,171.6690012,11167161000,74.37182077,72.85155581,13.06000042,"Amazon.com, Inc. (AMZN) Hits Fresh High: Is There Still Room to Run?","Amazon.com (AMZN) is at a 52-week high, but can investors hope for more gains in the future? We take a look at the company's fundamentals for clues.",https://www.zacks.com/stock/news/2244714/amazon-com-inc-amzn-hits-fresh-high-is-there-still-room-to-run?cid=CS-STOCKNEWSAPI-FT-52_week_high-2244714,zacks.com,8,amazoncom amzn week high investor hope gain future take look company fundamental clue,0.743,0.5944,0.085607,0.508793,Positive Impact
25/03/2024,178.01,180.99,177.24,179.71,179.71,29815500,5.66,38.78057437,1.192,0,27.30545211,0.4577403224,0.2071825716,5.33,312.332,16384.4707,18077.15039,7917.600098,8151.600098,3026.305908,72831.9375,21942.30078,168.9267987,144.75345,169.1724921,147.4144588,176.0699989,180.506299,171.6336989,61.09568811,2.562316103,2.678041738,-0.115725635,3.525714329,171.8640211,11196976500,82.81415096,74.7738657,13.18999958,"Dow 40,000 Is Coming Any Day Now Thanks To 8 Stocks, Analysts Say","Dow Jones 40,000 is a milestone investors have eyed for years. But now a handful of stocks are posed to make it a reality.",https://www.investors.com/etfs-and-funds/sectors/dow-jones-40000-sp500-is-coming-any-day-now-thanks-stocks-analysts-say/,investors.com,5,dow jones milestone investor eyed year handful stock posed make reality,0,0,0.325898,-0.325898,Negative Impact
26/03/2024,180.15,180.45,177.95,178.30,178.30,29659000,5.66,38.78057437,1.192,0,27.30545211,0.4577403224,0.2071825716,5.33,312.332,16315.7002,18059.18945,7931,8184.75,3031.480957,72470.29688,21912.5,169.4003989,145.0237,169.5304337,147.7217777,176.3079994,180.6831134,171.9328854,59.21509181,2.479645567,2.638362504,-0.158716937,3.475713457,172.0551406,11167317500,68.64325554,75.27640909,13.23999977,"Amazon, FedEx & others face disruption after Baltimore bridge collapse","Amazon.com Inc (NASDAQ:AMZN, ETR:AMZ), FedEx Corp (NYSE:FDX, ETR:FDX), Under Armour and several other companies are expected to suffer disruption after a vital commuter bridge in Baltimore collapsed on Tuesday morning. Distribution warehouses and other facilities based at an industrial park at the north end of the Francis Scott Key Bridge are facing severe disruption, with regional traffic also gridlocked.",https://www.proactiveinvestors.com/companies/news/1044040?SNAPI,proactiveinvestors.com,5,amazoncom inc nasdaqamzn etramz fedex corp nysefdx etrfdx armour several company expected suffer disruption vital commuter bridge baltimore collapsed tuesday morning distribution warehouse facility based industrial park north end francis scott key bridge facing severe disruption regional traffic also gridlocked,-0.875,-0.4375,0.290670625,-0.728170625,Negative Impact
27/03/2024,179.88,180.00,177.31,179.83,179.83,33272600,5.66,38.78057437,1.192,0,27.30545211,0.4577403224,0.2071825716,5.33,312.332,16399.51953,18255.24023,7932,8204.80957,2993.138916,72996.3125,22107.09961,169.9337988,145.3057,169.9343383,148.0412625,176.6414993,181.0231089,172.2598898,56.21642642,2.508668319,2.612423667,-0.103755348,3.347855704,172.2424378,11200590100,84.02013241,78.49251297,12.77999973,EU's top court rejects Amazon's request to suspend EU tech rules' ad clause,The European Union's top court on Wednesday said it had rejected a request by Amazon to suspend its obligation to make an advertisement repository publicly available.,https://www.reuters.com/technology/eus-top-court-rejects-amazons-request-suspend-eu-tech-rules-ad-clause-2024-03-27/,reuters.com,10,european union top court wednesday said rejected request amazon suspend obligation make advertisement repository publicly available,-0.4767,-0.4767,0.2094476,-0.6861476,Negative Impact
28/03/2024,180.17,181.70,179.26,180.38,180.38,38051600,5.66,38.78057437,1.192,0,27.30545211,0.4577403224,0.2071825716,5.33,312.332,16379.45996,18312.66992,7952.600098,8205.80957,3010.664063,73651.35156,22167,170.5071988,145.57475,170.3439723,148.363041,176.8224998,181.5129166,172.1320831,60.79861944,2.546693017,2.599277537,-0.05258452,3.203570775,172.425989,11238641700,87.09684637,79.9200781,13.01000023,Intel files lawsuit to overturn European patent that threatens to block its exports to Germany,"Intel Corporation has filed a lawsuit in Milan seeking to overturn a European patent owned by small California microchip designer R2 Semiconductor that threatens to block the Silicon Valley giant from exporting vast swathes of its products to Germany, MarketWatch understands.",https://www.marketwatch.com/story/intel-files-lawsuit-to-overturn-european-patent-that-threatens-to-block-its-exports-to-germany-c116b38a,marketwatch.com,8,intel corporation filed lawsuit milan seeking overturn european patent owned small california microchip designer r semiconductor threatens block silicon valley giant exporting vast swathe product germany marketwatch understands,-0.7506,-0.60048,0.29648,-0.89696,Negative Impact
01/04/2024,180.79,183.00,179.95,180.97,180.97,29174500,5.66,38.78057437,1.192,0,27.30545211,0.4577403224,0.2071825716,5.33,313.548,16396.83008,18216.18945,7952.600098,8205.80957,3077.378906,74014.54688,22185.30078,171.0565988,145.8463,170.7606793,148.6874884,176.9599998,181.9730497,171.94695,71.9863155,2.594527539,2.598327537,-0.003799998,3.14428493,172.7969493,11267816200,81.57896559,84.23198145,13.64999962,Those high-flying stocks mean everything to Wall Street ÃÂÃÂ but not Main Street,It used to be that the stock market was a decent guide to the health of the U.S. economy. Those days are largely gone.,https://www.marketwatch.com/story/those-high-flying-stocks-mean-everything-to-wall-street-but-not-main-street-1d95045a,marketwatch.com,8,used stock market decent guide health u economy day largely gone,0,0,0.2950410526,-0.295041053,Negative Impact
02/04/2024,179.07,180.79,178.38,180.69,180.69,32611500,5.66,38.78057437,1.192,0,27.30545211,0.4577403224,0.2071825716,5.33,313.548,16240.4502,18107.5293,7935.100098,8130.049805,3074.958984,73903.90625,22075.09961,171.5635989,146.11765,171.1500646,149.0059213,177.1154999,182.3953641,171.8356357,65.2825822,2.580101378,2.594682305,-0.014580927,2.986428397,173.4091324,11235204700,75.63292616,81.43624604,14.60999966,Amazon offers free credits for startups to use AI models including Anthropic,"Amazon Web Service (AWS) has expanded its free credits program for startups to cover the costs of using major AI models, the company told Reuters in an interview, as it looks to boost the market share of its AI platform Bedrock.",https://www.reuters.com/technology/amazon-offers-free-credits-startups-use-ai-models-including-anthropic-2024-04-02/,reuters.com,10,amazon web service aws expanded free credit program startup cover cost using major ai model company told reuters interview look boost market share ai platform bedrock,0.8885,0.8885,0.3894611765,0.4990388235,Positive Impact
03/04/2024,179.9,182.87,179.80,182.41,182.41,31046600,5.66,38.78057437,1.192,0,27.30545211,0.4577403224,0.2071825716,5.33,313.548,16277.45996,18146.64063,7937.399902,8153.22998,3069.295898,73876.82031,22112.5,172.116199,146.39415,171.5916308,149.3383003,177.5300003,183.1126444,171.9473562,66.34991983,2.676604041,2.611066653,0.06553738819,3.046428135,173.9845844,11266251300,93.77640713,83.66276629,14.32999992,Amazon cuts hundreds of jobs in cloud computing unit,The cuts affect hundreds of staffers in AWS' store technology and sales and marketing units.,https://www.cnbc.com/2024/04/03/amazon-layoffs-hundreds-of-jobs-cut-in-cloud-computing-unit.html,cnbc.com,9,cut affect hundred staffer aws store technology sale marketing unit,-0.2732,-0.24588,0.2597496429,-0.505629643,Negative Impact
04/04/2024,184,185.10,180.00,180.00,180.00,41624300,5.66,38.78057437,1.192,0,27.30545211,0.4577403224,0.2071825716,5.33,313.548,16049.08008,17982.49023,7975.899902,8151.549805,3069.295898,74227.63281,22051.80078,172.595799,146.6667001,171.9213708,149.6433918,177.8545006,183.202841,172.5061601,53.45112895,2.529457925,2.594744907,-0.065286982,3.192143032,174.5255094,11224627000,55.95850348,75.12261226,16.35000038,"Thursday's analyst calls: Upside ahead for Amazon, but a 'rate trap' looms for BofA","Thursday's analyst calls: Upside ahead for Amazon, but a 'rate trap' looms for BofA",https://www.cnbc.com/2024/04/04/thursdays-analyst-calls-upside-ahead-for-amazon-but-a-rate-trap-looms-for-bofa.html,cnbc.com,9,thursday analyst call upside ahead amazon rate trap loom bofa,-0.3612,-0.32508,0.2582622727,-0.583342273,Negative Impact
05/04/2024,182.38,186.27,181.97,185.07,185.07,42335200,5.66,38.78057437,1.192,0,27.30545211,0.4577403224,0.2071825716,5.33,313.548,16248.51953,18122.25977,7911.200195,8061.310059,3069.295898,74248.21875,22264.40039,173.1597992,146.9631501,172.4370036,149.9958955,178.2670006,184.4818009,172.0522003,78.24932914,2.789791804,2.633754287,0.156037518,3.293571472,175.3714691,11266962200,90.58825923,80.10772328,16.03000069,The 3 Best Long-Term Stocks to Buy in April 2024,It's less stressful to buy reliable companies and hold onto them for many years than it is to trade stocks and strategically plan your entries and exits. Even the most reliable companies go through down cycles and you will have to remain patient during those stretches.,https://investorplace.com/2024/04/the-3-best-long-term-stocks-to-buy-in-april-2024/,investorplace.com,6,less stressful buy reliable company hold onto many year trade stock strategically plan entry exit even reliable company go cycle remain patient stretch,-0.4601,-0.27606,0.32879,-0.60485,Negative Impact
08/04/2024,186.9,187.29,184.81,185.19,185.19,39221300,5.66,38.78057437,1.192,0,27.30545211,0.4577403224,0.2071825716,5.33,313.548,16253.95996,18154.36914,7943.5,8119.299805,3047.052979,74742.5,22260.30078,173.7085992,147.2649501,172.9371212,150.3460856,178.7590004,185.5341966,171.9838042,78.3183395,2.971536855,2.7013108,0.2702260551,3.298570905,176.4613226,11306183500,84.74950966,77.09875746,15.18999958,"Amazon's total Washington state employment declines for the first time, new numbers show","Amazon's employment in Washington state, including warehouse and corporate workers, fell by 3,000 people to 87,000 employees between early 2023 and early 2024 ÃÂÃÂ its first recorded year-over-year employment decline in the state since the company was founded nearly 30 years ago in Jeff Bezos' Bellevue garage.",https://www.geekwire.com/2024/amazons-total-washington-state-employment-declines-for-the-first-time-new-numbers-show/,geekwire.com,5,amazon employment washington state including warehouse corporate worker fell people employee early early first recorded yearoveryear employment decline state since company founded nearly year ago jeff bezos bellevue garage,0.1779,0.08895,0.3795481818,-0.290598182,Negative Impact
09/04/2024,187.24,187.34,184.20,185.67,185.67,36546900,5.66,38.78057437,1.192,0,27.30545211,0.4577403224,0.2071825716,5.33,313.548,16306.63965,18171.19922,7934.799805,8049.169922,3048.537109,74683.70313,22361.80078,174.2395993,147.5425501,173.4364497,150.6975673,179.4445,186.0964167,172.7925832,77.18418284,3.118356291,2.784719898,0.3336363927,3.339285714,177.7607631,11342730400,86.85040496,87.39605795,14.97999954,Amazon (AMZN) Share Price Reaches Record Post-Pandemic High,"Amazon's (AMZN) stock shows investor optimism on the back of a robust retail business, strengthening cloud division, growing generative AI efforts, and expanding streaming services.",https://www.zacks.com/stock/news/2252795/amazon-amzn-share-price-reaches-record-post-pandemic-high?cid=CS-STOCKNEWSAPI-FT-analyst_blog|company_news_-_corporate_actions-2252795,zacks.com,8,amazon amzn stock show investor optimism back robust retail business strengthening cloud division growing generative ai effort expanding streaming service,0.8885,0.7108,0.3484766667,0.3623233333,Positive Impact
10/04/2024,182.77,186.27,182.67,185.95,185.95,35879200,5.66,38.78057437,1.192,0,27.30545211,0.4577403224,0.2071825716,5.33,313.548,16170.36035,17947.30078,7961.200195,8045.379883,3027.334961,75038.14844,22199.09961,174.7333994,147.8256501,173.927177,151.0483377,179.9724998,186.9383537,173.006646,74.37498629,3.220185025,2.871812924,0.348372101,3.318571908,179.1018557,11378609600,86.87441105,86.15810855,15.80000019,"Amazon owes $525 mln in cloud-storage patent fight, US jury says","Amazon.com's Amazon Web Services, the world's largest cloud-service provider, owes tech company Kove $525 million for violating its patent rights in data-storage technology, an Illinois federal jury said on Wednesday.",https://www.reuters.com/legal/amazon-owes-525-mln-cloud-storage-patent-fight-us-jury-says-2024-04-11/,reuters.com,10,amazoncoms amazon web service world largest cloudservice provider owes tech company kove million violating patent right datastorage technology illinois federal jury said wednesday,-0.4215,-0.4215,0.30451,-0.72601,Negative Impact
11/04/2024,186.74,189.77,185.51,189.05,189.05,40020700,5.66,38.78057437,1.192,0,27.30545211,0.4577403224,0.2071825716,5.33,313.548,16442.19922,17915.19922,7923.799805,8023.740234,3034.246094,75038.14844,22110.09961,175.3343994,148.1342501,174.520229,151.4264638,180.5970001,188.4568341,172.7371662,78.53402347,3.51056204,2.999562747,0.5109992934,3.389286586,180.2551954,11418630300,94.47003852,89.39828484,14.90999985,"SoFI Technologies, Microsoft, Amazon, AMD, and Other Tech Stocks in Focus Today",Tech stocks had a bad day Wednesday after U.S. inflation data came in hot but were looking to stabilize early Thursday.,https://www.barrons.com/articles/sofi-technologies-microsoft-amazon-amd-tech-stocks-today-33276207,barrons.com,9,tech stock bad day wednesday u inflation data came hot looking stabilize early thursday,-0.5423,-0.48807,0.3027596296,-0.79082963,Negative Impact
12/04/2024,187.72,188.38,185.08,186.13,186.13,38554300,5.66,38.78057437,1.192,0,27.30545211,0.4577403224,0.2071825716,5.33,313.548,16175.08984,17639.03906,7995.600098,8010.830078,3019.474121,74244.89844,21900,175.9529996,148.4190002,174.9755144,151.7717726,180.9660004,189.147111,172.7848898,67.04226179,3.465124669,3.092675131,0.3724495371,3.49357278,181.7775648,11380076000,70.94972271,84.09805743,17.30999947,5 ETFs to Tap Amazon's Growth Story,"Amazon (AMZN) registered its first new all-time high in almost three years, reflecting a dramatic rebound from its slump in 2022 and the resurgence of confidence in the company's future growth potential.",https://www.zacks.com/stock/news/2254589/5-etfs-to-tap-amazon-s-growth-story?cid=CS-STOCKNEWSAPI-FT-etf_news_and_commentary-2254589,zacks.com,8,amazon amzn registered first new alltime high almost three year reflecting dramatic rebound slump resurgence confidence company future growth potential,0.765,0.612,0.2127036364,0.3992963636,Positive Impact
15/04/2024,187.43,188.69,183.00,183.62,183.62,48052400,5.66,38.78057437,1.192,0,27.30545211,0.4577403224,0.2071825716,5.33,313.548,15885.01953,17506.92969,7965.5,8045.109863,3057.37793,73399.78125,21740.19922,176.4397995,148.6919002,175.3145136,152.0886704,181.4260002,189.0746225,173.777378,58.51107009,3.189808288,3.112101763,0.07770652567,3.632144383,189.7700043,11332023600,50.64200769,72.02058964,19.22999954,"Investors should buy the dip, but be ready with these geopolitical hedges, says Citi","Early market action Monday indicates relief that the weekend's attack on Israel by Iran may signal the peak of tensions in the region. Some of the risk-off trades from Friday are being unwound, with stock-index futures higher on the session.",https://www.marketwatch.com/story/investors-should-buy-the-dip-but-be-ready-with-these-geopolitical-hedges-says-citi-d808d46a,marketwatch.com,8,early market action monday indicates relief weekend attack israel iran may signal peak tension region riskoff trade friday unwound stockindex future higher session,-0.3182,-0.25456,0.28842,-0.54298,Negative Impact
16/04/2024,183.27,184.83,182.26,183.32,183.32,32891300,5.66,38.78057437,1.192,0,27.30545211,0.4577403224,0.2071825716,5.33,313.548,15865.25,17413.98047,7820.399902,7932.609863,3007.068115,72943.67969,21642.90039,176.6699997,148.9690002,175.6284545,152.3994299,181.8680008,188.8161509,174.9198507,61.48216865,2.91382283,3.072445976,-0.158623146,3.637144906,189.6346042,11299132300,48.23440231,56.6087109,18.39999962,How AI Is Helping Amazon Save Half A Million Tons Of Packaging Per Year,"Amazon ships 20 million packages a day in 19 countries, requiring an astronomical amount of paper, cardboard and plastic packaging. Figuring out how to pack all those items efficiently is good for the environment and for its own profits.",https://www.forbes.com/sites/amyfeldman/2024/04/15/how-ai-is-helping-amazon-save-half-a-million-tons-of-packaging-per-year-artificial-intelligence/,forbes.com,8,amazon ship million package day country requiring astronomical amount paper cardboard plastic packaging figuring pack item efficiently good environment profit,0.8481,0.67848,0.2639436842,0.4145363158,Positive Impact
17/04/2024,184.31,184.57,179.82,181.28,181.28,31359700,5.66,38.78057437,1.192,0,27.30545211,0.4577403224,0.2071825716,5.33,313.548,15683.37012,17403.43945,7848,7981.509766,3071.381104,72943.67969,21656.09961,176.8893997,149.2236002,175.8500837,152.6867988,182.137001,188.5046192,175.7693828,53.24093937,2.501653224,2.958287426,-0.456634202,3.784287589,189.3396198,11267772600,25.46087842,41.44576281,18.20999908,5 Signs a Market Bounce May Be Imminent,"Though the current market weakness has scared many investors, 5 signals suggest that it may be an optimal time for opportunistic investors to take advantage of.",https://www.zacks.com/commentary/2257173/5-signs-a-market-bounce-may-be-imminent?cid=CS-STOCKNEWSAPI-FT-investment_ideas-2257173,zacks.com,8,though current market weakness scared many investor signal suggest may optimal time opportunistic investor take advantage,-0.3182,-0.25456,0.2749721053,-0.529532105,Negative Impact
18/04/2024,181.47,182.39,178.65,179.22,179.22,30723800,5.66,38.78057437,1.192,0,27.30545211,0.4577403224,0.2071825716,5.33,313.548,15601.5,17388.08984,7877.100098,8023.259766,3074.225098,72488.99219,21708.40039,177.0907999,149.4686002,175.9822373,152.9508107,182.1905014,188.4338403,175.9471625,47.57118211,1.985889161,2.763807773,-0.777918612,3.87714495,188.7684431,11237048800,7.374858498,27.02337974,18,"The stars may be aligning for a repeat of last August's stock selloff, warns JPMorgan","It's been a dreary April, with a 4.4% drop for the S&P 500, and a fall of 2% this week. It's also in the grips of the longest slide since January, with a fear gauge on the rise.",https://www.marketwatch.com/story/the-stars-may-be-aligning-for-a-repeat-of-last-augusts-stock-selloff-warns-jpmorgan-70ff55d2,marketwatch.com,8,dreary april drop sp fall week also grip longest slide since january fear gauge rise,-0.7717,-0.61736,0.2671705882,-0.884530588,Negative Impact
19/04/2024,178.74,179.00,173.44,174.63,174.63,55950000,5.66,38.78057437,1.192,0,27.30545211,0.4577403224,0.2071825716,5.33,313.548,15282.00977,17458.76953,7895.899902,8022.410156,3065.260986,73088.32813,21807.40039,177.1728,149.6898502,175.9292086,153.1665241,182.014502,188.902592,175.1264119,38.62985074,1.193015738,2.449649366,-1.256633628,4.072144645,187.9589671,11181098800,7.287215603,13.37431751,18.70999908,TRIP vs. AMZN: Which Stock Should Value Investors Buy Now?,Investors looking for stocks in the Internet - Commerce sector might want to consider either TripAdvisor (TRIP) or Amazon (AMZN). But which of these two stocks offers value investors a better bang for their buck right now?,https://www.zacks.com/stock/news/2258624/trip-vs-amzn-which-stock-should-value-investors-buy-now?cid=CS-STOCKNEWSAPI-FT-tale_of_the_tape|yseop_template_3-2258624,zacks.com,8,investor looking stock internet commerce sector might want consider either tripadvisor trip amazon amzn two stock offer value investor better bang buck right,0.743,0.5944,0.2907466667,0.3036533333,Positive Impact
22/04/2024,176.94,178.87,174.56,177.23,177.23,37924900,5.66,38.78057437,1.192,0,27.30545211,0.4577403224,0.2071825716,5.33,313.548,15451.30957,17602.18945,8023.899902,8040.359863,3044.594971,73648.61719,21872,177.3206,149.9342002,175.9802199,153.4059616,181.932502,189.0145262,174.8504777,44.27151148,0.7656296684,2.112845427,-1.347215758,4.195001875,186.5070707,11219023700,23.20877441,12.62361617,16.94000053,"Big Tech's Big Breakdown, The Technical Setup Ahead Of Earnings","Ahead of their Q1 2024 earnings, big tech stocks swung lower last week amid a broad market sell-off. In my view, soaring long-duration treasury yields and rightful concerns about liquidity drying up are driving this pullback. The technical setup for big tech stocks heading into Q1 looks bearish, and a failure to meet lofty investor expectations could lead to a deeper pullback in this frothy, overcrowded basket.",https://seekingalpha.com/article/4685066-big-techs-big-breakdown-technical-setup-ahead-of-earnings,seekingalpha.com,6,ahead q earnings big tech stock swung lower last week amid broad market selloff view soaring longduration treasury yield rightful concern liquidity drying driving pullback technical setup big tech stock heading q look bearish failure meet lofty investor expectation could lead deeper pullback frothy overcrowded basket,-0.5719,-0.34314,0.2433504545,-0.586490455,Negative Impact
23/04/2024,178.08,179.93,175.98,179.54,179.54,37046500,5.66,38.78057437,1.192,0,27.30545211,0.4577403224,0.2071825716,5.33,313.548,15696.63965,17792.75977,8044.799805,8105.779785,3021.978027,73738.45313,22011.69922,177.4223999,150.1830001,176.1198188,153.6660018,181.9240013,189.0176566,174.8303461,45.33937804,0.6063312174,1.811542585,-1.205211367,4.257859366,185.2003638,11256070200,37.3545019,22.61683064,15.68999958,3 Stocks Built to Withstand the Coming AI Tumble,"The S&P 500 took a beating last week, shedding more than 3% as investors rotated out of AI stocks. Nvidia (NASDAQ: NVDA ), perhaps the biggest AI trailblazer, saw the second biggest daily loss in the market for any U.S. company on Friday, losing more than $200 billion.",https://investorplace.com/2024/04/3-stocks-built-to-withstand-the-coming-ai-tumble/,investorplace.com,6,sp took beating last week shedding investor rotated ai stock nvidia nasdaq nvda perhaps biggest ai trailblazer saw second biggest daily loss market u company friday losing billion,-0.7845,-0.4707,0.2838545161,-0.754554516,Negative Impact
24/04/2024,179.94,180.32,176.18,176.59,176.59,34185100,5.66,38.78057437,1.192,0,27.30545211,0.4577403224,0.2071825716,5.33,313.548,15712.75,17758.08008,8040.399902,8091.859863,3044.822021,73852.9375,21873.69922,177.5073999,150.4303001,176.1382572,153.8941012,181.838501,189.1538314,174.5231706,44.55792352,0.2392875893,1.497091586,-1.257803996,4.189288548,184.0243277,11221885100,19.28961141,26.61762924,15.97000027,Will the Stock Market Crash? 3 Apocalypse Stocks to Buy if You're Worried.,"The recent wave of mass layoffs in the U.S. is raising concerns about the country's economic health, signaling a potential slide into the recession that was narrowly avoided last year. Analysts like Gary Shilling, who accurately predicted the 2007-2008 financial crisis, note weakening labor market indicators despite post-pandemic solid hiring.",https://investorplace.com/2024/04/will-the-stock-market-crash-3-apocalypse-stocks-to-buy-if-youre-worried/,investorplace.com,6,recent wave mass layoff u raising concern country economic health signaling potential slide recession narrowly avoided last year analyst like gary shilling accurately predicted financial crisis note weakening labor market indicator despite postpandemic solid hiring,-0.8606,-0.51636,0.2692009091,-0.785560909,Negative Impact
25/04/2024,169.68,173.92,166.32,173.67,173.67,49249400,5.66,38.78057437,1.192,0,27.30545211,0.4577403224,0.2071825716,5.33,313.548,15611.75977,17731.56055,8078.899902,8016.649902,3052.899902,74339.4375,21885.40039,177.6079999,150.6547501,176.0414627,154.0908763,181.5305008,189.6737559,173.3872457,30.46604185,-0.283943456,1.140884577,-1.424828033,4.475001744,182.9658952,11172635700,31.34324862,29.32912064,15.36999989,"Amazon, Meta, IBM, Super Micro, and Other Tech Stocks in Focus Today",Disappointing corporate earnings are putting the sector under pressure early Thursday.,https://www.barrons.com/articles/amazon-meta-ibm-super-micro-tech-stocks-today-71652802,barrons.com,9,disappointing corporate earnings putting sector pressure early thursday,-0.6597,-0.59373,0.2866215789,-0.880351579,Negative Impact
26/04/2024,177.8,180.82,176.13,179.62,179.62,43919800,5.66,38.78057437,1.192,0,27.30545211,0.4577403224,0.2071825716,5.33,313.548,15927.90039,17763.26953,8139.799805,8088.240234,3088.635986,73730.15625,21969.19922,177.7807999,150.8988501,176.1817973,154.3448974,181.4925003,189.6654,173.3196006,42.04511479,-0.216002855,0.869507091,-1.085509946,4.808574132,180.9683886,11216555500,56.71637324,35.78307776,15.02999973,Cat hides in Amazon return packageÃÂÃÂthen ends up in California 700 miles from home,"A cat went missing after hiding in an Amazon return package. Then her Utah owner got a callÃÂÃÂfrom hundreds of miles awayÃÂÃÂthat ""changed everything.",https://techxplore.com/news/2024-04-cat-amazon-package-california-miles.html,techxplore.com,5,cat went missing hiding amazon return package utah owner got callfrom hundred mile awaythat changed everything,-0.4019,-0.20095,0.3503533333,-0.551303333,Negative Impact
29/04/2024,182.75,183.53,179.39,180.96,180.96,54063900,5.66,38.78057437,1.192,0,27.30545211,0.4577403224,0.2071825716,5.33,313.548,15983.08008,17831.07031,8147,8065.149902,3113.042969,74671.28125,22011.59961,178.0039999,151.1321501,176.3691781,154.6097243,181.4920006,189.665036,173.3189651,43.43463605,-0.053415956,0.6849224816,-0.738338438,4.880002703,166.3200073,11270619400,62.43070915,50.16344367,14.67000008,"SoFi, ON Semiconductor, Amazon, Super Micro, and Other Tech Stocks in Focus Today",Tech stocks are rising to start a busy week of earnings as the sector looks to end a difficult month in style.,https://www.barrons.com/articles/sofi-amazon-super-micro-tech-stocks-today-0b3f2446,barrons.com,9,tech stock rising start busy week earnings sector look end difficult month style,-0.3612,-0.32508,0.1835320833,-0.508612083,Negative Impact
30/04/2024,181.09,182.99,174.80,175.00,175.00,94639800,5.66,38.78057437,1.192,0,27.30545211,0.4577403224,0.2071825716,5.33,313.548,15657.82031,17603.33984,8144.100098,7984.930176,3104.824951,74482.78125,21714.5,178.1138,151.3337502,176.3154848,154.8126127,181.2075005,189.8790144,172.5359866,36.82310933,-0.40086646,0.4677646932,-0.868631153,5.207859584,166.6642072,11175979600,37.01489896,52.05399378,15.64999962,"AMD, Super Micro, Amazon, Logitech, Samsung, and Other Tech Stocks in Focus Today",Tech stocks were struggling for direction Tuesday at the end of a difficult month for the sector as investors awaited a raft of key earnings.,https://www.barrons.com/articles/amd-super-micro-amazon-logitech-samsung-tech-stocks-today-a34a528c,barrons.com,9,tech stock struggling direction tuesday end difficult month sector investor awaited raft key earnings,-0.6597,-0.59373,0.2559695556,-0.849699556,Negative Impact
01/05/2024,181.64,185.15,176.56,179.00,179.00,94645100,5.66,38.78057437,1.192,0,27.30545211,0.4577403224,0.2071825716,5.33,314.069,15605.48047,17576.39063,8121.200195,7984.930176,3104.824951,74482.78125,21728.59961,178.3522,151.5609502,176.4207599,155.0532832,181.0370003,189.7429887,172.3310118,38.16253972,-0.349428919,0.3043259708,-0.653754889,5.628572736,167.001523,11270624700,56.6830373,52.0428818,15.39000034,"Amazon Beats, Starbucks Misses, Fed Scheduled To Deliver","Stocks, which were down all-day Tuesday, saw accelerated selling into the close. When the day finally came to an end, the S&P 500 was down 1.6% and the Nasdaq Composite was off 2%. The selloff was widespread with all eleven sectors of the S&P down on the day. For the month, the S&P 500 was down 4.2%, its worst month since September. The Nasdaq Composite dropped 4.4%.",https://www.forbes.com/sites/jjkinahan/2024/05/01/amazon-beats-starbucks-misses-fed-scheduled-to-deliver/,forbes.com,8,stock allday tuesday saw accelerated selling close day finally came end sp nasdaq composite selloff widespread eleven sector sp day month sp worst month since september nasdaq composite dropped,-0.6249,-0.49992,0.2596926667,-0.759612667,Negative Impact
02/05/2024,180.85,185.10,179.91,184.72,184.72,54303500,5.66,38.78057437,1.192,0,27.30545211,0.4577403224,0.2071825716,5.33,314.069,15840.95996,17699.05078,8172.200195,7914.649902,3104.824951,74611.10938,21823.19922,178.6748001,151.8204002,176.7462204,155.3484744,181.2730003,190.1154556,172.4305451,48.4419849,0.1511496393,0.2736907045,-0.122541065,5.780715942,167.7274618,11324928200,82.2530081,58.65031479,14.68000031,"Amazon CEO Andy Jassy's comments about unions violated federal law, NLRB judge rules",A federal administrative-law judge ruled that Amazon CEO Andy Jassy violated labor law by making certain anti-union comments during media interviews two years ago.,https://www.marketwatch.com/story/amazon-ceo-andy-jassys-comments-about-unions-violated-federal-law-nlrb-judge-rules-256c674e,marketwatch.com,8,federal administrativelaw judge ruled amazon ceo andy jassy violated labor law making certain antiunion comment medium interview two year ago,-0.1531,-0.12248,0.3058818182,-0.428361818,Negative Impact
03/05/2024,186.99,187.87,185.42,186.21,186.21,39172000,5.66,38.78057437,1.192,0,27.30545211,0.4577403224,0.2071825716,5.33,314.069,16156.33008,17797.89063,8213.5,7957.569824,3104.824951,73878.14844,21947.40039,178.9074002,152.0746502,177.1173492,155.6555543,181.3300003,190.2894365,172.3705641,52.9278904,0.6604791512,0.3510483939,0.3094307573,5.599286761,168.4243631,11364100200,92.29703321,77.07769287,13.48999977,"Most Magnificent Seven stocks have now reported earnings. What can Apple, Amazon, Meta, Google, Microsoft and Tesla tell us about future market growth?","Last night, the world's biggest company by market reported its latest financial results. Investors were on the edge of their seats as Apple Inc announced earnings ÃÂÃÂ but so were the world markets.",https://invezz.com/news/2024/05/03/most-magnificent-seven-stocks-have-now-reported-earnings-what-can-they-tell-us-about-future-market-growth/,invezz.com,5,last night world biggest company market reported latest financial result investor edge seat apple inc announced earnings world market,0,0,0.3173071429,-0.317307143,Negative Impact
06/05/2024,186.28,188.75,184.80,188.70,188.70,34725300,5.66,38.78057437,1.192,0,27.30545211,0.4577403224,0.2071825716,5.33,314.069,16349.25,17963.83984,8213.5,7996.640137,3140.719971,73895.53906,22259.5,179.1816,152.3683501,177.5715707,155.9843548,181.5055,190.9097638,172.1012362,55.79490504,1.250631361,0.5309649874,0.7196663739,5.697857448,169.591101,11398825500,99.77707058,91.44237063,13.48999977,Morgan Stanley's Mike Wilson offers a playbook to cope with the cautious consumer,"With a Fed meeting and major data out of the way, investors will have some time to ponder what's happening under the surface of the economy this week. That's as earnings season continues to roll on.",https://www.marketwatch.com/story/morgan-stanleys-mike-wilson-offers-a-playbook-to-cope-with-the-cautious-consumer-95841ed6,marketwatch.com,8,fed meeting major data way investor time ponder whats happening surface economy week thats earnings season continues roll,0,0,0.398935,-0.398935,Negative Impact
07/05/2024,188.92,189.94,187.31,188.76,188.76,34048900,5.66,38.78057437,1.192,0,27.30545211,0.4577403224,0.2071825716,5.33,314.069,16332.55957,17994.26953,8313.700195,8075.680176,3147.738037,73511.85156,22290.59961,179.4622,152.6621501,178.0103324,156.3104805,181.6599998,191.4461134,171.8738863,58.4158392,1.703535247,0.7654790393,0.9380562079,5.546429225,171.1238129,11432874400,95.00419907,95.69276762,13.22999954,"Amazon, AMD, Snowflake, Datadog, and Other Tech Stocks in Focus Today",The sector is struggling to keep recent momentum going early Tuesday amid disappointing earnings reports.,https://www.barrons.com/articles/amazon-amd-snowflake-palantir-tech-stocks-today-57c338ad,barrons.com,9,sector struggling keep recent momentum going early tuesday amid disappointing earnings report,-0.7184,-0.64656,0.2284361111,-0.874996111,Negative Impact
08/05/2024,187.44,188.43,186.39,188.00,188.00,26136400,5.66,38.78057437,1.192,0,27.30545211,0.4577403224,0.2071825716,5.33,314.069,16302.75977,17996.0293,8354.099609,8131.410156,3128.47998,73466.39063,22259.19922,179.7514001,152.9581501,178.4020841,156.6257991,181.7625,191.7780614,171.7469386,60.17617294,1.978334625,1.008050156,0.9702844682,5.448571341,173.0054319,11406738000,91.78660947,95.52262638,13,Huge News for Amazon Stock Investors,Amazon reveals critical insights that investors will not want to miss.,https://www.fool.com/investing/2024/05/08/huge-news-for-amazon-stock-investors/,fool.com,7,amazon reveals critical insight investor want miss,-0.2263,-0.15841,0.3916876923,-0.550097692,Negative Impact
09/05/2024,188.88,191.70,187.44,189.50,189.50,43368400,5.66,38.78057437,1.192,0,27.30545211,0.4577403224,0.2071825716,5.33,314.069,16346.25977,18127.21094,8381.400391,8187.649902,3154.320068,72404.17188,22375.80078,180.0782001,153.2600001,178.8372965,156.9529056,181.7849998,191.8712653,171.6987344,68.56429419,2.290746278,1.264589381,1.026156897,5.339999608,174.6988889,11450106400,91.33176577,92.70752477,12.68999958,"Intel, Amazon, Palantir, Super Micro, and Other Tech Stocks in Focus Today",Tech stocks look set for another challenging day as corporate earnings keep AI-exposed companies under pressure.,https://www.barrons.com/articles/intel-amazon-palantir-tech-stocks-today-89878542,barrons.com,9,tech stock look set another challenging day corporate earnings keep aiexposed company pressure,-0.1531,-0.13779,0.2850376923,-0.422827692,Negative Impact
10/05/2024,189.16,189.89,186.93,187.48,187.48,34141800,5.66,38.78057437,1.192,0,27.30545211,0.4577403224,0.2071825716,5.33,314.069,16340.87012,18162.05078,8433.799805,8219.139648,3154.547119,72664.46875,22308.90039,180.2926001,153.5566501,179.1762259,157.2566577,181.8524994,192.0783011,171.6266976,62.98454482,2.34826793,1.48132509,0.8669428394,5.24357169,176.7390219,11415964600,83.37272283,88.83036602,12.55000019,"DigitalOcean Stock Rises After Earnings. It's a Different Cloud Play From Microsoft, Amazon.","For the full-year, the company expects revenue of $760 to $775 million, narrowing the lower end of the range from $755 million.",https://www.barrons.com/articles/digitalocean-holdings-earnings-stock-price-551fe598,barrons.com,9,fullyear company expects revenue million narrowing lower end range million,-0.296,-0.2664,0.2686247059,-0.535024706,Negative Impact
13/05/2024,188,188.31,185.36,186.57,186.57,24898600,5.66,38.78057437,1.192,0,27.30545211,0.4577403224,0.2071825716,5.33,314.069,16388.24023,18133.94922,8415,8209.280273,3148.020996,72776.13281,22259.19922,180.4596002,153.8482501,179.4661781,157.5483329,182,192.4164754,171.5835246,59.23301222,2.293982196,1.643856512,0.6501256842,5.172143119,178.5343389,11391066000,79.78726666,84.83058509,13.60000038,AMZN or CPNG: Which Is the Better Value Stock Right Now?,"Investors interested in Internet - Commerce stocks are likely familiar with Amazon (AMZN) and Coupang, Inc. (CPNG). But which of these two stocks offers value investors a better bang for their buck right now?",https://www.zacks.com/stock/news/2272988/amzn-or-cpng-which-is-the-better-value-stock-right-now?cid=CS-STOCKNEWSAPI-FT-tale_of_the_tape|yseop_template_3-2272988,zacks.com,8,investor interested internet commerce stock likely familiar amazon amzn coupang inc cpng two stock offer value investor better bang buck right,0.8271,0.66168,0.3093365,0.3523435,Positive Impact
14/05/2024,183.82,187.72,183.45,187.07,187.07,38698200,5.66,38.78057437,1.192,0,27.30545211,0.4577403224,0.2071825716,5.33,314.069,16511.17969,18220.81055,8428.099609,8225.799805,3145.773926,73104.60938,22243.30078,180.6494003,154.1225501,179.7643675,157.8420809,182.1875,192.8364287,171.5385713,64.71085405,2.26519443,1.768124095,0.497070335,5.181428092,180.1142179,11429764200,81.75732263,81.63910404,13.42000008,Amazon's Stock Claws Back From The Brink Igniting Optimism Despite Legal Frays With Fire TV Sticks - Amazon.com (NASDAQ:AMZN),"Moving further into the digital age, the way technology, law, and how individuals behave online keeps evolving. A key example is what's happening with Amazon.com Inc AMZN Fire TV Sticks.",https://www.benzinga.com/trading-ideas/24/05/38814738/amazons-stock-claws-back-from-the-brink-igniting-optimism-despite-legal-frays-with-fire-tv-sticks,benzinga.com,5,moving digital age way technology law individual behave online keep evolving key example whats happening amazoncom inc amzn fire tv stick,-0.34,-0.17,0.2293427778,-0.399342778,Negative Impact
15/05/2024,185.97,186.72,182.73,185.99,185.99,75459900,5.66,38.78057437,1.192,0,27.30545211,0.4577403224,0.2071825716,5.33,314.069,16742.39063,18378.49023,8445.799805,8239.990234,3119.9021,72987.03125,22284.80078,180.8868005,154.3841002,180.0085101,158.1221597,182.4230003,193.195038,171.6509627,68.23565389,2.130671739,1.840633624,0.2900381153,4.757858276,181.5045114,11354304300,66.21305611,75.91921513,12.44999981,"3 ""Magnificent Seven"" Stocks That Can Plunge Up to 86%, According to Select Wall Street Analysts","The Magnificent Seven are widely credited with leading the Dow Jones, S&P 500, and Nasdaq Composite to fresh record highs. Though the Magnificent Seven components all possess clearly-defined competitive advantages, Wall Street's outlook for these companies is mixed.",https://www.fool.com/investing/2024/05/15/3-magnificent-seven-stocks-plunge-86-wall-street/,fool.com,7,magnificent seven widely credited leading dow jones sp nasdaq composite fresh record high though magnificent seven component possess clearlydefined competitive advantage wall street outlook company mixed,0.936,0.6552,0.29122625,0.36397375,Positive Impact
16/05/2024,185.6,187.31,183.46,183.63,183.63,38834500,5.66,38.78057437,1.192,0,27.30545211,0.4577403224,0.2071825716,5.33,314.069,16698.32031,18317.38086,8438.700195,8188.490234,3122.400879,73663.71875,22299.80078,181.0892007,154.6438002,180.1505295,158.3759691,182.6435005,193.3195931,171.9674079,56.64128758,1.812733152,1.83505353,-0.022320377,4.522142683,182.7279696,11315469800,52.24855041,66.73964305,12.42000008,All In: Daniel Loeb Puts 37% of Portfolio in These 3 Stocks. Masterstroke or Misstep?,"Billionaire activist investor Daniel Loeb describes the strategy at his Third Point hedge fund as ÃÂÃÂan event-driven and value approach.ÃÂÃÂ He looks to unlock shareholder value through special situation investing, whether it is mergers and acquisitions, restructurings or other catalysts that can spur gains.",https://investorplace.com/2024/05/all-in-daniel-loeb-put-37-of-portfolio-in-these-3-stocks-masterstroke-or-misstep/,investorplace.com,6,billionaire activist investor daniel loeb describes strategy third point hedge fund eventdriven value approach look unlock shareholder value special situation investing whether merger acquisition restructurings catalyst spur gain,0.872,0.5232,0.22006,0.30314,Positive Impact
17/05/2024,183.76,185.30,183.35,184.70,184.70,33175700,5.66,38.78057437,1.192,0,27.30545211,0.4577403224,0.2071825716,5.33,314.069,16685.9707,18388.25977,8420.299805,8167.5,3154.025879,73917.03125,22465.40039,181.2468005,154.9262502,180.32894,158.6378997,183.1470001,193.1611254,173.1328748,56.24998725,1.628333534,1.793709531,-0.165375997,4.365713937,191.6999969,11348645500,58.5798667,59.01382441,11.98999977,"Is the meme-stock frenzy over already? Possibly, say experts.",It was the week the meme-stock frenzy from 2021 returned with a vengeance ÃÂÃÂ and it may all be over already.,https://www.marketwatch.com/story/is-the-meme-stock-frenzy-over-already-possibly-say-experts-b229350c,marketwatch.com,8,week memestock frenzy returned vengeance may already,-0.3182,-0.25456,0.1777028571,-0.432262857,Negative Impact
20/05/2024,184.34,186.67,183.28,183.54,183.54,30511800,5.66,38.78057437,1.192,0,27.30545211,0.4577403224,0.2071825716,5.33,314.069,16794.86914,18335.61914,8424.200195,8195.969727,3171.14502,73917.03125,22465.40039,181.4106003,155.1994001,180.4548637,158.8856818,183.4625,193.0815114,173.8434886,66.99840791,1.372768486,1.709521322,-0.336752836,4.022856576,191.5329971,11318133700,46.10301195,52.31047635,12.14999962,3 S&P 500 Stocks That Have Proven Themselves Recession-Proof,"Since 1928, there have been 25 bear markets, or declines in the S&P 500 of 20% or more, according to Yardeni Research. Market corrections have been far more common.",https://investorplace.com/2024/05/3-sp-500-stocks-that-have-proven-themselves-recession-proof/,investorplace.com,6,since bear market decline sp according yardeni research market correction far common,0,0,0.39411,-0.39411,Negative Impact
21/05/2024,182.3,183.26,180.75,183.15,183.15,50839100,5.66,38.78057437,1.192,0,27.30545211,0.4577403224,0.2071825716,5.33,314.069,16832.61914,18337.91016,8416.5,8141.459961,3157.966064,73953.3125,22468.19922,181.6344,155.4173,180.5605551,159.1271177,183.643,193.0859651,174.200035,59.64667108,1.125784312,1.59277392,-0.466989608,3.497142247,191.2028772,11267294600,27.48084885,44.05457583,11.85999966,Tech giants pledge AI safety commitments ÃÂÃÂ including a ÃÂÃÂkill switch' if they can't mitigate risks,"A slew of major tech companies including Microsoft, Amazon, and OpenAI, on Tuesday agreed to a landmark international agreement on artificial intelligence safety at the Seoul AI Safety Summit.",https://www.cnbc.com/2024/05/21/tech-giants-pledge-ai-safety-commitments-including-a-kill-switch.html,cnbc.com,9,slew major tech company including microsoft amazon openai tuesday agreed landmark international agreement artificial intelligence safety seoul ai safety summit,0.9325,0.83925,0.4120115,0.4272385,Positive Impact
22/05/2024,183.88,185.22,181.97,183.13,183.13,28148800,5.66,38.78057437,1.192,0,27.30545211,0.4577403224,0.2071825716,5.33,314.069,16801.53906,18236.64063,8370.299805,8092.109863,3158.540039,74221.0625,22346.80078,181.7892001,155.6218501,180.6613178,159.3659524,183.9700005,192.8188513,175.1211496,44.9715381,0.9178541765,1.457789971,-0.539935794,3.293570382,190.5757046,11239145800,21.73521047,31.77302375,12.28999996,"Amazon, AI startup Hugging Face pair to use Amazon chips",Amazon.com's cloud unit on Wednesday said it has partnered with artificial intelligence startup Hugging Face to make it easier to run thousands of AI models on Amazon's custom computing chips.,https://www.reuters.com/technology/amazon-ai-startup-hugging-face-pair-use-amazon-chips-2024-05-23/,reuters.com,10,amazoncoms cloud unit wednesday said partnered artificial intelligence startup hugging face make easier run thousand ai model amazon custom computing chip,0.8555,0.8555,0.2826304545,0.5728695455,Positive Impact
23/05/2024,183.66,184.76,180.08,181.05,181.05,33670200,5.66,38.78057437,1.192,0,27.30545211,0.4577403224,0.2071825716,5.33,314.069,16736.0293,18028.4707,8339.200195,8102.330078,3116.386963,75418.03906,22200.80078,181.8790002,155.8274001,180.6765604,159.5817141,184.3390007,191.9013504,176.776651,34.26824639,0.5785600023,1.281943977,-0.703383975,3.402856009,189.9861623,11205475600,8.347690433,19.18791658,12.77000046,White House pushes tech industry to crack down on sexually abusive AI deepfakes,President Joe Biden's administration is pushing the tech industry and financial institutions to shut down a growing market of abusive sexual images made with artificial intelligence technology.,https://www.marketwatch.com/story/white-house-pushes-tech-industry-to-crack-down-on-sexually-abusive-ai-deepfakes-4d34c241,marketwatch.com,8,president joe bidens administration pushing tech industry financial institution shut growing market abusive sexual image made artificial intelligence technology,-0.1027,-0.08216,0.35044,-0.4326,Negative Impact
24/05/2024,181.65,182.44,180.30,180.75,180.75,27434100,5.66,38.78057437,1.192,0,27.30545211,0.4577403224,0.2071825716,5.33,314.069,16920.78906,18110.59961,8317.599609,8094.970215,3088.871094,75410.39063,22320.90039,181.9190002,156.0419,180.6794403,159.7923438,184.3955009,191.8251208,176.965881,22.02670561,0.2822060895,1.0819964,-0.79979031,3.273570469,189.1936695,11178041500,5.765907491,11.9496028,11.93000031,CEOs of AI start-ups backed by Microsoft and Amazon are the new tech rockstars,"Arthur Mensch, the CEO of Mistral AI and Dario Amodei, the CEO of Anthropic were in the spotlight at Viva Tech in Paris. Both lead companies backed by U.S. tech giants.",https://www.cnbc.com/2024/05/24/mistral-ai-anthropic-ceos-are-the-new-tech-rockstars-in-ai-boom.html,cnbc.com,9,arthur mensch ceo mistral ai dario amodei ceo anthropic spotlight viva tech paris lead company backed u tech giant,0.0258,0.02322,0.3600177778,-0.336797778,Negative Impact
28/05/2024,179.93,182.24,179.49,182.15,182.15,29927000,5.66,38.78057437,1.192,0,27.30545211,0.4577403224,0.2071825716,5.33,314.069,17019.88086,18007.00977,8254.200195,8057.799805,3109.572021,75170.45313,22265.09961,182.0736002,156.25985,180.7371091,160.014808,184.4550003,191.7871979,177.1228028,28.7459412,0.1584843765,0.8972939951,-0.738809619,3.282141549,188.464576,11207968500,21.78534205,11.96631333,12.92000008,US judge rejects Amazon bid to dismiss FTC lawsuit over Prime program,A U.S. judge in Seattle on Tuesday rejected Amazon.com's request to dismiss a Federal Trade Commission lawsuit that accuses the company of enrolling millions of consumers into its paid Amazon Prime service without their consent.,https://www.reuters.com/legal/us-judge-rejects-amazon-bid-dismiss-ftc-lawsuit-over-prime-program-2024-05-29/,reuters.com,10,u judge seattle tuesday rejected amazoncoms request dismiss federal trade commission lawsuit accuses company enrolling million consumer paid amazon prime service without consent,-0.7626,-0.7626,0.04817333333,-0.810773333,Negative Impact
29/05/2024,181.7,184.08,181.55,182.02,182.02,32009300,5.66,38.78057437,1.192,0,27.30545211,0.4577403224,0.2071825716,5.33,314.069,16920.58008,17794.89063,8183.100098,7935.029785,3111.018066,74502.89844,21898,182.2244003,156.4779,180.7874187,160.2337652,184.8060005,190.7784544,178.8335466,29.95975639,0.04937577809,0.7277103517,-0.678334574,3.293570382,187.567119,11175959200,20.72072522,16.09065826,14.27999973,"Duke Energy signs agreements with Amazon, Google, Microsoft for clean energy supply","Duke Energy on Wednesday announced agreements with Amazon, Google, Microsoft and Nucor to support carbon-free energy generation in response to growing data center demand.",https://www.reuters.com/sustainability/duke-energy-signs-agreements-with-amazon-google-microsoft-clean-energy-supply-2024-05-29/,reuters.com,10,duke energy wednesday announced agreement amazon google microsoft nucor support carbonfree energy generation response growing data center demand,0.875,0.875,0.3466273333,0.5283726667,Positive Impact
30/05/2024,181.31,181.34,178.36,179.32,179.32,29249200,5.66,38.78057437,1.192,0,27.30545211,0.4577403224,0.2071825716,5.33,314.069,16737.08008,17852.35938,8231.099609,7978.509766,3091.677979,73885.60156,22071.69922,182.2928006,156.67165,180.7298732,160.423678,184.8220009,190.7303328,178.9136689,18.42427099,-0.252055225,0.5317572363,-0.783812462,3.250713893,186.7594076,11146710000,8.326164922,16.9440774,14.47000027,Twitch terminates all members of its Safety Advisory Council,"Twitch on Friday will end the contracts for all members of its Safety Advisory Council, a resource made up of industry experts, streamers and moderators, who consulted on trust and safety issues. The council has advised Twitch on ""drafting new policies and policy updates,"" ""developing products and features to improve safety and moderation"" and ""protecting the interests of marginalized groups,"" per a company webpage.",https://www.cnbc.com/2024/05/30/twitch-ends-contracts-for-its-safety-advisory-council-sac-trust-safety.html,cnbc.com,9,twitch friday end contract member safety advisory council resource made industry expert streamer moderator consulted trust safety issue council advised twitch drafting new policy policy update developing product feature improve safety moderation protecting interest marginalized group per company webpage,0.9485,0.85365,0.3600476,0.4936024,Positive Impact
31/05/2024,178.3,179.21,173.87,176.44,176.44,58903900,5.66,38.78057437,1.192,0,27.30545211,0.4577403224,0.2071825716,5.33,314.069,16735.01953,18083.68945,8275.400391,7992.870117,3086.812988,73961.3125,22269.09961,182.2586008,156.8655,180.561643,160.5830444,184.4080009,191.4062625,177.4097394,17.49111924,-0.715090672,0.2823876546,-0.997478327,3.428571429,185.7514788,11087806100,17.79783165,15.61490726,12.92000008,"Amazon shutting down warehouse near Seattle, will offer new roles to employees","Amazon is closing a warehouse in Tukwila, Wash.",https://www.geekwire.com/2024/amazon-shutting-down-warehouse-near-seattle-will-offer-new-roles-to-employees/,geekwire.com,5,amazon closing warehouse tukwila wash,0.1779,0.08895,0.3318428571,-0.242892857,Negative Impact
03/06/2024,177.7,178.70,175.92,178.34,178.34,30786600,5.66,38.78057437,1.192,0,27.30545211,0.4577403224,0.2071825716,5.33,314.175,16828.66992,18006.96094,8262.799805,7998.02002,3078.489014,76468.78125,22116.69922,182.2624008,157.08185,180.4745196,160.7597305,184.0145004,191.4570667,176.5719342,27.10065553,-0.918152085,0.04227970659,-0.960431792,3.416428702,184.0880711,11118592700,32.27436282,19.4661198,13.10999966,United Kingdom Small Kitchen Appliances Market 2024 - Amazon is the Most Shopped at Retailer Across All Small Kitchen Appliances Subcategories,"Dublin, June 03, 2024 (GLOBE NEWSWIRE) -- The ""UK: Home Category Data, The Consumer - Small Kitchen Appliances 2024"" report has been added to ResearchAndMarkets.com's offering. The report offers a comprehensive insight into consumer attitudes in the UK small kitchen appliances market. The report focuses on five key subcategories: kettles & hot beverage makers, electrical kitchen gadgets, toasters & sandwich makers, small tabletop cooking appliances and food preparation appliances.",https://www.globenewswire.com/news-release/2024/06/03/2892004/28124/en/United-Kingdom-Small-Kitchen-Appliances-Market-2024-Amazon-is-the-Most-Shopped-at-Retailer-Across-All-Small-Kitchen-Appliances-Subcategories.html,globenewswire.com,5,dublin june globe newswire uk home category data consumer small kitchen appliance report added researchandmarketscoms offering report offer comprehensive insight consumer attitude uk small kitchen appliance market report focus five key subcategories kettle hot beverage maker electrical kitchen gadget toaster sandwich maker small tabletop cooking appliance food preparation appliance,0.25,0.125,0.4068577778,-0.281857778,Negative Impact
04/06/2024,177.64,179.82,176.44,179.34,179.34,27198400,5.66,38.78057437,1.192,0,27.30545211,0.4577403224,0.2071825716,5.33,314.175,16857.05078,17934.49023,8232,7937.899902,3091.198975,72079.04688,21978.19922,182.2718008,157.30865,180.4300285,160.9446088,183.5465004,190.9253841,176.1676167,29.0741114,-0.987010434,-0.163578321,-0.823432112,3.352857317,182.6575404,11145791100,40.69940645,30.25720031,13.15999985,Is this Michael Burry's biggest win of 2024?,Despite him keeping a fairly limited portfolio ÃÂÃÂ and dropping its controversial 2023 bet against the semiconductor industry ÃÂÃÂ there has been no shortage of excitement stemming from the various stock market bets of ÃÂÃÂ The Big Short ' investor Michael Burry.,https://finbold.com/is-this-michael-burrys-biggest-win-of-2024/,finbold.com,5,despite keeping fairly limited portfolio dropping controversial bet semiconductor industry shortage excitement stemming various stock market bet big short investor michael burry,0.2654,0.1327,0.4067671429,-0.274067143,Negative Impact
05/06/2024,180.1,181.50,178.75,181.28,181.28,32116400,5.66,38.78057437,1.192,0,27.30545211,0.4577403224,0.2071825716,5.33,314.175,17187.90039,18045.5,8247,8006.569824,3065.403076,74382.24219,22145,182.3032007,157.54895,180.4633606,161.146951,183.1725006,190.1880718,176.1569294,37.81682953,-0.874953271,-0.305853311,-0.569099959,3.23928506,173.8699951,11177907500,55.1339458,42.70257169,12.63000011,A Bull Market Is Here. 3 Reasons to Buy Amazon Like There's No Tomorrow.,Amazon has a solid growth track record -- and recent moves set the company up for more success down the road. The tech giant has put a focus on the hot area of artificial intelligence.,https://www.fool.com/investing/2024/06/05/a-bull-market-is-here-3-reasons-to-buy-amazon/,fool.com,7,amazon solid growth track record recent move set company success road tech giant put focus hot area artificial intelligence,0.8934,0.62538,0.3816353333,0.2437446667,Positive Impact
06/06/2024,181.75,185.00,181.49,185.00,185.00,31371200,5.66,38.78057437,1.192,0,27.30545211,0.4577403224,0.2071825716,5.33,314.175,17173.11914,18066.57031,8285.299805,8040.120117,3048.793945,75074.50781,22229.09961,182.4372006,157.80055,180.641268,161.3842948,183.0225006,189.7247648,176.3202364,53.31077085,-0.480435985,-0.340769846,-0.139666139,3.230000087,174.0225952,11209278700,86.95314242,60.92883156,12.57999992,Amazon Stock Breakout: Potential Run to $200,"Despite setting a fresh all-time high at the start of the month, shares of Amazon.com Inc NASDAQ: AMZN actually spent most of May on the back foot. In fact, for a while, it looked a little scary, especially as the broader market stayed buoyant.",https://www.marketbeat.com/stock-ideas/amazon-stock-breakout-potential-run-to-200/,marketbeat.com,5,despite setting fresh alltime high start month share amazoncom inc nasdaq amzn actually spent may back foot fact looked little scary especially broader market stayed buoyant,-0.1948,-0.0974,0.3760811111,-0.473481111,Negative Impact
07/06/2024,184.9,186.29,183.36,184.30,184.30,28021500,5.66,38.78057437,1.192,0,27.30545211,0.4577403224,0.2071825716,5.33,314.175,17133.13086,17985.63086,8245.400391,8001.799805,3051.279053,76693.35938,22007,182.5266006,158.0508,180.7847479,161.6123118,182.7625008,188.7746578,176.7503437,49.01576193,-0.221706405,-0.316957158,0.09525075324,3.299999782,174.4616914,11181257200,81.48441756,74.52383526,12.22000027,7 Reliable Stocks That Deliver Come Rain or Shine,"The stock market is unpredictable, and it is impossible to time it. Inflation, recession, low consumer spending and geopolitical issues can impact your investment portfolio.",https://investorplace.com/2024/06/7-reliable-stocks-that-deliver-come-rain-or-shine/,investorplace.com,6,stock market unpredictable impossible time inflation recession low consumer spending geopolitical issue impact investment portfolio,-0.5994,-0.35964,0.3495753846,-0.709215385,Negative Impact
10/06/2024,184.07,187.23,183.79,187.06,187.06,34494500,5.66,38.78057437,1.192,0,27.30545211,0.4577403224,0.2071825716,5.33,314.175,17192.5293,18037.5293,8228.5,7893.97998,3051.279053,76490.07813,22069.80078,182.6602005,158.3085,181.0308361,161.8655226,182.7415009,188.6868405,176.7961612,58.02921868,0.2036990271,-0.212825921,0.4165249479,3.303571429,175.1713895,11215751700,98.72755867,89.05503955,12.73999977,Better Artificial Intelligence Stock: Amazon vs. Alphabet,"The AI market is booming, projected to hit nearly $2 trillion by 2030. Amazon is expanding its AI capabilities through Amazon Web Services.",https://www.fool.com/investing/2024/06/10/better-artificial-intelligence-stock-amazon-vs-/,fool.com,7,ai market booming projected hit nearly trillion amazon expanding ai capability amazon web service,0.34,0.238,0.45120375,-0.21320375,Negative Impact
11/06/2024,187.06,187.77,184.54,187.23,187.23,27265100,5.66,38.78057437,1.192,0,27.30545211,0.4577403224,0.2071825716,5.33,314.175,17343.55078,17919.10938,8147.799805,7789.209961,3028.044922,76456.59375,21887.30078,182.7854004,158.58545,181.2739404,162.1179054,182.7745003,188.8158647,176.7331359,59.40094042,0.548233632,-0.06061401,0.6088476423,3.335001264,176.136078,11243016800,96.115049,92.10900841,12.85000038,"VCR: Fueled By Amazon, But Weighed Down By Tesla","Vanguard Consumer Discretionary ETF is a hold due to key risk factors, including competition dragging down Tesla and potential declines in consumer spending during recessions. VCR is a passively managed ETF with 303 holdings and $6.06B in AUM, focusing on broadline retail companies, automobile manufacturers, and restaurants. VCR has seen slightly lower returns compared to the S&P 500, has a low expense ratio, and average dividend yield.",https://seekingalpha.com/article/4698519-vcr-fueled-by-amazon-but-weighed-down-by-tesla,seekingalpha.com,6,vanguard consumer discretionary etf hold due key risk factor including competition dragging tesla potential decline consumer spending recession vcr passively managed etf holding b aum focusing broadline retail company automobile manufacturer restaurant vcr seen slightly lower return compared sp low expense ratio average dividend yield,-0.8228,-0.49368,0.08129363636,-0.574973636,Negative Impact
12/06/2024,188.02,188.35,185.43,186.89,186.89,33984200,5.66,38.78057437,1.192,0,27.30545211,0.4577403224,0.2071825716,5.33,314.175,17608.43945,18005.94922,8215.5,7864.700195,3037.468018,76606.57031,21961.59961,182.9094003,158.8536,181.494178,162.3643939,182.7654999,188.7803977,176.750602,58.53769071,0.7847982599,0.1084684438,0.6763298161,3.311430795,177.2994706,11209032600,89.91708836,94.91989868,12.03999996,Appeals Court Throws Out Order Barring Amazon From Firing Pro-Union Employees,"A Manhattan-based appeals court threw out a 2022 order Wednesday requiring Amazon to hold back from firing pro-union employees, according to court filings, after the judges on the panel previously expressed concerns about the specificity of the order.",https://www.forbes.com/sites/caileygleeson/2024/06/12/appeals-court-throws-out-order-barring-amazon-from-firing-pro-union-employees/,forbes.com,8,manhattanbased appeal court threw order wednesday requiring amazon hold back firing prounion employee according court filing judge panel previously expressed concern specificity order,-0.1779,-0.14232,0.285475,-0.427795,Negative Impact
13/06/2024,186.09,187.67,182.67,183.83,183.83,39721500,5.66,38.78057437,1.192,0,27.30545211,0.4577403224,0.2071825716,5.33,314.175,17667.56055,17923.41016,8163.700195,7708.02002,3028.918945,76810.89844,21698.09961,182.9378003,159.10705,181.5857789,162.577982,182.6574997,188.5038243,176.8111751,56.04348363,0.7170949777,0.2301937506,0.4869012272,3.334288461,178.6255349,11169311100,68.78452456,84.93888731,11.93999958,Amazon adds $230 million in cloud credits to AI startups,"Amazon said it is investing $230 million in the form of Amazon Web Service (AWS) credits in artificial intelligence startups, the latest example of cloud providers trying to capture AI clients from nascent stages.",https://www.reuters.com/technology/artificial-intelligence/amazon-adds-230-million-cloud-credits-ai-startups-2024-06-13/,reuters.com,10,amazon said investing million form amazon web service aws credit artificial intelligence startup latest example cloud provider trying capture ai client nascent stage,0.7964,0.7964,0.3512786667,0.4451213333,Positive Impact
14/06/2024,183.08,183.72,182.23,183.66,183.66,25456400,5.66,38.78057437,1.192,0,27.30545211,0.4577403224,0.2071825716,5.33,314.175,17688.88086,17817.25977,8146.899902,7503.27002,3032.633057,76992.77344,21639.09961,183.0110004,159.3508,181.6671211,162.7877534,182.6589996,188.5063901,176.8116092,56.3620642,0.6423179657,0.3126185936,0.3296993721,3.295717512,179.7924714,11143854700,67.61050495,75.43737262,12.65999985,Amazon hit with $122 mln US verdict in internet-advertising patent case,"Amazon must pay nearly $122 million for violating another company's rights in targeted internet advertising technology, a Texas federal jury said on Friday.",https://www.reuters.com/legal/litigation/amazon-hit-with-122-mln-us-verdict-internet-advertising-patent-case-2024-06-14/,reuters.com,10,amazon must pay nearly million violating another company right targeted internet advertising technology texas federal jury said friday,-0.4939,-0.4939,0.2299027273,-0.723802727,Negative Impact
17/06/2024,182.52,185.00,181.22,184.06,184.06,35601900,5.66,38.78057437,1.192,0,27.30545211,0.4577403224,0.2071825716,5.33,314.175,17857.01953,17902.25,8142.200195,7571.569824,3015.891113,76992.77344,21587.90039,182.9908002,159.59575,181.7609594,162.9994175,182.6269997,188.4342279,176.8197714,54.36672783,0.6083204698,0.3717589688,0.2365615009,3.369288853,180.8193756,11179456600,70.37289164,68.92264039,12.75,3 Stocks That Could Soon Follow Nvidia to the $3 Trillion Club,"While it is self-apparent that Fed's rate cuts lead to cheaper cost of capital, it matters why the rate cuts were implemented in the first place. If the underlying reasoning stems from a weakened economy, aimed at stimulating it, history suggests a market downturn is likely after rate cuts.",https://investorplace.com/2024/06/3-stocks-that-could-soon-follow-nvidia-to-the-3-trillion-club/,investorplace.com,6,selfapparent fed rate cut lead cheaper cost capital matter rate cut implemented first place underlying reasoning stem weakened economy aimed stimulating history suggests market downturn likely rate cut,-0.5574,-0.33444,0.3177472727,-0.652187273,Negative Impact
18/06/2024,183.74,184.29,181.43,182.81,182.81,36659200,5.66,38.78057437,1.192,0,27.30545211,0.4577403224,0.2071825716,5.33,314.175,17862.23047,17967.84961,8191.299805,7628.799805,3030.246094,77301.14063,21611.30078,182.9432001,159.81975,181.8020981,163.1965377,182.5904999,188.3827236,176.7982762,51.71812559,0.4750367283,0.3924145207,0.08262220756,3.392860413,188.3500061,11142797400,61.74030151,66.57456603,12.30000019,Amazon hit with $5.9 million fine as California says it failed to disclose quotas to workers,"Amazon.com Inc. has been fined $5.9 million by a California labor agency accusing the online retailer of failing to sufficiently disclose productivity quotas to employees at two warehouses in the state, in violation of a law intended to prevent worker injuries.",https://www.marketwatch.com/story/amazon-hit-with-5-9-million-fine-as-california-says-it-failed-to-disclose-quotas-to-workers-db03d462,marketwatch.com,8,amazoncom inc fined million california labor agency accusing online retailer failing sufficiently disclose productivity quota employee two warehouse state violation law intended prevent worker injury,-0.872,-0.6976,0.1540938462,-0.851693846,Negative Impact
20/06/2024,182.91,186.51,182.72,186.10,186.10,44726800,5.66,38.78057437,1.192,0,27.30545211,0.4577403224,0.2071825716,5.33,314.175,17721.58984,18015.94922,8272.5,7671.339844,3005.437012,77478.92969,21581.40039,182.9518002,160.05965,181.9706435,163.4244329,182.7380005,188.7367773,176.7392237,64.37659593,0.6276494446,0.4394615055,0.1881879391,3.402145386,188.2116058,11187524200,84.46133776,72.1915103,13.27999973,I Am Loading Up On These 8.5% Yielding REITs,High dividend yield typically indicates high risk. But there are exceptions. Here are 8%+ yielding REITs that I am buying.,https://seekingalpha.com/article/4699488-i-am-loading-up-on-these-8-5-percent-yielding-reits,seekingalpha.com,6,high dividend yield typically indicates high risk exception yielding reit buying,-0.2732,-0.16392,0.2318429412,-0.395762941,Negative Impact
21/06/2024,187.8,189.28,185.86,189.08,189.08,72931800,5.66,38.78057437,1.192,0,27.30545211,0.4577403224,0.2071825716,5.33,314.175,17689.35938,17995.68945,8237.700195,7628.569824,2998.137939,77209.89844,21554.90039,183.0144003,160.3187,182.2494419,163.6797122,183.0355003,189.6723587,176.3986419,76.68921335,0.9777855688,0.5471263182,0.4306592506,3.257144383,181.4299927,11260456000,98.50301692,81.56821873,13.19999981,Amazon Customers May Soon Be Asking Alexa How Much She's Charging to Help,Amazon is reportedly working on a major overhaul of Alexa that would include generative AI and involve a premium cost.,https://www.cnet.com/tech/services-and-software/amazon-customers-may-soon-be-asking-alexa-how-much-shes-charging-to-help/,cnet.com,5,amazon reportedly working major overhaul alexa would include generative ai involve premium cost,0.1779,0.08895,0.3963436364,-0.307393636,Negative Impact
24/06/2024,189.33,191.00,185.33,185.57,185.57,50610400,5.66,38.78057437,1.192,0,27.30545211,0.4577403224,0.2071825716,5.33,314.175,17496.82031,18126.68945,8281.599609,7706.890137,2963.099121,77341.07813,21848.59961,182.9448004,160.5697501,182.3796601,163.8975261,183.2615005,189.9214749,176.6015262,64.29422157,0.9609663257,0.6298943197,0.3310720061,3.463572911,181.5869928,11209845600,62.70608801,81.89014756,13.32999992,AMZN Stock Today: Why A Long-Term Bull Put Spread Places $125 In Your Pocket,Sticking to this stop loss level will help avoid large losses if the trade goes south.,https://www.investors.com/research/options/amzn-stock-today-why-a-long-term-bull-put-spread-places-125-in-your-pocket/,investors.com,5,sticking stop loss level help avoid large loss trade go south,-0.6486,-0.3243,0.3156847059,-0.639984706,Negative Impact
25/06/2024,186.81,188.84,185.42,186.34,186.34,45898500,5.66,38.78057437,1.192,0,27.30545211,0.4577403224,0.2071825716,5.33,314.175,17717.65039,18051,8247.799805,7662.299805,2949.996094,78053.52344,21788.5,182.9490002,160.8122,182.5349674,164.1208342,183.5410004,190.2263272,176.8556735,63.96649882,0.9982612979,0.7035677153,0.2946935826,3.466429574,181.9635131,11255744100,61.95915378,74.38941957,12.84000015,"GM's Cruise names former Amazon, Microsoft Xbox executive as new CEO","General Motors' Cruise autonomous vehicle unit on Tuesday announced Marc Whitten, a former Amazon and Microsoft executive, as its new CEO. His appointment comes at a crucial time for Cruise, as it attempts to relaunch its autonomous vehicles on public roadways after the company ceased operations weeks after an Oct. 2 accident.",https://www.cnbc.com/2024/06/25/gms-cruise-names-former-amazon-microsoft-xbox-executive-as-new-ceo.html,cnbc.com,9,general motor cruise autonomous vehicle unit tuesday announced marc whitten former amazon microsoft executive new ceo appointment come crucial time cruise attempt relaunch autonomous vehicle public roadway company ceased operation week oct accident,-0.34,-0.306,0.288012381,-0.594012381,Negative Impact
26/06/2024,186.92,194.80,186.26,193.61,193.61,65103900,5.66,38.78057437,1.192,0,27.30545211,0.4577403224,0.2071825716,5.33,314.175,17805.16016,17993.78906,8225.299805,7609.149902,2972.524902,78674.25,21793.90039,183.1488004,161.0891,182.9692825,164.4142588,184.1140007,192.1294838,176.0985176,70.28630217,1.596048169,0.8820638061,0.713984363,3.880001613,182.3249726,11320848000,91.23709661,71.96744613,12.55000019,"Amazon hits $2 trillion in valuation on AI fervor, rate cut bets","Amazon.com Inc hit $2 trillion in market value on Wednesday, becoming the fifth U.S. company to surpass that level as investors pile into technology-related stocks on optimism around artificial intelligence and potential interest rate cuts.",https://www.reuters.com/markets/us/amazon-hits-2-trillion-valuation-ai-fervor-rate-cut-bets-2024-06-26/,reuters.com,10,amazoncom inc hit trillion market value wednesday becoming fifth u company surpass level investor pile technologyrelated stock optimism around artificial intelligence potential interest rate cut,0.872,0.872,0.3682793333,0.5037206667,Positive Impact
27/06/2024,195.01,199.84,194.20,197.85,197.85,74397500,5.66,38.78057437,1.192,0,27.30545211,0.4577403224,0.2071825716,5.33,314.175,17858.67969,18009.08984,8179.700195,7530.720215,2945.852051,79243.17969,21942.19922,183.4394003,161.36285,183.5528403,164.7469528,184.9055008,194.9259161,174.8850855,70.78618128,2.38444518,1.182540081,1.201905099,4.059286935,183.0734744,11395245500,89.31261678,80.83628905,12.23999977,"Amazon hit with fresh class action-style suit in UK ÃÂÃÂ $3.4BN in competition damages sought for 200,000+ sellers","Amazon is facing another competition lawsuit in the UK. The latest claim, which was filed Thursday, is seeking more than ÃÂÃÂ£2.7BN in damages ÃÂÃÂ or around $3.4BN at current exchange rates ÃÂÃÂ before the UK's Competition Appeals Tribunal.",https://techcrunch.com/2024/06/27/amazon-hit-with-fresh-class-action-style-suit-in-uk-3-4bn-in-competition-damages-sought-for-200000-sellers/,techcrunch.com,5,amazon facing another competition lawsuit uk latest claim filed thursday seeking bn damage around bn current exchange rate uk competition appeal tribunal,-0.5267,-0.26335,0.2893304,-0.5526804,Negative Impact
28/06/2024,197.73,198.85,192.50,193.25,193.25,76930200,5.66,38.78057437,1.192,0,27.30545211,0.4577403224,0.2071825716,5.33,314.175,17732.59961,18026.5,8164.100098,7479.399902,2967.403076,79032.72656,21875.80078,183.6788004,161.6229501,183.933121,165.0305652,185.6020004,195.9198146,175.2841862,62.85550345,2.608009927,1.46763405,1.140375877,4.303573608,184.4147961,11318315300,64.60795883,81.71922407,12.43999958,7 Consumer Cyclical Stocks to Buy for the Starkly Lopsided Recovery,"While the economy may have bounced back on paper from the COVID-19 disaster, it's increasingly looking like we're headed toward a K-shaped recovery. Per Investopedia, this phenomenon refers to a recovery following a recession (or in this case an acute emergency) where ÃÂÃÂonly certain sectors, industries, or areas of the economy recover.",https://investorplace.com/2024/06/7-consumer-cyclical-stocks-to-buy-for-the-starkly-lopsided-recovery/,investorplace.com,6,economy may bounced back paper covid disaster increasingly looking like headed toward kshaped recovery per investopedia phenomenon refers recovery following recession case acute emergency certain sector industry area economy recover,-0.7096,-0.42576,0.294805,-0.720565,Negative Impact
01/07/2024,193.49,198.30,192.82,197.20,197.20,41192000,5.66,38.78057437,1.192,0,27.30545211,0.4577403224,0.2071825716,5.33,314.54,17879.30078,17957.05078,8166.799805,7561.129883,2994.72998,79476.1875,21875.80078,184.0384003,161.8847,184.4533907,165.350659,186.6400002,197.249773,176.0302274,64.08333845,3.068546053,1.787816451,1.280729603,4.449287415,185.6488122,11359507300,85.82169666,79.91409076,12.22000027,3 Warren Buffett Stocks That Are Screaming Buys for the Second Half of 2024 (and Beyond),"The Oracle of Omaha has delivered a nearly 4,964,000% aggregate return for his Class A (BRK.A) shareholders since becoming Berkshire Hathaway's CEO. For nearly six decades, Warren Buffett has had an uncanny ability to find phenomenal deals hiding in plain sight.",https://www.fool.com/investing/2024/07/01/3-warren-buffett-stocks-are-screaming-buy-for-2024/,fool.com,7,oracle omaha delivered nearly aggregate return class brka shareholder since becoming berkshire hathaway ceo nearly six decade warren buffett uncanny ability find phenomenal deal hiding plain sight,0.0258,0.01806,0.3261691667,-0.308109167,Negative Impact
02/07/2024,197.28,200.43,195.93,200.00,200.00,45600000,5.66,38.78057437,1.192,0,27.30545211,0.4577403224,0.2071825716,5.33,314.54,18028.75977,18028.16992,8121.200195,7538.290039,2997.010986,79441.45313,21953.80078,184.5458002,162.1611,185.0630616,165.6954286,187.7230003,199.1555146,176.290486,66.52861468,3.617757837,2.153804728,1.463953109,4.540000916,186.7841069,11405107300,97.76161964,82.73042504,12.02999973,"France Digital Ad Spending 2024: The Triopoly's Share Is Being Eroded Slightly, but Amazon Is Accounting for a Bigger Chunk","Dublin, July 02, 2024 (GLOBE NEWSWIRE) -- The ""France Digital Ad Spending 2024: Digital Advertising Is Recovering Rapidly as the Market Matures"" report has been added to ResearchAndMarkets.com's offering.",https://www.globenewswire.com/news-release/2024/07/02/2907227/28124/en/France-Digital-Ad-Spending-2024-The-Triopoly-s-Share-Is-Being-Eroded-Slightly-but-Amazon-Is-Accounting-for-a-Bigger-Chunk.html,globenewswire.com,5,dublin july globe newswire france digital ad spending digital advertising recovering rapidly market matures report added researchandmarketscoms offering,0,0,0.295593,-0.295593,Negative Impact
03/07/2024,199.94,200.03,196.76,197.59,197.59,31597900,5.66,38.78057437,1.192,0,27.30545211,0.4577403224,0.2071825716,5.33,314.54,18188.30078,18091.65039,8171.100098,7632.080078,2982.375977,79986.79688,22223.69922,184.9530002,162.4471,185.554314,166.0127875,188.6355003,200.1636448,177.1073558,63.14496038,3.814572955,2.485958373,1.328614582,4.565000262,188.1486955,11373509400,85.2160458,89.59978737,12.09000015,Australia spy agency moves intelligence data to cloud in Amazon deal,Australia will move its top secret intelligence data to the cloud under a A$2 billion deal with Amazon Web Services that Defence Minister Richard Marles said would boost defence force interoperability with the United States.,https://www.reuters.com/world/asia-pacific/australia-spy-agency-moves-intelligence-data-cloud-amazon-deal-2024-07-04/,reuters.com,10,australia move top secret intelligence data cloud billion deal amazon web service defence minister richard marles said would boost defence force interoperability united state,0.8979,0.8979,0.2964616667,0.6014383333,Positive Impact
05/07/2024,198.65,200.55,198.17,200.00,200.00,39858900,5.66,38.78057437,1.192,0,27.30545211,0.4577403224,0.2071825716,5.33,314.54,18352.75977,18098.90039,8203.900391,7675.620117,2949.933105,79996.60156,22059,185.3622003,162.7472,186.1208115,166.3509687,189.5715004,201.6134671,177.5295336,70.18726209,4.117552922,2.812277283,1.305275639,4.419286455,189.3768252,11413368300,97.15466632,93.37744392,12.47999954,Amazon Stock Is Up 27% This Year. Where Will It Be by the End of 2024?,"Amazon had a great start to the year, with high sales growth and massive profit growth. It's making major investments in AI.",https://www.fool.com/investing/2024/07/05/amazon-stock-is-up-23-this-year-where-will-it-be-b/,fool.com,7,amazon great start year high sale growth massive profit growth making major investment ai,0.9169,0.64183,0.2731544444,0.3686755556,Positive Impact
08/07/2024,200.04,201.20,197.96,199.29,199.29,34767300,5.66,38.78057437,1.192,0,27.30545211,0.4577403224,0.2071825716,5.33,314.54,18403.74023,18087.86914,8193.5,7627.450195,2922.449951,79960.38281,22126.09961,185.8162003,163.0555,186.63725,166.6787202,190.2860001,202.8694718,177.7025283,69.25349243,4.251367996,3.100095426,1.151272571,4.536428179,190.7176065,11378601000,90.44042007,90.93704406,12.36999989,Wall Street Favors These Four ETFs With Stellar Ratings,"When it comes to investing, individual exchange-traded funds (ETFs) aren't a one-size-fits-all financial vehicle as there are plenty of funds to choose from and the number of long-term possibilities in the ETF market continues to grow year-over-year.",https://247wallst.com/investing/2024/07/08/wall-street-favors-these-four-etfs-with-stellar-ratings/,247wallst.com,5,come investing individual exchangetraded fund etf arent onesizefitsall financial vehicle plenty fund choose number longterm possibility etf market continues grow yearoveryear,0.0772,0.0386,0.400555,-0.361955,Negative Impact
09/07/2024,199.4,200.57,199.05,199.34,199.34,32700100,5.66,38.78057437,1.192,0,27.30545211,0.4577403224,0.2071825716,5.33,314.54,18429.28906,18048.58008,8139.799805,7508.660156,2959.37207,80351.64063,22042.5,186.3296002,163.37575,187.1353969,167.003708,191.0379997,203.9095554,178.1664441,68.98607219,4.311749076,3.342426156,0.9693229201,4.375,192.1851412,11411301100,90.59180471,92.7289637,12.51000023,Prediction: 2 Stocks That Will Be Worth More Than Nvidia 5 Years From Now,"If Alphabet were valued the same way as its peers, it would already be worth more than Nvidia. Amazon must continue growing and improving margins if it wants to catch Nvidia.",https://www.fool.com/investing/2024/07/09/prediction-2-stocks-that-will-be-worth-more-than-n/,fool.com,7,alphabet valued way peer would already worth nvidia amazon must continue growing improving margin want catch nvidia,0.8519,0.59633,0.255637,0.340693,Positive Impact
10/07/2024,200,200.11,197.69,199.79,199.79,32883800,5.66,38.78057437,1.192,0,27.30545211,0.4577403224,0.2071825716,5.33,314.54,18647.44922,18215.17969,8193.5,7573.549805,2939.364014,79924.77344,22350.19922,186.7330002,163.7280499,187.6316556,167.3299397,191.6744995,204.9698152,178.3791839,71.52635409,4.34581664,3.543104253,0.8027123877,4.343571254,193.447221,11444184900,92.37010829,91.13411102,12.85000038,"NBA agrees to terms on new 11-year, $76 billion rights deal with Disney, NBC, Amazon","The NBA has agreed to terms on its new media deal, an 11-year agreement worth $76 billion that assures player salaries will continue rising for the foreseeable future and one that will surely change how some viewers access the game for years to come.",https://www.marketwatch.com/story/nba-agrees-to-terms-on-new-11-year-76-billion-rights-deal-with-disney-nbc-amazon-c60e6695,marketwatch.com,8,nba agreed term new medium deal year agreement worth billion assures player salary continue rising foreseeable future one surely change viewer access game year come,0.886,0.7088,0.2792792308,0.4295207692,Positive Impact
11/07/2024,200.09,200.27,192.86,195.05,195.05,44565000,5.66,38.78057437,1.192,0,27.30545211,0.4577403224,0.2071825716,5.33,314.54,18283.41016,18379.74023,8223.299805,7627.129883,2970.386963,79897.34375,22544.09961,187.0148001,164.0577,187.9225712,167.6057612,192.0654999,205.2701125,178.8608873,60.94399252,3.944863897,3.623456181,0.3214077155,4.602143424,201.1999969,11399619900,61.24766359,81.4031922,12.92000008,Amazon ÃÂÃÂvery disappointed' by fall in grocery code compliance score,"Amazon.com Inc (NASDAQ:AMZN) said it is ÃÂÃÂvery disappointedÃÂÃÂ by the result of the Grocery Code Adjudicator's latest survey, which showed that less than half of polled suppliers believe they are treated fairly by the US e-commerce giant. The GCA threatened Amazon with a formal investigation after only 47% of suppliers to Amazon believed that it consistently or mostly complies with the Groceries Supply Code of Practice.",https://www.proactiveinvestors.co.uk/companies/news/1051717,proactiveinvestors.co.uk,5,amazoncom inc nasdaqamzn said disappointed result grocery code adjudicator latest survey showed less half polled supplier believe treated fairly u ecommerce giant gca threatened amazon formal investigation supplier amazon believed consistently mostly complies grocery supply code practice,-0.5719,-0.28595,0.2181561905,-0.50410619,Negative Impact
12/07/2024,194.8,196.47,193.83,194.49,194.49,30598500,5.66,38.78057437,1.192,0,27.30545211,0.4577403224,0.2071825716,5.33,314.54,18398.44922,18505.91992,8252.900391,7724.319824,2971.294922,80519.34375,22673.5,187.4046002,164.3738,188.1801176,167.8732662,192.4455002,205.4590392,179.4319612,57.03145762,3.541099248,3.606984795,-0.065885546,4.546429225,201.033197,11369021400,57.71900744,70.4455931,12.46000004,ÃÂÃÂBig Short' investor Steve Eisman says shorting current market would be ÃÂÃÂinsanity',ÃÂÃÂBig Short' investor Steve Eisman has said ÃÂÃÂthere's no fundamental case to be massively shortÃÂÃÂ in the current stock market and said it would be ÃÂÃÂinsanityÃÂÃÂ to start shorting stocks like Nvidia.,https://www.marketwatch.com/story/big-short-investor-steve-eisman-says-shorting-current-market-would-be-insanity-2a33506b,marketwatch.com,8,big short investor steve eisman said there fundamental case massively short current stock market said would insanity start shorting stock like nvidia,-0.296,-0.2368,0.2771838462,-0.513983846,Negative Impact
15/07/2024,194.56,196.19,190.83,192.72,192.72,40683200,5.66,38.78057437,1.192,0,27.30545211,0.4577403224,0.2071825716,5.33,314.54,18472.57031,18525.08984,8183,7632.709961,2974.010986,80664.85938,22751.69922,187.6790002,164.7075,188.3581522,168.1204974,192.8900002,205.2556561,180.5243442,59.73317691,3.043208095,3.494229455,-0.45102136,4.524286543,200.8697331,11328338200,46.26111291,55.07592798,13.11999989,7 Stocks for a Second-Half Surge,All seven stocks are primed to move higher in the second half of 2024.,https://www.fool.com/investing/2024/07/15/7-stocks-for-a-second-half-surge/,fool.com,7,seven stock primed move higher second half,0,0,0.3245040909,-0.324504091,Negative Impact
16/07/2024,195.59,196.62,192.24,193.02,193.02,33994700,5.66,38.78057437,1.192,0,27.30545211,0.4577403224,0.2071825716,5.33,314.54,18509.33984,18781.2207,8164.899902,7580.029785,2976.303955,80716.54688,22995.40039,187.8450003,165.0427,188.54097,168.3682536,193.3580002,204.9362326,181.7797678,59.21125665,2.642373866,3.323858337,-0.681484471,4.592857361,200.4681438,11362332900,45.24771527,49.74261187,13.18999958,"Amazon warehouse workers get injured because of Prime Day rushes, according to a Senate report",Amazon's Prime Day is a major contributor to warehouse worker injuries. That's according to a new report from a US Senate committee.,https://www.businessinsider.com/amazon-warehouse-workers-get-injured-during-prime-day-senate-report-2024-7,businessinsider.com,7,amazon prime day major contributor warehouse worker injury thats according new report u senate committee,-0.2732,-0.19124,0.3087744444,-0.500014444,Negative Impact
17/07/2024,191.35,191.58,185.99,187.93,187.93,48076100,5.66,38.78057437,1.192,0,27.30545211,0.4577403224,0.2071825716,5.33,314.54,17996.91992,18712.48047,8187.5,7570.810059,2962.85498,80716.54688,22851.19922,187.8794,165.3524499,188.5170101,168.5628978,193.5514999,204.5923335,182.5106664,41.66666294,1.892176621,3.037521994,-1.145345373,4.48499952,200.0826182,11314256800,12.7546895,34.75450589,14.47999954,Amazon wins UK union battle but faces legal challenge over union-busting tactics,"Amazon.com Inc (NASDAQ:AMZN) has won its UK unionisation battle by a tiny margin, with the GMB union saying the tech giant ""fought dirty"" with a ""culture of fear"" and the battle ""is not over"". Out of the 2,600 workers who voted at the Coventry warehouse site, 49.5% backed union recognition.",https://www.proactiveinvestors.co.uk/companies/news/1052103,proactiveinvestors.co.uk,5,amazoncom inc nasdaqamzn uk unionisation battle tiny margin gmb union saying tech giant fought dirty culture fear battle worker voted coventry warehouse site backed union recognition,-0.91,-0.455,0.1241840741,-0.579184074,Negative Impact
18/07/2024,189.59,189.68,181.45,183.75,183.75,51043600,5.66,38.78057437,1.192,0,27.30545211,0.4577403224,0.2071825716,5.33,314.54,17871.2207,18513.74023,8204.900391,7586.549805,2977.133057,81343.46094,22726.80078,187.7804001,165.6355999,188.3300685,168.7140133,193.5985001,204.4532383,182.7437618,29.27689887,0.9494052713,2.619898649,-1.670493378,4.627856663,199.2370614,11263213200,11.64558507,23.21599661,15.93000031,"Don't buy the dip as the summer slump is officially here, says Goldman strategist","A modest bounce for the Nasdaq Composite could be in the making for Thursday, following the worst one-day percentage drop for the tech index, as a recent rotation out of its biggest companies got amped by concerns the U.S. would hit tech companies with more China restrictions.",https://www.marketwatch.com/story/dont-buy-the-dip-as-the-summer-slump-is-officially-here-says-goldman-strategist-0fa63c56,marketwatch.com,8,modest bounce nasdaq composite could making thursday following worst oneday percentage drop tech index recent rotation biggest company got amped concern u would hit tech company china restriction,-0.8074,-0.64592,0.1826685714,-0.828588571,Negative Impact
19/07/2024,181.14,184.93,180.11,183.13,183.13,43081800,5.66,38.78057437,1.192,0,27.30545211,0.4577403224,0.2071825716,5.33,314.54,17726.93945,18406.05078,8155.700195,7534.52002,2982.309082,80604.64844,22690.40039,187.6678003,165.9039499,188.1261444,168.857456,193.45,204.8063459,182.0936541,33.1558052,0.1504890161,2.126016723,-1.975527707,4.518569946,197.8140962,11220131400,14.31960549,12.90662668,16.52000046,Why Amazon stock is crashing,"As the month of July unfolds, Amazon (NASDAQ: AMZN) shares have failed to sustain the momentum that has previously led it to a new all-time high (ATH), raising questions about the reasons for such a poor performance of the company's stocks in recent days.",https://finbold.com/why-amazon-stock-is-crashing/,finbold.com,5,month july unfolds amazon nasdaq amzn share failed sustain momentum previously led new alltime high ath raising question reason poor performance company stock recent day,-0.5423,-0.27115,0.212939,-0.484089,Negative Impact
22/07/2024,185,185.06,182.48,182.55,182.55,39931900,5.66,38.78057437,1.192,0,27.30545211,0.4577403224,0.2071825716,5.33,314.54,18007.57031,18539.14063,8198.799805,7622.02002,2964.216064,80502.07813,22872.69922,187.5588004,166.1930999,187.9074722,168.9937002,193.1235001,205.3509267,180.8960735,22.53470844,-0.52342545,1.596128288,-2.119553738,4.311427525,196.0436867,11180199500,11.56947779,12.51155611,14.90999985,"Jeff Bezos Is Selling $5B of Amazon Stock. Why You Should Sell Some, Too.","Amazon (NASDAQ: AMZN ) is an e-commerce and cloud-computing juggernaut, and the share price fully reflects this. Amazon stock fails to reflect the company's weak areas.",https://investorplace.com/2024/07/jeff-bezos-is-selling-5b-of-amazon-stock-why-you-should-sell-some-too/,investorplace.com,6,amazon nasdaq amzn ecommerce cloudcomputing juggernaut share price fully reflects amazon stock fails reflect company weak area,-0.2732,-0.16392,0.2712009091,-0.435120909,Negative Impact
23/07/2024,184.1,189.39,183.56,186.41,186.41,47537700,5.66,38.78057437,1.192,0,27.30545211,0.4577403224,0.2071825716,5.33,314.54,17997.34961,18518.33984,8167.399902,7598.629883,2915.368896,80429.03906,22813.80078,187.4970004,166.4901499,187.848748,169.1669968,193.1654999,205.2890118,181.041988,25.49586918,-0.737535875,1.129395456,-1.86693133,4.478570121,194.4503181,11227737200,29.8719969,18.58702672,14.72000027,"Italy seizes 121 mln euros from Amazon unit over alleged tax, labour offences","Italy's tax police have seized some 121 million euros from an Italian unit of e-commerce giant Amazon as part of an investigation into alleged tax fraud and illegal labour practices, prosecutors' documents showed on Tuesday.",https://www.reuters.com/technology/italy-seizes-121-mln-euros-amazon-unit-over-alleged-tax-labour-offences-2024-07-23/,reuters.com,10,italy tax police seized million euro italian unit ecommerce giant amazon part investigation alleged tax fraud illegal labour practice prosecutor document showed tuesday,-0.7717,-0.7717,0.2359435,-1.0076435,Negative Impact
24/07/2024,183.2,185.45,180.41,180.83,180.83,41532400,5.66,38.78057437,1.192,0,27.30545211,0.4577403224,0.2071825716,5.33,314.54,17342.41016,18308.41992,8153.700195,7513.72998,2901.951904,80148.88281,22639.59961,187.3640005,166.7644999,187.573503,169.2830466,192.8900002,205.8856418,179.8943585,22.88027582,-1.342009592,0.6351144461,-1.977124038,4.673569815,193.0162863,11186204800,3.413946637,14.95180711,18.04000092,ÃÂÃÂMagnificent Seven' stocks near correction territory as $1.7 trillion in value erased,"The megacap group was on track for its worst day since October 2022, according to Dow Jones data.",https://www.marketwatch.com/story/magnificent-seven-stocks-near-correction-territory-as-1-7-trillion-in-value-erased-5add4623,marketwatch.com,8,megacap group track worst day since october according dow jones data,-0.6249,-0.49992,0.1256966667,-0.625616667,Negative Impact
25/07/2024,182.91,183.90,176.80,179.85,179.85,44464200,5.66,38.78057437,1.192,0,27.30545211,0.4577403224,0.2071825716,5.33,314.54,17181.7207,18344.46094,8186.399902,7427.02002,2886.741943,80039.79688,22608,187.2296005,167.02395,187.2706208,169.3881904,192.2020004,206.4351567,177.9688442,15.81270264,-1.878482852,0.1323949865,-2.010877838,4.969282968,191.7256578,11141740600,12.50001563,15.26198639,18.45999908,3 Top Retail Stocks to Consider to Ring Up Big Gains,"On July 23, CNBC's Jim Cramer said that U.S. consumers, on the whole, are tired of the elevated prices being charged by some firms. As a result, ÃÂÃÂThey are pushing back on high prices, they are demanding bargains,ÃÂÃÂ he stated.",https://investorplace.com/2024/07/3-top-retail-stocks-to-consider-to-ring-up-big-gains/,investorplace.com,6,july cnbcs jim cramer said u consumer whole tired elevated price charged firm result pushing back high price demanding bargain stated,-0.5859,-0.35154,0.2166784615,-0.568218462,Negative Impact
26/07/2024,180.39,183.19,180.24,182.50,182.50,29506000,5.66,38.78057437,1.192,0,27.30545211,0.4577403224,0.2071825716,5.33,314.54,17357.88086,18564.48047,8285.700195,7517.680176,2890.896973,81332.71875,22814.80078,187.1382004,167.29515,187.0835376,169.5186562,191.4345001,206.0359832,176.8330171,23.27284386,-2.065993923,-0.307282795,-1.758711127,4.976426261,189.9345792,11171246600,23.97978933,13.2979172,16.38999939,"No, Amazon isn't texting you. It's a scam","There is another scam circulating that's mimicking a major brand. If you get a message regarding your Amazon Prime account, it could be a bad actor trying to target you.",https://www.foxbusiness.com/lifestyle/no-amazon-isnt-texting-you-its-scam,foxbusiness.com,5,another scam circulating thats mimicking major brand get message regarding amazon prime account could bad actor trying target,-0.7579,-0.37895,0.23261,-0.61156,Negative Impact
29/07/2024,183.84,184.75,182.38,183.20,183.20,33270100,5.66,38.78057437,1.192,0,27.30545211,0.4577403224,0.2071825716,5.33,314.54,17370.19922,18539.36914,8292.400391,7443.839844,2891.844971,81355.84375,22779.59961,187.0824002,167.56375,186.9312419,169.6547889,190.932,205.9560269,175.907973,24.82843372,-2.133520003,-0.672530237,-1.460989766,5.037139893,188.3584301,11204516700,27.26882643,21.2495438,16.60000038,Temu and Shein's soaring popularity has Wall Street eyeing China's influence on tech earnings,"Earnings reports from Amazon, Meta and eBay could all raise questions about the ongoing impact of discount retailers Temu and Shein. The two China-linked companies have seen huge growth in the U.S. thanks to a marketing blitz and rock-bottom prices.",https://www.cnbc.com/2024/07/29/temu-shein-soaring-popularity-could-hit-amazon-meta-ebay-earnings.html,cnbc.com,9,earnings report amazon meta ebay could raise question ongoing impact discount retailer temu shein two chinalinked company seen huge growth u thanks marketing blitz rockbottom price,0.8176,0.73584,0.3911107692,0.3447292308,Positive Impact
30/07/2024,184.72,185.86,179.38,181.71,181.71,39508600,5.66,38.78057437,1.192,0,27.30545211,0.4577403224,0.2071825716,5.33,314.54,17147.41992,18580.58008,8274.400391,7474.939941,2879.300049,81455.39844,22824.69922,187.0440002,167.81315,186.7264876,169.7747414,190.1575005,205.4162303,174.8987706,22.68882189,-2.280971054,-0.9942184,-1.286752654,5.327139718,186.9714188,11165008100,20.92033833,24.05631803,17.69000053,Amazon is suing a group on Telegram it says orchestrated $1.2 million in fraudulent refunds while taking a cut,"Amazon says a criminal group is responsible for more than 10,000 items stolen through fraudulent refunds. A lawsuit also names seven US defendants who are said to have used and promoted the illegal service.",https://www.businessinsider.com/amazon-suing-refund-fraud-group-it-says-stole-10000-items-2024-7,businessinsider.com,7,amazon say criminal group responsible item stolen fraudulent refund lawsuit also name seven u defendant said used promoted illegal service,-0.8591,-0.60137,0.2568633333,-0.858233333,Negative Impact
31/07/2024,185.05,187.94,184.46,186.98,186.98,41667300,5.66,38.78057437,1.192,0,27.30545211,0.4577403224,0.2071825716,5.33,314.54,17599.40039,18710.00977,8368,7531.490234,2938.749023,81741.34375,23110.80078,187.0896002,168.0864,186.7364291,169.9459379,189.5065002,204.0933197,174.9196808,38.00176409,-1.950103425,-1.185395405,-0.76470802,5.242853437,176.8000031,11206675400,51.36224395,33.18380291,16.36000061,"Amazon accountable for product recalls, US rules","Amazon.com Inc (NASDAQ:AMZN) has been told it is now required to handle the recalls of unsafe products sold on its site, according to a recent ruling by US regulators. The US Consumer Product Safety Commission (CPSC) decided that Amazon's current alert system was inadequate in ensuring customers stopped using dangerous items.",https://www.proactiveinvestors.co.uk/companies/news/1053062,proactiveinvestors.co.uk,5,amazoncom inc nasdaqamzn told required handle recall unsafe product sold site according recent ruling u regulator u consumer product safety commission cpsc decided amazon current alert system inadequate ensuring customer stopped using dangerous item,0.0258,0.0129,0.3832542857,-0.370354286,Negative Impact
01/08/2024,189.29,190.60,181.87,184.07,184.07,70435600,5.66,38.78057437,1.192,0,27.30545211,0.4577403224,0.2071825716,5.33,314.796,17194.15039,18493.23047,8283.400391,7370.450195,2932.386963,81867.54688,22723.19922,187.1002005,168.3578001,186.6318635,170.0864759,188.8305008,203.0894276,174.571574,35.51972173,-1.900789076,-1.328474139,-0.572314937,5.677854265,177.022803,11136239800,36.68015733,36.3209132,18.59000015,Amazon projects quarterly revenue below estimates,"Amazon.com forecast current-quarter revenue largely below Wall Street estimates on Thursday, signaling tepid demand for its cloud computing services as businesses keep a tight lid on costs against an uncertain economic backdrop.",https://www.reuters.com/technology/amazon-projects-quarterly-revenue-below-estimates-2024-08-01/,reuters.com,10,amazoncom forecast currentquarter revenue largely wall street estimate thursday signaling tepid demand cloud computing service business keep tight lid cost uncertain economic backdrop,-0.4019,-0.4019,0.230523438,-0.632423438,Negative Impact
02/08/2024,166.75,168.77,160.55,167.90,167.90,141448400,5.66,38.78057437,1.192,0,27.30545211,0.4577403224,0.2071825716,5.33,314.796,16776.16016,18162.25977,8174.700195,7251.799805,2905.337891,80981.95313,22227.59961,186.7952005,168.53455,185.8972804,170.0647199,187.2255005,203.3013969,171.1496041,25.36718941,-3.130406666,-1.688860645,-1.441546021,6.974997384,190.6000061,10994791400,20.37702374,36.13980834,23.38999939,Amazon shares tumble 12% after third-quarter outlook disappoints,"Amazon shares tumbled on Friday, a day after the company reported a revenue miss and disappointing guidance for the second quarter. The company is navigating slower sales in its core retail business, and said the chaotic news cycle was partly to blame for its weak forecast.",https://www.cnbc.com/2024/08/02/amazon-stock-down-12percent-after-third-quarter-outlook-disappoints.html,cnbc.com,9,amazon share tumbled friday day company reported revenue miss disappointing guidance second quarter company navigating slower sale core retail business said chaotic news cycle partly blame weak forecast,-0.8329,-0.74961,0.05694666667,-0.806556667,Negative Impact
05/08/2024,154.21,162.96,151.61,161.02,161.02,83149400,5.66,38.78057437,1.192,0,27.30545211,0.4577403224,0.2071825716,5.33,314.796,16200.08008,17725.17969,8008.200195,7148.990234,2860.697998,78759.39844,22227.59961,186.3530005,168.6823,184.921701,169.9747227,185.312001,204.2051078,166.4188942,21.9100931,-4.606939201,-2.272476356,-2.334462845,7.825711932,190.6000061,10911642000,23.54266544,26.8666155,38.56999969,"Magnificent Seven set to shed $1 trillion in value, led by Apple, Nvidia",Apple and Nvidia led a sell-off in technology stocks on Monday as U.S. recession fears and Berkshire Hathaway's decision to cut its stake in the iPhone maker punctured a months-long rally in the sector.,https://www.reuters.com/technology/magnificent-seven-set-shed-1-trillion-value-led-by-apple-nvidia-2024-08-05/,reuters.com,10,apple nvidia led selloff technology stock monday u recession fear berkshire hathaway decision cut stake iphone maker punctured monthslong rally sector,-0.7964,-0.7964,0.2222241667,-1.018624167,Negative Impact
06/08/2024,161.71,165.08,158.54,161.93,161.93,59950800,5.66,38.78057437,1.192,0,27.30545211,0.4577403224,0.2071825716,5.33,314.796,16366.84961,17922.55078,8026.700195,7130.040039,2867.283936,78593.07031,21979.40039,185.9706003,168.8513,184.0200653,169.8946756,183.4415009,203.8348346,163.0481671,25.36942908,-5.638674287,-2.945715942,-2.692958345,7.790712629,189.0404059,10971592800,26.46830113,23.46266343,27.70999908,Four Stocks That Look Like Long-Term Bargains,"There's flip side of the market's nasty summer decline. We've identified a handful of beaten-up stocks to buy, including Amazon, Nvidia, AMD, and Adobe.",https://www.barrons.com/articles/amazon-stock-nvidia-stock-bargains-d0941d77,barrons.com,9,there flip side market nasty summer decline weve identified handful beatenup stock buy including amazon nvidia amd adobe,-0.4404,-0.39636,0.1665090909,-0.562869091,Negative Impact
07/08/2024,166.55,167.58,161.43,162.77,162.77,48408200,5.66,38.78057437,1.192,0,27.30545211,0.4577403224,0.2071825716,5.33,314.796,16195.80957,17838.81055,8166.899902,7266.009766,2869.833984,79468.00781,21881,185.6110004,169.02315,183.1867296,169.8237834,181.5905014,202.4508485,160.7301543,28.78234818,-6.315745873,-3.619721928,-2.696023944,7.64214216,187.5431897,11020001000,28.62272914,26.2112319,27.85000038,Jim Cramer reveals the only retail stocks worth investing in,"After the banking giant Barclays announced it is downgrading the entire retail sector to ÃÂÃÂneutral' due to it not seeing much gross margin and, by extension, stock market growth potential within it, Jim Cramer had only a very succinct reaction to offer.",https://finbold.com/jim-cramer-reveals-the-only-retail-stocks-worth-investing-in/,finbold.com,5,banking giant barclays announced downgrading entire retail sector neutral due seeing much gross margin extension stock market growth potential within jim cramer succinct reaction offer,-0.128,-0.064,0.342005,-0.406005,Negative Impact
08/08/2024,165.17,166.69,162.55,165.80,165.80,44616200,5.66,38.78057437,1.192,0,27.30545211,0.4577403224,0.2071825716,5.33,314.796,16660.01953,18186.11914,8145,7247.450195,2869.900879,78886.21875,22225.59961,185.2840005,169.2263,182.5048972,169.7837458,180.1280014,201.1161455,159.1398573,33.28831717,-6.532531448,-4.202283832,-2.330247616,7.593571254,186.1058621,11064617200,36.3939483,30.49499286,23.79000092,Amazon Stock Analysis: Should You Buy AMZN on the Dip?,"When writing about Amazon (NASDAQ: AMZN ) before earnings, I rightly predicted that the stock could go down as much as 10% after earnings. But I didn't anticipate a full-blown global market crash.",https://investorplace.com/2024/08/amazon-stock-analysis-should-you-buy-amzn-on-the-dip/,investorplace.com,6,writing amazon nasdaq amzn earnings rightly predicted stock could go much earnings didnt anticipate fullblown global market crash,-0.25,-0.15,0.3083213043,-0.458321304,Negative Impact
09/08/2024,166.4,168.55,165.85,166.94,166.94,36401000,5.66,38.78057437,1.192,0,27.30545211,0.4577403224,0.2071825716,5.33,314.796,16745.30078,18267.15039,8168.100098,7269.709961,2862.194092,79705.90625,22311.30078,184.9824005,169.4282001,181.8945092,169.7554498,178.7505013,199.3830837,158.1179188,35.10779131,-6.536992771,-4.66922562,-1.867767151,7.605713981,184.7260277,11101018200,39.31777295,34.77815013,20.37000084,"Got $5,000? 2 Tech Stocks to Buy and Hold for the Long Term",Countless stocks have plunged after a market downturn. Nvidia's stock price is 20% lower than its all-time high.,https://www.fool.com/investing/2024/08/09/got-5000-2-tech-stocks-to-buy-and-hold-for-the-lon/,fool.com,7,countless stock plunged market downturn nvidias stock price lower alltime high,-0.296,-0.2072,0.2656466667,-0.472846667,Negative Impact
12/08/2024,168.14,168.55,166.11,166.80,166.80,30072800,5.66,38.78057437,1.192,0,27.30545211,0.4577403224,0.2071825716,5.33,314.796,16780.60938,18206.39063,8210.299805,7250.669922,2858.205078,79648.92188,22398.90039,184.7320004,169.6194001,181.3025677,169.7260424,177.4545013,197.6439545,157.2650481,29.86237619,-6.477160508,-5.030812598,-1.446347911,7.291428702,183.4013866,11070945400,38.95870813,38.22347646,20.70999908,Why Amazon Could Be Worth $4 Trillion By 2030,"Amazon's future growth potential is often underestimated due to its size, but its unique position in leading growth industries sets it apart. Amazon's online store, 3P sales, advertising, subscriptions, and AWS segments all contribute to its potential $4 trillion valuation by 2030. A sum-of-the-parts valuation approach projects steady growth and profitability across all segments, supporting a 'Strong Buy' rating for Amazon stock.",https://seekingalpha.com/article/4713800-why-amazon-could-be-worth-4-trillion-by-2030,seekingalpha.com,6,amazon future growth potential often underestimated due size unique position leading growth industry set apart amazon online store p sale advertising subscription aws segment contribute potential trillion valuation sumoftheparts valuation approach project steady growth profitability across segment supporting strong buy rating amazon stock,0.9442,0.56652,0.1589833333,0.4075366667,Positive Impact
13/08/2024,167.81,171.04,167.10,170.23,170.23,39237900,5.66,38.78057437,1.192,0,27.30545211,0.4577403224,0.2071825716,5.33,314.796,17187.60938,18402.31055,8235.200195,7275.870117,2867.946045,78956.03125,22618.19922,184.6078003,169.8636001,180.8683492,169.7310569,176.3150009,195.3446508,157.2853511,38.61192731,-6.082851935,-5.241220465,-0.84163147,7.165713719,182.1297311,11110183300,47.75581558,42.01076555,18.12000084,3 Beaten-Down Tech Stocks Worth Buying Now: August 2024,There's a tech wreck going on in the market right now. The Nasdaq Composite index that is mostly comprised of tech stocks is down 10% over the last month and officially in a correction.,https://investorplace.com/2024/08/3-beaten-down-tech-stocks-worth-buying-now-august-2024/,investorplace.com,6,there tech wreck going market right nasdaq composite index mostly comprised tech stock last month officially correction,-0.4404,-0.26424,0.2247066667,-0.488946667,Negative Impact
14/08/2024,172.11,172.28,168.86,170.10,170.10,28843800,5.66,38.78057437,1.192,0,27.30545211,0.4577403224,0.2071825716,5.33,314.796,17192.59961,18498.08984,8281.099609,7333.359863,2850.654053,79105.88281,22760,184.4430005,170.1162501,180.4460613,169.734728,175.4235016,193.8221782,157.024825,39.33025552,-5.714970009,-5.335970374,-0.378999635,6.902857099,180.9089419,11081339500,47.42242341,44.71231571,16.19000053,Here's Why Amazon (AMZN) is a Strong Value Stock,"Whether you're a value, growth, or momentum investor, finding strong stocks becomes easier with the Zacks Style Scores, a top feature of the Zacks Premium research service.",https://www.zacks.com/stock/news/2321971/here-s-why-amazon-amzn-is-a-strong-value-stock?cid=CS-STOCKNEWSAPI-FT-tale_of_the_tape|zacks_education_value_score-2321971,zacks.com,8,whether youre value growth momentum investor finding strong stock becomes easier zacks style score top feature zacks premium research service,0.8979,0.71832,0.34282,0.3755,Positive Impact
15/08/2024,174.86,177.91,173.99,177.59,177.59,51698500,5.66,38.78057437,1.192,0,27.30545211,0.4577403224,0.2071825716,5.33,314.796,17594.5,18706.51953,8347.400391,7423.370117,2877.35791,79105.88281,23032.69922,184.4080005,170.3655001,180.3340587,169.8128899,175.1155014,193.129499,157.1015038,45.14149049,-4.764123467,-5.221600992,0.4574775253,7.222142901,179.7369843,11133038000,66.63244952,53.93689617,15.22999954,3 Billionaire Stocks to Buy From the Latest Stock Market Correction,"The market losses in the first three days of August provided a tremendous opportunity for stocks to buy now. Between the July 31st close and the August 5th close, the S&P 500 lost 6.1%.",https://investorplace.com/2024/08/3-billionaire-stocks-to-buy-from-the-latest-stock-market-correction/,investorplace.com,6,market loss first three day august provided tremendous opportunity stock buy july st close august th close sp lost,-0.2023,-0.12138,0.2765323077,-0.397912308,Negative Impact
16/08/2024,177.04,178.34,176.26,177.06,177.06,31489200,5.66,38.78057437,1.192,0,27.30545211,0.4577403224,0.2071825716,5.33,314.796,17631.7207,18753.76953,8311.400391,7449.700195,2879.429932,80436.84375,23054.59961,184.3236005,170.5872501,180.2056642,169.8850004,174.812001,192.4582386,157.1657635,43.90388527,-4.007145327,-4.978709859,0.9715645321,7.201429095,178.6119049,11101548800,65.27312994,59.77600096,14.80000019,EV maker Rivian halts production of Amazon delivery vans amid parts shortage,"Rivian has temporarily suspended production of its commercial delivery vans used by retail giant Amazon.com due to a shortage of parts, a spokesperson for the electric vehicle manufacturer said on Friday.",https://www.reuters.com/business/autos-transportation/ev-maker-rivian-halts-production-amazon-delivery-vans-amid-parts-shortage-2024-08-16/,reuters.com,10,rivian temporarily suspended production commercial delivery van used retail giant amazoncom due shortage part spokesperson electric vehicle manufacturer said friday,-0.6249,-0.6249,0.2121381818,-0.837038182,Negative Impact
19/08/2024,177.64,178.30,176.16,178.22,178.22,31129800,5.66,38.78057437,1.192,0,27.30545211,0.4577403224,0.2071825716,5.33,314.796,17876.76953,18882.03906,8356.900391,7484.169922,2893.674072,80424.67969,23116.40039,184.1880005,170.8129001,180.127795,169.9679357,174.5955009,191.9457712,157.2452307,46.51208398,-3.275869908,-4.638141869,1.362271961,6.891429356,151.6100006,11132678600,68.24826074,66.71794673,14.64999962,How Temu Upset Its Chinese Suppliers in Battle With Amazon,The e-commerce company has thrived in the U.S. but is now finding it more to continue that success in a country where shoppers are more accustomed to higher-quality goods.,https://www.barrons.com/articles/temu-stock-retailers-china-amazon-b997aa9f,barrons.com,9,ecommerce company thrived u finding continue success country shopper accustomed higherquality good,0.765,0.6885,0.36102125,0.32747875,Positive Impact
20/08/2024,177.92,179.01,177.43,178.88,178.88,26255200,5.66,38.78057437,1.192,0,27.30545211,0.4577403224,0.2071825716,5.33,314.796,17816.93945,18802.24023,8273.299805,7485.72998,2866.660889,80802.85938,23037.40039,184.0796005,171.0223001,180.0788621,170.056613,174.219001,190.7995278,157.6384743,41.08322698,-2.61295161,-4.233103817,1.620152207,6.559286935,152.1438007,11158933800,69.94101162,67.82080076,15.88000011,Amazon-backed Anthropic hit with class-action lawsuit over copyright infringement,"Anthropic, the Amazon-backed AI startup, on Monday was hit with a class-action lawsuit in California federal court over alleged copyright infringement. Three authors said in the filing that Anthropic ""built a multibillion-dollar business by stealing hundreds of thousands of copyrighted books,"" including their own.",https://www.cnbc.com/2024/08/20/amazon-backed-anthropic-hit-with-class-action-lawsuit-over-copyright-infringement.html,cnbc.com,9,anthropic amazonbacked ai startup monday hit classaction lawsuit california federal court alleged copyright infringement three author said filing anthropic built multibilliondollar business stealing hundred thousand copyrighted book including,-0.8271,-0.74439,0.066198,-0.810588,Negative Impact
21/08/2024,179.92,182.39,178.89,180.11,180.11,35599100,5.66,38.78057437,1.192,0,27.30545211,0.4577403224,0.2071825716,5.33,314.796,17918.99023,18902.5,8283.400391,7524.720215,2856.583984,80905.29688,23121.69922,183.9406006,171.2325001,180.0800832,170.1566467,174.1830009,190.7061171,157.6598848,45.47324076,-1.965674633,-3.77961798,1.813943347,6.186428615,153.2184484,11194532900,92.59259626,76.92728954,16.27000046,"India minister accuses Amazon, e-commerce firms of predatory pricing",India's commerce minister accused Amazon and other e-commerce companies of predatory pricing practices and said the sector's rapid rise should not disrupt millions of brick-and-mortar stores operating in the country.,https://www.reuters.com/world/india/india-minister-accuses-amazon-e-commerce-firms-predatory-pricing-2024-08-21/,reuters.com,10,india commerce minister accused amazon ecommerce company predatory pricing practice said sector rapid rise disrupt million brickandmortar store operating country,-0.128,-0.128,0.328635,-0.456635,Negative Impact
22/08/2024,181.38,181.47,175.68,176.13,176.13,32047500,5.66,38.78057437,1.192,0,27.30545211,0.4577403224,0.2071825716,5.33,314.796,17619.34961,18850.84961,8288,7524.109863,2848.771973,81053.1875,23037.5,183.7186008,171.4201501,179.9251782,170.2160831,173.9970009,190.3342199,157.6597818,63.0428243,-1.753640483,-3.374422481,1.620781998,4.920000349,154.9687415,11162485400,79.6621353,80.73191439,17.54999924,"Amazon must face D.C.'s antitrust lawsuit, appeals court rules","An appeals court in Washington, D.C. revived the district's lawsuit against Amazon.com Inc on Thursday, saying it plausibly claimed the online retailer's pricing policies illegally stifle competition.",https://www.reuters.com/legal/amazon-must-face-dcs-antitrust-lawsuit-appeals-court-rules-2024-08-22/,reuters.com,10,appeal court washington dc revived district lawsuit amazoncom inc thursday saying plausibly claimed online retailer pricing policy illegally stifle competition,-0.2263,-0.2263,0.3661192857,-0.592419286,Negative Impact
23/08/2024,177.34,178.97,175.24,177.04,177.04,29150100,5.66,38.78057437,1.192,0,27.30545211,0.4577403224,0.2071825716,5.33,314.796,17877.78906,19093.48047,8327.799805,7577.040039,2854.36792,81086.21094,23286.09961,183.5216006,171.60665,179.8120337,170.2839827,173.7240005,189.6400016,157.8079995,81.31355851,-1.494940687,-2.998526122,1.503585435,4.022857666,156.6140169,11191635500,77.56811432,83.27428196,15.85999966,Amazon's $51 Billion Secret Weapon Is Hiding in Plain Sight,Amazon is primarily known for its online retail and cloud computing. The company is also one of the world's largest digital advertisers.,https://www.fool.com/investing/2024/08/23/amazons-51-billion-secret-weapon-is-hiding-in-plai/,fool.com,7,amazon primarily known online retail cloud computing company also one world largest digital advertiser,0.1779,0.12453,0.476756,-0.352226,Negative Impact
26/08/2024,176.7,177.47,174.30,175.50,175.50,22366200,5.66,38.78057437,1.192,0,27.30545211,0.4577403224,0.2071825716,5.33,314.796,17725.76953,19100.40039,8327.799805,7590.370117,2855.52002,81698.10938,23349,183.3550006,171.7706,179.6429343,170.3358834,173.3390007,188.6509214,158.02708,75.88711856,-1.398067768,-2.678434451,1.280366684,3.782142639,158.1605759,11169269300,67.12787604,74.78604189,16.14999962,3 Stocks Mega Investors Are Buying Right Now,"During the past two weeks, investors have scrutinized the stock market closely, especially as the S&P 500 just recovered from one of its worst selloffs in 2024. There is doubt as to whether any investment in the stock market can be safe today and whether diversifying or concentrating portfolios can be the better choice to navigate this volatility.",https://www.marketbeat.com/stock-ideas/3-stocks-mega-investors-are-buying-right-now/,marketbeat.com,5,past two week investor scrutinized stock market closely especially sp recovered one worst selloff doubt whether investment stock market safe today whether diversifying concentrating portfolio better choice navigate volatility,-0.2023,-0.10115,0.22689,-0.32804,Negative Impact
27/08/2024,174.15,174.89,172.25,173.12,173.12,29842000,5.66,38.78057437,1.192,0,27.30545211,0.4577403224,0.2071825716,5.33,314.796,17754.82031,19119.31055,8345.5,7565.779785,2848.730957,81711.75781,23260,183.1442004,171.9257999,179.3871328,170.363586,172.9095001,187.7059837,158.1130165,68.64866292,-1.496095724,-2.441966706,0.9458709816,3.574999128,159.6143413,11139427300,53.27617952,65.99072329,15.43000031,"Investors Heavily Search Amazon.com, Inc. (AMZN): Here is What You Need to Know","Amazon (AMZN) has been one of the stocks most watched by Zacks.com users lately. So, it is worth exploring what lies ahead for the stock.",https://www.zacks.com/stock/news/2327488/investors-heavily-search-amazon-com-inc-amzn-here-is-what-you-need-to-know?cid=CS-STOCKNEWSAPI-FT-tale_of_the_tape|most_searched_stocks-2327488,zacks.com,8,amazon amzn one stock watched zackscom user lately worth exploring lie ahead stock,0.3818,0.30544,0.39725,-0.09181,Negative Impact
28/08/2024,173.69,173.69,168.92,170.80,170.80,29045000,5.66,38.78057437,1.192,0,27.30545211,0.4577403224,0.2071825716,5.33,314.796,17556.0293,19064.42969,8343.900391,7577.669922,2837.428955,81785.5625,23127,182.8790005,172.0767999,179.0503826,170.3679285,172.1005005,185.3457751,158.8552259,59.24558008,-1.740919323,-2.301757229,0.5608379066,3.619999477,160.9808808,11110382300,29.92744231,50.11049929,17.11000061,These Are Warren Buffett's Favorite Artificial Intelligence (AI) Stocks,Apple plans to lock in more users with its generative AI services. Amazon provides the cloud infrastructure for a lot of AI applications.,https://www.fool.com/investing/2024/08/28/warren-buffett-fave-artificial-intelligence-stock/,fool.com,7,apple plan lock user generative ai service amazon provides cloud infrastructure lot ai application,0.1779,0.12453,0.3966111111,-0.272081111,Negative Impact
29/08/2024,173.22,174.29,170.81,172.12,172.12,26407800,5.66,38.78057437,1.192,0,27.30545211,0.4577403224,0.2071825716,5.33,314.796,17516.42969,19149.53906,8379.599609,7640.950195,2823.105957,82134.60938,23227.5,182.6652005,172.2195999,178.7786027,170.385362,171.5029999,183.4935077,159.5124921,59.51506991,-1.807594634,-2.20292471,0.3953300759,3.672855922,162.2654279,11136790100,36.91643094,40.04001759,15.64999962,Amazon workers join Teamsters' unfair labor practices strikes in US,"Amazon.com workers were organizing to join Teamsters' strikes in several U.S. states over unfair labor practices, the labor union said on Thursday.",https://www.reuters.com/markets/us/amazon-workers-join-teamsters-unfair-labor-practices-strikes-us-2024-08-29/,reuters.com,10,amazoncom worker organizing join teamster strike several u state unfair labor practice labor union said thursday,-0.34,-0.34,0.21935,-0.55935,Negative Impact
30/08/2024,172.78,178.90,172.60,178.50,178.50,43429400,5.66,38.78057437,1.192,0,27.30545211,0.4577403224,0.2071825716,5.33,314.796,17713.61914,19292.23047,8376.599609,7630.950195,2842.214111,82365.77344,23346.19922,182.5132004,172.3991499,178.7676771,170.4661046,172.0330002,184.2871223,159.778878,67.48358629,-1.330287499,-2.028397268,0.698109769,3.982855661,163.4729022,11180219500,74.55852781,47.13413369,15,Forget Nvidia: Billionaire Daniel Loeb Has 31% of His $8.7 Billion Portfolio in Just 4 Unstoppable Artificial Intelligence (AI) Stocks Instead,"Hedge fund Third Point has more than $2.6 billion invested in just four AI stocks -- and none of them are Nvidia. Loeb has been clear about the potential of AI, calling the technology ""transformational.",https://www.fool.com/investing/2024/08/30/forget-nvidia-billionaire-daniel-loeb-has-31-of-hi/,fool.com,7,hedge fund third point billion invested four ai stock none nvidia loeb clear potential ai calling technology transformational,-0.2924,-0.20468,0.3012184615,-0.505898462,Negative Impact
03/09/2024,177.55,178.26,175.26,176.25,176.25,37817500,5.66,38.78057437,1.192,0,27.30545211,0.4577403224,0.2071825716,5.13,315.301,17136.30078,19017.41992,8298.5,7575.100098,2802.979004,82555.4375,23042.5,182.2566003,172.5513999,178.6689447,170.5236558,172.7945,184.0164338,161.5725662,59.32467943,-1.120656125,-1.846849039,0.7261929143,3.911428179,164.607928,11142402000,54.61936479,55.36477452,20.71999931,Prediction: Amazon Stock Will Soar Over the Next 5 Years. Here's 1 Reason Why.,"Rather than focusing on near-term profits, Amazon has often prioritized expanding its operational footprint and laying the foundations for long-term wins. The business has been seeing some very promising trends on the profitability front.",https://www.fool.com/investing/2024/09/03/prediction-amazon-stock-will-soar-over-the-next-5/,fool.com,7,rather focusing nearterm profit amazon often prioritized expanding operational footprint laying foundation longterm win business seeing promising trend profitability front,0.9042,0.63294,0.30502,0.32792,Positive Impact
04/09/2024,174.48,175.98,172.54,173.33,173.33,30309200,5.66,38.78057437,1.192,0,27.30545211,0.4577403224,0.2071825716,5.13,315.301,17084.30078,19001.91992,8269.599609,7500.970215,2784.278076,82352.64063,23040.80078,182.0118002,172.7020499,178.4595743,170.5515797,173.3645004,183.3532022,163.3757987,54.60507452,-1.176578337,-1.712794899,0.5362165618,3.932143075,165.6748523,11112092800,32.73944516,53.97244592,21.31999969,Is It Time to Buy August's Worst-Performing Dow Jones Stocks?,Intel's malaise continued in August despite a rebound on reports of a potential spin-off. Chevron stock slipped on disappointing earnings and anxiety over its pending acquisition of Hess.,https://www.fool.com/investing/2024/09/04/time-buy-august-worst-performing-dow-jones-stocks/,fool.com,7,intels malaise continued august despite rebound report potential spinoff chevron stock slipped disappointing earnings anxiety pending acquisition hess,-0.5994,-0.41958,0.2074825,-0.6270625,Negative Impact
05/09/2024,175,179.88,175.00,177.89,177.89,40170500,5.66,38.78057437,1.192,0,27.30545211,0.4577403224,0.2071825716,5.13,315.301,17127.66016,18878.01953,8241.700195,7431.959961,2788.313965,82201.15625,22988.30078,181.8428003,172.8773499,178.4372381,170.6245988,174.1205002,182.9550419,165.2859585,50.46671335,-0.843223247,-1.538880569,0.6956573217,3.842143467,166.6777611,11152263300,66.59243064,51.3170802,19.89999962,Amazon challenges US labor board's structure in lawsuit over union election,Amazon.com filed a lawsuit on Thursday accusing a U.S. labor board of illegally interfering in a union election at a New York City warehouse and claiming the agency's structure violates the U.S. Constitution.,https://www.reuters.com/legal/amazon-challenges-us-labor-boards-structure-lawsuit-over-union-election-2024-09-05/,reuters.com,10,amazoncom filed lawsuit thursday accusing u labor board illegally interfering union election new york city warehouse claiming agency structure violates u constitution,-0.7096,-0.7096,0.2375328571,-0.947132857,Negative Impact
06/09/2024,177.24,178.38,171.16,171.39,171.39,41466500,5.66,38.78057437,1.192,0,27.30545211,0.4577403224,0.2071825716,5.13,315.301,16690.83008,18663.14063,8181.5,7352.299805,2765.806885,81183.92969,22781.40039,181.3984003,173.0084,178.1608758,170.6322147,174.4,182.444559,166.355441,42.56100417,-1.090956743,-1.449295803,0.3583390603,4.209286281,167.6204954,11110796800,18.33705269,39.22297616,22.37999916,"Why Meta Platforms, Amazon, Alphabet, and Other ""Magnificent Seven"" Stocks Slumped on Friday","The Federal Reserve has been trying to thread the needle between controlling inflation and keeping the economy out of recession. The monthly jobs report had many of the elements investors had hoped for, but also contained a few ugly surprises.",https://www.fool.com/investing/2024/09/06/meta-platforms-amazon-alphabet-tesla-generative-ai/,fool.com,7,federal reserve trying thread needle controlling inflation keeping economy recession monthly job report many element investor hoped also contained ugly surprise,-0.34,-0.238,0.2771583333,-0.515158333,Negative Impact
09/09/2024,174.53,175.85,173.51,175.40,175.40,29037400,5.66,38.78057437,1.192,0,27.30545211,0.4577403224,0.2071825716,5.13,315.301,16884.59961,18859.68945,8270.799805,7425.259766,2736.488037,81559.53906,23027.19922,180.9494,173.1547499,178.0526059,170.6796553,174.8229996,182.0656476,167.5803515,46.55760496,-0.952731781,-1.349982999,0.3972512179,4.37500109,168.5066657,11139834200,48.10686815,44.34545049,19.45000076,"With new Amazon Web Services partnership, Oracle's cloud database trade-off is complete",Oracle announced a strategic partnership with Amazon Web Services on Monday afternoon that will further integrate its database offerings and cloud infrastructure with the Seattle tech giant's cloud platform.,https://www.geekwire.com/2024/with-new-amazon-web-services-partnership-oracles-cloud-database-trade-off-is-complete/,geekwire.com,5,oracle announced strategic partnership amazon web service monday afternoon integrate database offering cloud infrastructure seattle tech giant cloud platform,0.1779,0.08895,0.3563509091,-0.267400909,Negative Impact
10/09/2024,177.49,180.50,176.79,179.55,179.55,36233800,5.66,38.78057437,1.192,0,27.30545211,0.4577403224,0.2071825716,5.13,315.301,17025.88086,18822.2207,8206,7407.549805,2744.191895,81921.28906,23003.09961,180.6754001,173.333,178.1113274,170.7679175,175.4604996,181.9333372,168.9876619,50.7536543,-0.502523667,-1.180491133,0.6779674656,4.626429967,169.3396657,11176068000,78.91613897,48.45335327,19.07999992,How Amazon Stock Passed Alphabet as 4th Largest in S&P 500 With an Assist From Oracle,The retail/cloud company has avoided a September selloff so far.,https://www.barrons.com/articles/amazon-stock-price-oracle-alphabet-bc0c2fe7,barrons.com,9,retailcloud company avoided september selloff far,-0.34,-0.306,0.2930645,-0.5990645,Negative Impact
11/09/2024,180.1,184.99,175.73,184.52,184.52,42564700,5.66,38.78057437,1.192,0,27.30545211,0.4577403224,0.2071825716,5.13,315.301,17395.5293,18866.63086,8193.900391,7396.830078,2721.794922,81523.15625,23211.19922,180.4218002,173.5220499,178.362648,170.9047541,176.175,183.335123,169.014877,54.57564456,0.2523975872,-0.893913389,1.146310976,5.037145342,170.1226857,11218632700,97.07528932,74.69943215,17.69000053,"EXCLUSIVE: Is Apple 'Falling Behind' Rivals Like Amazon, Alphabet? WisdomTree's Christopher Gannatti Weighs In","In the tech world, staying ahead of the pack is always the name of the game, but Apple Inc's AAPL playing a different one.",https://www.benzinga.com/trading-ideas/long-ideas/24/09/40812228/exclusive-is-apple-falling-behind-rivals-like-amazon-alphabet-wisdomtrees-christopher-ga,benzinga.com,5,tech world staying ahead pack always name game apple inc aapl playing different one,0.2023,0.10115,0.4019215385,-0.300771538,Negative Impact
12/09/2024,184.8,187.41,183.54,187.00,187.00,33622500,5.66,38.78057437,1.192,0,27.30545211,0.4577403224,0.2071825716,5.13,315.301,17569.67969,18987.90039,8241,7435.069824,2717.123047,82962.71094,23475.09961,180.1618002,173.7233499,178.7013677,171.0649058,177.0199997,185.0922335,168.9477659,61.64061004,1.0388182,-0.507367071,1.546185271,4.900002616,171.3120713,11252255200,97.78256603,91.25799811,17.06999969,Report: Amazon and Flipkart Broke India's Competition Laws,"Amazon and Walmart-owned Flipkart have reportedly been accused of violating India's antitrust laws. An investigation found that the two eCommerce rivals broke the competition rules by prioritizing select sellers on their websites, Reuters reported Thursday (Sept.",https://www.pymnts.com/antitrust/2024/report-amazon-and-flipkart-broke-indias-competition-laws/,pymnts.com,5,amazon walmartowned flipkart reportedly accused violating india antitrust law investigation found two ecommerce rival broke competition rule prioritizing select seller website reuters reported thursday sept,-0.7783,-0.38915,0.2131822222,-0.602332222,Negative Impact
13/09/2024,187,188.50,185.91,186.49,186.49,26495400,5.66,38.78057437,1.192,0,27.30545211,0.4577403224,0.2071825716,5.13,315.301,17683.98047,19121.5,8273.099609,7465.25,2704.090088,82890.9375,23568.69922,179.9398004,173.91715,179.0068045,171.2183894,177.4650002,186.5830581,168.3469422,60.20740624,1.602437998,-0.085406057,1.687844056,4.818574088,172.9218645,11225759800,89.7344519,94.86410242,16.55999947,Is Amazon Angling To Buy TikTok? The Two Companies' Ties Deepen,"Asthe January deadline approaches for TikTok to be sold to an American firm or face a nationwide ban, the Chinese-owned social media giant is quietly deepening its ties to a major company that is central to Americans' daily life, and one of its biggest rivals: Amazon. It's a strategic move that will make it harder to shut down TikTok here, industry insiders told Forbes.",https://www.forbes.com/sites/alexandralevine/2024/09/13/amazon-tiktok-ban-acquisition-bytedance/,forbes.com,8,asthe january deadline approach tiktok sold american firm face nationwide ban chineseowned social medium giant quietly deepening tie major company central american daily life one biggest rival amazon strategic move make harder shut tiktok industry insider told forbes,-0.4404,-0.35232,0.18827375,-0.54059375,Negative Impact
16/09/2024,185.29,185.81,183.36,184.89,184.89,26065500,5.66,38.78057437,1.192,0,27.30545211,0.4577403224,0.2071825716,5.13,315.301,17592.13086,19256.38086,8278.400391,7449.439941,2704.090088,82988.78125,23702.09961,179.6376004,174.10645,179.237518,171.3544253,177.8565002,187.5552391,168.1577613,60.12945118,1.898123246,0.3112998034,1.586823442,4.815717425,174.7912408,11199694300,81.56281781,89.69327858,17.13999939,Amazon Files Lawsuit Targeting Allegedly False Trademark Infringement Notices,Amazon's Counterfeit Crimes Unit filed a lawsuit against companies and individuals it alleged obtained invalid trademarks or filed fake complaints to have Amazon remove their competitors from the Amazon store.,https://www.pymnts.com/amazon/2024/amazon-files-lawsuit-targeting-allegedly-false-trademark-infringement-notices/,pymnts.com,5,amazon counterfeit crime unit filed lawsuit company individual alleged obtained invalid trademark filed fake complaint amazon remove competitor amazon store,-0.765,-0.3825,0.2011108696,-0.58361087,Negative Impact
17/09/2024,186.85,189.45,186.14,186.88,186.88,26091700,5.66,38.78057437,1.192,0,27.30545211,0.4577403224,0.2071825716,5.13,315.301,17628.06055,19225.7793,8309.900391,7487.419922,2704.090088,83079.65625,23677.69922,179.3894006,174.30925,179.5372234,171.5089087,178.2895004,188.7961702,167.7828307,64.96955214,2.266901319,0.7024201066,1.564481213,4.909288679,176.4362919,11225786000,87.48177195,86.25968055,17.61000061,"Microsoft Vs. Amazon: Stock Charts Signal Trouble, But Wall Street Sees AI-Fueled Growth","As Microsoft Corp MSFT and Amazon.com Inc AMZN head for a potential Death Cross on their stock charts, a fierce competition between the two tech giants rages on.",https://www.benzinga.com/trading-ideas/technicals/24/09/40908395/microsoft-vs-amazon-stock-charts-signal-trouble-but-wall-street-sees-ai-fueled-growth,benzinga.com,5,microsoft corp msft amazoncom inc amzn head potential death cross stock chart fierce competition two tech giant rage,-0.8176,-0.4088,0.2611516667,-0.669951667,Negative Impact
18/09/2024,186.45,188.80,185.06,186.43,186.43,34448100,5.66,38.78057437,1.192,0,27.30545211,0.4577403224,0.2071825716,5.13,315.301,17573.30078,19195.56055,8253.700195,7444.899902,2717.281006,82948.22656,23592.59961,179.1312006,174.5109499,179.8075281,171.6573772,178.6669998,189.7876001,167.5463995,67.72509131,2.494097966,1.060755679,1.433342288,4.835717337,178.2582106,11191337900,83.79825981,84.28094986,18.22999954,"Amazon raises pay of hourly workers in fulfillment, transport ops",Amazon.com said on Wednesday it is increasing the base pay of hourly workers in its fulfillment and transportation operations by $1.50 to more than $22 per hour.,https://www.reuters.com/business/retail-consumer/amazon-raises-pay-hourly-workers-fulfillment-transport-ops-2024-09-18/,reuters.com,10,amazoncom said wednesday increasing base pay hourly worker fulfillment transportation operation per hour,-0.1027,-0.1027,0.3197275,-0.4224275,Negative Impact
19/09/2024,190.04,190.99,188.47,189.87,189.87,39543200,5.66,38.78057437,1.192,0,27.30545211,0.4577403224,0.2071825716,5.13,315.301,18013.98047,19432.41992,8328.700195,7615.410156,2736.021973,83184.79688,23866.30078,178.9328006,174.7251499,180.2021346,171.8385973,179.1549995,191.3471782,166.9628209,69.20579048,2.918094418,1.432223426,1.485870991,4.912147522,179.8250607,11230881100,94.35194013,88.54399063,16.32999992,"Amazon raises pay for fulfillment and transportation workers by $1.50 an hour, adds Prime membership as benefit","Amazon.com Inc. is raising pay for fulfillment and transportation workers by $1.50 an hour starting this month, raising the base wage to more than $22 an hour, or $3,000 a year on average for full-time employees who work a 40-hour week.",https://www.marketwatch.com/story/amazon-raises-pay-for-fulfilment-and-transportation-workers-by-1-50-an-hour-adds-prime-membership-as-benefit-92f59967,marketwatch.com,8,amazoncom inc raising pay fulfillment transportation worker hour starting month raising base wage hour year average fulltime employee work hour week,-0.1027,-0.08216,0.4299490909,-0.512109091,Negative Impact
20/09/2024,190.23,191.84,187.41,191.60,191.60,100378600,5.66,38.78057437,1.192,0,27.30545211,0.4577403224,0.2071825716,5.13,315.301,17948.32031,19373.74023,8230,7500.259766,2736.813965,84544.3125,23867.40039,178.8638007,174.95895,180.64911,172.0352282,179.9284996,193.2254747,166.6315245,65.76034318,3.355037307,1.816786203,1.538251105,4.744289943,181.6114519,11331259700,98.83950523,92.32990172,16.14999962,"Amazon.com, Inc. (AMZN) is Attracting Investor Attention: Here is What You Should Know","Amazon (AMZN) has received quite a bit of attention from Zacks.com users lately. Therefore, it is wise to be aware of the facts that can impact the stock's prospects.",https://www.zacks.com/stock/news/2339025/amazon-com-inc-amzn-is-attracting-investor-attention-here-is-what-you-should-know?cid=CS-STOCKNEWSAPI-FT-tale_of_the_tape|most_searched_stocks-2339025,zacks.com,8,amazon amzn received quite bit attention zackscom user lately therefore wise aware fact impact stock prospect,0.7184,0.57472,0.1935116667,0.3812083333,Positive Impact
23/09/2024,191.64,194.45,190.57,193.88,193.88,36993100,5.66,38.78057437,1.192,0,27.30545211,0.4577403224,0.2071825716,5.13,315.301,17974.26953,19445.42969,8259.700195,7508.080078,2748.917969,84928.60938,23894.69922,178.8516006,175.19395,181.1679686,172.2525892,180.7705002,195.3665853,166.1744151,71.19499098,3.841017681,2.221632498,1.619385182,4.790003095,183.4525899,11368252800,97.55263104,96.91469213,15.89000034,"These ""Magnificent Seven"" Stocks Are Brilliant Artificial Intelligence (AI) Buys",Four of the Magnificent Seven offer the growth needed to justify buying the stocks today. These companies are poised to grow earnings by as much as 40% annually.,https://www.fool.com/investing/2024/09/23/these-magnificent-seven-stocks-are-brilliant-artif/,fool.com,7,four magnificent seven offer growth needed justify buying stock today company poised grow earnings much annually,0.8176,0.57232,0.2627109091,0.3096090909,Positive Impact
24/09/2024,194.27,195.37,190.13,193.96,193.96,43478900,5.66,38.78057437,1.192,0,27.30545211,0.4577403224,0.2071825716,5.13,315.301,18074.51953,19506.55078,8282.799805,7604.009766,2863.125977,84914.03906,23952.19922,178.8764008,175.44115,181.6696171,172.4685834,181.6935005,197.1929973,166.1940038,76.61934018,4.184381166,2.614182232,1.570198934,4.899287633,185.6520713,11411731700,94.17600619,96.85604749,15.39000034,"Apple iPhone To Fuel 96% Of 2025 Revenue, Analyst Says: A Safer Bet Than AI-Heavy Amazon, Alphabet, Microsoft, Meta?",Needham analyst Laura Martin reiterated a buy rating on Apple Inc AAPL and a $260 price target.,https://www.benzinga.com/news/24/09/41005053/apple-iphone-to-fuel-96-of-2025-revenue-analyst-says-a-safer-bet-than-ai-heavy-amazon-alphabet-micro,benzinga.com,5,needham analyst laura martin reiterated buy rating apple inc aapl price target,0,0,0.276766,-0.276766,Negative Impact
25/09/2024,193.75,193.95,192.16,192.53,192.53,26391100,5.66,38.78057437,1.192,0,27.30545211,0.4577403224,0.2071825716,5.13,315.301,18082.21094,19381.17969,8268.700195,7565.620117,2896.305908,85169.86719,23905.90039,178.8666006,175.6693999,182.0955145,172.6681995,182.6640007,198.3329488,166.9950526,70.55022822,4.291638179,2.949673421,1.341964758,4.560001918,187.595656,11385340600,88.26932119,93.33265281,15.40999985,American Eagle sues Amazon over alleged 'knock-offs' of Aerie products,American Eagle Outfitters filed a lawsuit against Amazon alleging the company infringed on its Aerie trademarks. The complaint accuses Amazon of knowingly deceiving shoppers by featuring Aerie branding in its sponsored ads and organic search results.,https://www.cnbc.com/2024/09/25/american-eagle-sues-amazon-over-trademark-infringement-of-aerie-line.html,cnbc.com,9,american eagle outfitter filed lawsuit amazon alleging company infringed aerie trademark complaint accuses amazon knowingly deceiving shopper featuring aerie branding sponsored ad organic search result,-0.6705,-0.60345,0.06942363636,-0.672873636,Negative Impact
26/09/2024,194.31,194.53,189.54,191.16,191.16,36334900,5.66,38.78057437,1.192,0,27.30545211,0.4577403224,0.2071825716,5.13,315.301,18190.28906,19501.7207,8284.900391,7742.089844,3000.952881,85836.11719,24033.80078,178.9312009,175.8881,182.4509846,172.8521975,183.6820007,198.7390979,168.6249036,82.42043444,4.217476534,3.203234044,1.01424249,4.400716509,189.1505239,11349005700,80.74111922,87.72881553,15.36999989,Amazon Accused in Suit of Touting American Eagle Knock-Offs,"American Eagle Outfitters has reportedly filed a trademark infringement suit against Amazon. The suit alleges that Amazon used branding from the clothing retailer's Aerie line of apparel in search results, directing shoppers to ÃÂÃÂinferior quality knock-offs,ÃÂÃÂ CNBC reported Wednesday (Sept.",https://www.pymnts.com/news/retail/2024/amazon-accused-in-suit-of-touting-american-eagle-knock-offs/,pymnts.com,5,american eagle outfitter reportedly filed trademark infringement suit amazon suit alleges amazon used branding clothing retailer aerie line apparel search result directing shopper inferior quality knockoff cnbc reported wednesday sept,-0.5267,-0.26335,0.3170616667,-0.580411667,Negative Impact
27/09/2024,190.68,190.90,187.34,187.97,187.97,36002300,5.66,38.78057437,1.192,0,27.30545211,0.4577403224,0.2071825716,5.13,315.301,18119.58984,19501.2207,8320.799805,7791.790039,3087.529053,85571.85156,23956.80078,179.0156009,176.0985,182.6674166,173.0026234,184.474501,198.6095465,170.3394556,71.18299411,3.856837141,3.333954663,0.5228824778,4.355002267,195.3699951,11313003400,62.32182217,77.11075419,16.95999908,Amazon Stock Was a Once-in-a-Generation Investment Opportunity Thanks to 1 Underappreciated Trait. Here's an $80 Billion Company That Surprisingly Hopes to Follow in Its Footsteps.,"Many people believe Amazon was successful because it was early to the e-commerce scene, but founder Jeff Bezos has a different perspective on its success. The co-founder of one $80 billion business is starting to talk like Bezos and he has billions of dollars at his disposal to make his dreams a reality.",https://www.fool.com/investing/2024/09/27/amazon-stock-was-a-once-in-a-generation-investment/,fool.com,7,many people believe amazon successful early ecommerce scene founder jeff bezos different perspective success cofounder one billion business starting talk like bezos billion dollar disposal make dream reality,0.9136,0.63952,0.3148271429,0.3246928571,Positive Impact
30/09/2024,187.14,188.49,184.65,186.33,186.33,41583900,5.66,38.78057437,1.192,0,27.30545211,0.4577403224,0.2071825716,5.13,315.301,18189.16992,19516.43945,8237,7635.75,3336.49707,84299.78125,24000.40039,179.0796008,176.29275,182.8110474,173.1352342,184.8660011,198.735547,170.9964552,62.48157262,3.399506188,3.347064968,0.05244121985,4.265002659,195.2093951,11271419500,53.97151952,65.67815364,16.72999954,Billionaire Philippe Laffont Sold 72% of Coatue's Stake in Nvidia and Is Piling Into This Historically Cheap Dual-Industry Leader,"Form 13Fs are filed quarterly and offer investors an under-the-hood look at which stocks Wall Street's smartest fund managers have been buying and selling. Coatue Management's brightest investors, led by Philippe Laffont, have sold north of 36 million shares of Nvidia in 15 months.",https://www.fool.com/investing/2024/09/30/billionaire-philippe-laffont-sold-72-stake-nvidia/,fool.com,7,form f filed quarterly offer investor underthehood look stock wall street smartest fund manager buying selling coatue management brightest investor led philippe laffont sold north million share nvidia month,0.8807,0.61649,0.1153885714,0.5011014286,Positive Impact
01/10/2024,184.9,186.19,183.45,185.13,185.13,36044900,5.66,38.78057437,1.192,0,27.30545211,0.4577403224,0.2071825716,4.83,315.664,17910.35938,19473.92969,8276.700195,7574.069824,3336.49707,84266.28906,24034,179.1312009,176.4742001,182.9019869,173.2545851,185.3100014,198.5735005,172.0465023,51.3039757,2.906731398,3.258998254,-0.352266856,3.809288025,194.7870191,11235374600,14.73776088,43.67703419,19.26000023,Amazon just won a partial victory against the FTC,Amazon won partial dismissal of an FTC lawsuit alleging illegal monopoly practices. The FTC accused Amazon of stifling competition by coercing sellers to use its service.,https://www.businessinsider.com/amazon-ftc-lawsuit-partially-dismissed-antitrust-competition-vendor-fulfillment-2024-10,businessinsider.com,7,amazon partial dismissal ftc lawsuit alleging illegal monopoly practice ftc accused amazon stifling competition coercing seller use service,-0.6486,-0.45402,0.1261116667,-0.580131667,Negative Impact
02/10/2024,184.44,186.60,184.04,184.76,184.76,23704100,5.66,38.78057437,1.192,0,27.30545211,0.4577403224,0.2071825716,4.83,315.664,17925.11914,19481.78906,8290.900391,7577.589844,3336.49707,84266.28906,24001.59961,179.0982007,176.6609,182.97485,173.3690668,185.881501,197.8979093,173.8650927,44.73684022,2.458012641,3.098801131,-0.64078849,3.715716771,194.1067978,11211670500,11.65690705,26.78872915,18.89999962,Amazon hit with US labor board complaint over 'joint employment' of drivers,"Amazon.com has been accused by a U.S. labor board of illegally refusing to bargain with a union representing drivers employed by a contractor, the agency announced on Wednesday.",https://www.reuters.com/technology/amazon-hit-with-us-labor-board-complaint-over-joint-employment-drivers-2024-10-02/,reuters.com,10,amazoncom accused u labor board illegally refusing bargain union representing driver employed contractor agency announced wednesday,-0.4767,-0.4767,0.199928,-0.676628,Negative Impact
03/10/2024,183.05,183.44,180.88,181.96,181.96,30204300,5.66,38.78057437,1.192,0,27.30545211,0.4577403224,0.2071825716,4.83,315.664,17918.48047,19387.67969,8282.5,7477.779785,3336.49707,82497.10156,23968.5,179.1208008,176.8208501,182.9350522,173.4545488,186.0850014,197.661362,174.5086408,40.3903447,1.855079973,2.8500569,-0.994976927,3.807859148,193.4673897,11181466200,7.453433809,11.28270058,20.48999977,"Amazon plans to hire 250,000 workers for the holidays, same as last year","Amazon plans to hire 250,000 transportation and warehouse workers this holiday shopping season, the same number as last year as e-commerce spending is expected to outpace overall holiday sales in the final quarter of 2024, the company said on Thursday.",https://www.reuters.com/technology/amazon-plans-hire-250000-workers-holidays-same-last-year-2024-10-03/,reuters.com,10,amazon plan hire transportation warehouse worker holiday shopping season number last year ecommerce spending expected outpace overall holiday sale final quarter company said thursday,0.7506,0.7506,0.2815755,0.4690245,Positive Impact
04/10/2024,185.75,187.60,183.60,186.51,186.51,40890300,5.66,38.78057437,1.192,0,27.30545211,0.4577403224,0.2071825716,4.83,315.664,18137.84961,19538.67969,8280.599609,7541.359863,3336.49707,81688.45313,24162.80078,179.2540005,176.98305,183.075246,173.5844537,186.8410011,196.1244263,177.557576,53.05428719,1.724518304,2.624949181,-0.900430876,3.98714447,192.4603989,11222356500,38.85433691,19.32155926,19.20999908,"Billionaire David Tepper Likes These 3 Stocks, Are They Must Buys?","David Tepper is a notable figure in finance, most notably the billionaire founder of global hedge fund Appaloosa management based in Florida.",https://247wallst.com/investing/2024/10/04/billionaire-david-tepper-likes-these-3-stocks-are-they-must-buys/,247wallst.com,5,david tepper notable figure finance notably billionaire founder global hedge fund appaloosa management based florida,0,0,0.3435493333,-0.343549333,Negative Impact
07/10/2024,182.95,183.60,180.25,180.80,180.80,42364200,5.66,38.78057437,1.192,0,27.30545211,0.4577403224,0.2071825716,4.83,315.664,17923.90039,19432.30078,8303.599609,7576.02002,3336.49707,81050,24102.69922,179.2200006,177.1181001,182.9860208,173.6562502,187.1110016,195.2350843,178.9869188,39.94708875,1.147075875,2.329374519,-1.182298645,4.108572824,191.5339674,11179992300,3.637587496,16.64845274,22.63999939,"Dow Jumps Over 300 Points As Tesla, Amazon And Netflix Record Gains: Investor Optimism Improves, Fear Index Remains In 'Greed' Zone","The CNN Money Fear and Greed index showed an improvement in the overall market sentiment, while the index remained in the ÃÂÃÂGreedÃÂÃÂ zone on Friday.",https://www.benzinga.com/news/earnings/24/10/41201502/dow-jumps-over-300-points-as-tesla-amazon-and-netflix-record-gains-investor-optimism-improves-fear-,benzinga.com,5,cnn money fear greed index showed improvement overall market sentiment index remained greed zone friday,-0.6808,-0.3404,0.2688432,-0.6092432,Negative Impact
08/10/2024,181.92,183.09,180.92,182.72,182.72,26372100,5.66,38.78057437,1.192,0,27.30545211,0.4577403224,0.2071825716,4.83,315.664,18182.91992,19435.0293,8190.600098,7521.319824,3489.774902,81634.8125,24072.5,179.2104007,177.2711001,182.9755887,173.7464368,187.2695015,194.879926,179.659077,44.15012227,0.8347538723,2.03045039,-1.195696518,4.005000523,190.4055707,11206364400,16.33599218,19.60930553,21.42000008,"FTC can proceed with antitrust lawsuit against Amazon, judge rules","A federal judge said the Federal Trade Commission can proceed with its landmark antitrust lawsuit against Amazon. But, he also gave the company a small victory by tossing out a few claims made by states involved in the legal fight.",https://www.fastcompany.com/91205147/amazon-ftc-antitrust-lawsuit-state-claims,fastcompany.com,5,federal judge said federal trade commission proceed landmark antitrust lawsuit amazon also gave company small victory tossing claim made state involved legal fight,-0.25,-0.125,0.2498994118,-0.374899412,Negative Impact
09/10/2024,182.82,185.85,182.05,185.17,185.17,26343100,5.66,38.78057437,1.192,0,27.30545211,0.4577403224,0.2071825716,4.83,315.664,18291.61914,19547.08984,8243.700195,7560.089844,3258.85791,81467.10156,24224.90039,179.2796005,177.4277501,183.0616439,173.8601041,187.3020012,194.868412,179.7355904,42.35026189,0.775985634,1.779557439,-1.003571805,3.950714111,189.3900136,11232707500,32.53968094,17.50442021,20.86000061,Amazon targets faster deliveries and buying with new tech,"Amazon , in its quest for greater efficiency, has developed new systems to shave seconds off each package delivery and to help customers make faster buying choices, even for new product types that they may know little about.",https://www.reuters.com/technology/amazon-targets-faster-deliveries-buying-with-new-tech-2024-10-09/,reuters.com,10,amazon quest greater efficiency developed new system shave second package delivery help customer make faster buying choice even new product type may know little,0.8126,0.8126,0.3329182609,0.4796817391,Positive Impact
10/10/2024,187.13,188.13,185.83,186.65,186.65,27785000,5.66,38.78057437,1.192,0,27.30545211,0.4577403224,0.2071825716,4.83,315.664,18282.05078,19496.00977,8237.700195,7541.589844,3301.926025,81611.40625,24302.30078,179.2730005,177.5939001,183.2023635,173.9873667,187.2845009,194.8554704,179.7135314,41.87722848,0.8391613386,1.591478219,-0.75231688,3.845715114,188.4760122,11260492500,42.32801563,30.40122958,20.93000031,"S&P Settles At Record High As Apple, Amazon Shares Surge: Investor Optimism Improves Ahead Of Inflation Data","The CNN Money Fear and Greed index showed some improvement in the overall market sentiment, while the index remained in the ÃÂÃÂGreedÃÂÃÂ zone on Wednesday.",https://www.benzinga.com/news/earnings/24/10/41266054/s-p-settles-at-record-high-as-apple-amazon-shares-surge-investor-optimism-improves-ahead-of-inflati,benzinga.com,5,cnn money fear greed index showed improvement overall market sentiment index remained greed zone wednesday,-0.6808,-0.3404,0.1690123077,-0.509412308,Negative Impact
11/10/2024,186.63,189.93,186.30,188.82,188.82,25751600,5.66,38.78057437,1.192,0,27.30545211,0.4577403224,0.2071825716,4.83,315.664,18342.93945,19711.2207,8253.700195,7577.890137,3217.738037,81381.35938,24471.19922,179.3680005,177.7709501,183.4226633,174.1349551,187.401001,194.9921747,179.8098272,41.66666667,1.052201365,1.483622848,-0.431421483,3.827857971,180.25,11286244100,56.67996092,43.84921916,20.45999908,"Bullish Underdogs and Big Winners: PYPL, PFE & AMZN","Andrew Arons with Synergy Advisory Management remains bullish on the state of the markets, crediting A.I. stocks and the Fed's rate cut.",https://www.youtube.com/watch?v=w3wUvo_6riE,youtube.com,5,andrew arons synergy advisory management remains bullish state market crediting ai stock fed rate cut,-0.128,-0.064,0.383432,-0.447432,Negative Impact
14/10/2024,189.78,189.83,187.36,187.54,187.54,22614400,5.66,38.78057437,1.192,0,27.30545211,0.4577403224,0.2071825716,4.83,315.664,18502.68945,19814.55078,8292.700195,7602.060059,3284.322998,81973.04688,24471.19922,179.7608005,177.9419501,183.5841272,174.2683386,187.5335007,195.0320785,180.0349228,39.82887528,1.105012787,1.407900836,-0.302888049,3.630001613,180.4435999,11263629700,51.05037752,50.01945136,19.70000076,Amazon Uses Technology and Legal Action to Combat Fake Reviews,Amazon said Monday (Oct. 14) that it has been using legal action and other methods to combat fake reviews and prevent those reviews from being seen by customers.,https://www.pymnts.com/news/security-and-risk/2024/amazon-uses-technology-and-legal-action-to-combat-fake-reviews/,pymnts.com,5,amazon said monday oct using legal action method combat fake review prevent review seen customer,-0.4939,-0.24695,0.3139883333,-0.560938333,Negative Impact
15/10/2024,187.63,188.41,184.58,187.69,187.69,32178900,5.66,38.78057437,1.192,0,27.30545211,0.4577403224,0.2071825716,4.83,315.664,18315.58984,19678.71094,8249.299805,7521.970215,3201.291992,81820.11719,24439.09961,180.2942004,178.1135001,183.7451419,174.4018875,187.5740005,195.0664643,180.0815368,42.00793175,1.14576306,1.355473281,-0.209710221,3.775001526,180.6333277,11295808600,52.10086189,53.27706678,20.63999939,"If I Could Only Buy 2 Stocks in the Last Half of 2024, I'd Pick These",Buying these stocks now can set you on the path to building a rock-solid portfolio.,https://www.fool.com/investing/2024/10/15/if-i-could-only-buy-2-stocks-id-pick-these/,fool.com,7,buying stock set path building rocksolid portfolio,0,0,0.3397641667,-0.339764167,Negative Impact
16/10/2024,187.05,187.78,185.61,186.89,186.89,23456800,5.66,38.78057437,1.192,0,27.30545211,0.4577403224,0.2071825716,4.83,315.664,18367.08008,19825.49023,8329.099609,7492,3202.947998,81501.35938,24561.19922,180.7934006,178.28825,183.8684697,174.5261473,187.5970009,195.0774925,180.1165093,42.81386182,1.100814876,1.3045416,-0.203726723,3.573572431,180.819261,11272351800,62.34744784,55.16622908,19.57999992,Immigration Is a Top Issue for VotersÃÂÃÂand Companies Like Amazon,Voters will soon decide if they want Trump or Harris to handle the immigration crisis. The consequences for corporate America and the economy run deep.,https://www.barrons.com/articles/immigration-election-economy-amazon-big-tech-423af9aa,barrons.com,9,voter soon decide want trump harris handle immigration crisis consequence corporate america economy run deep,-0.5859,-0.52731,0.2699920833,-0.797302083,Negative Impact
17/10/2024,188.22,188.94,186.00,187.53,187.53,25039400,5.66,38.78057437,1.192,0,27.30545211,0.4577403224,0.2071825716,4.83,315.664,18373.60938,19855.25977,8385.099609,7583.72998,3169.384033,81006.60938,24690.5,181.2886005,178.4762501,184.0120591,174.6555389,187.4800011,194.8836068,180.0763954,49.18998089,1.104108247,1.264454929,-0.160346683,3.51071494,181.0014756,11297391200,75.20665586,63.21832186,19.11000061,Amazon AWS CEO: Quit if you don't want to return to office,"One of Amazon's top executives defended the new, controversial 5-day-per-week in-office policy on Thursday, saying those who don't support it can leave for another company. Speaking at an all-hands meeting for AWS, unit CEO Matt Garman said nine out of 10 workers he has spoken with support the new policy, which takes effect in January, according to a transcript reviewed by Reuters.",https://www.reuters.com/technology/amazon-aws-ceo-quit-if-you-dont-want-return-office-2024-10-17/,reuters.com,10,one amazon top executive defended new controversial dayperweek inoffice policy thursday saying dont support leave another company speaking allhands meeting aws unit ceo matt garman said nine worker spoken support new policy take effect january according transcript reviewed reuters,-0.3956,-0.3956,0.1965273913,-0.592127391,Negative Impact
18/10/2024,187.15,190.74,186.28,188.99,188.99,37417700,5.66,38.78057437,1.192,0,27.30545211,0.4577403224,0.2071825716,4.83,315.664,18489.55078,19884.81055,8358.299805,7613.049805,3261.562988,81224.75,24822.5,181.7524005,178.6788501,184.2072726,174.7981704,187.349501,194.5361642,180.1628378,54.92958224,1.210573864,1.253678716,-0.043104852,3.555000305,181.180046,11334808900,83.31745392,73.62385254,18.03000069,Time to Buy Amazon ETFs Following Cathie Wood's Investment?,"On Oct. 8, 2024, Cathie Wood's Ark Innovation ETF purchased 76, 505 shares of Amazon, valued at $14 million.",https://www.zacks.com/stock/news/2353406/time-to-buy-amazon-etfs-following-cathie-wood-s-investment?cid=CS-STOCKNEWSAPI-FT-etf_news_and_commentary-2353406,zacks.com,8,oct cathie wood ark innovation etf purchased share amazon valued million,0.8126,0.65008,0.2385133333,0.4115666667,Positive Impact
21/10/2024,188.05,189.46,186.40,189.07,189.07,24639400,5.66,38.78057437,1.192,0,27.30545211,0.4577403224,0.2071825716,4.83,315.664,18540.00977,19720.32031,8318.200195,7536.22998,3268.110107,81151.27344,24723.30078,182.1950006,178.9013501,184.3979681,174.9401787,187.1090012,193.6702024,180.5478,57.61794281,1.286573296,1.260257632,0.02631566402,3.567858015,181.5624444,11359448300,84.08010205,80.86807061,18.37000084,"Amazon's satellite constellation doesn't offer its stock much upside, says BofA",The company's ambitious Project Kuiper broadband satellite system has been attracting a lot of attention recently.,https://www.marketwatch.com/story/amazons-satellite-constellation-doesnt-offer-its-stock-much-upside-says-bofa-ec66300b,marketwatch.com,8,company ambitious project kuiper broadband satellite system attracting lot attention recently,0.7351,0.58808,0.2876546154,0.3004253846,Positive Impact
22/10/2024,188.35,191.52,186.98,189.70,189.70,29650600,5.66,38.78057437,1.192,0,27.30545211,0.4577403224,0.2071825716,4.83,315.664,18579.76953,19664.58008,8306.5,7535.100098,3285.866943,80220.71875,24689.69922,182.6530005,179.1236501,184.6058908,175.0870426,186.8960007,192.7603275,181.0316738,59.45636172,1.381710789,1.284548264,0.09716252576,3.709286281,181.9295468,11389098900,83.85087281,83.74947626,18.20000076,"Amazon sets ultra-low pricing plans for Temu rival store, The Information reports","Amazon.com is imposing severe price caps on what merchants can charge for their products on a new low-cost storefront that the e-commerce giant is preparing to launch, the Information reported on Tuesday.",https://www.reuters.com/technology/amazon-sets-ultra-low-pricing-plans-temu-rival-store-information-reports-2024-10-22/,reuters.com,10,amazoncom imposing severe price cap merchant charge product new lowcost storefront ecommerce giant preparing launch information reported tuesday,-0.4588,-0.4588,0.2278286667,-0.686628667,Negative Impact
23/10/2024,188.85,189.16,183.69,184.71,184.71,31937100,5.66,38.78057437,1.192,0,27.30545211,0.4577403224,0.2071825716,4.83,315.664,18276.65039,19594.24023,8258.599609,7497.47998,3302.802979,80081.97656,24573.59961,182.9426007,179.3017001,184.6099738,175.1827935,186.5050011,191.8031256,181.2068766,54.85694143,1.04244082,1.236126775,-0.193685955,3.861429487,182.5049743,11357161800,39.57413508,69.16836998,19.23999977,Mag 7 Earnings Loom: What Can Investors Expect?,"Without the Mag 7's substantial earnings contribution, Q3 earnings for the remaining S&P 500 index would be modestly in negative territory. Next week, several will reveal their results.",https://www.zacks.com/commentary/2356392/mag-7-earnings-loom-what-can-investors-expect?cid=CS-STOCKNEWSAPI-FT-earnings_outlook-2356392,zacks.com,8,without mag substantial earnings contribution q earnings remaining sp index would modestly negative territory next week several reveal result,-0.6476,-0.51808,0.210648125,-0.728728125,Negative Impact
24/10/2024,185.25,187.11,183.86,186.38,186.38,21647400,5.66,38.78057437,1.192,0,27.30545211,0.4577403224,0.2071825716,4.83,315.664,18415.49023,19560.73047,8269.400391,7503.279785,3280.262939,80065.15625,24551.59961,183.2682007,179.4767501,184.6793868,175.2942085,186.2660011,191.0900034,181.4419989,49.74441686,0.8979705754,1.168495535,-0.27052496,3.690715245,183.0458761,11378809200,54.39221436,59.27240742,19.07999992,"Amazon Vs. Walmart: E-Commerce Giant Offers Gas Savings To Prime Members, EV Charging Discounts In Latest Battle For Subscribers",Amazon.com Inc AMZN is adding another reason for consumers to sign up for its Amazon Prime membership program as the e-commerce giant intensifies the battle for subscribers against retailer Walmart Inc WMT.,https://www.benzinga.com/trading-ideas/24/10/41527960/amazon-vs-walmart-e-commerce-giant-offers-gas-savings-to-prime-members-ev-charging-discounts-in-lat,benzinga.com,5,amazoncom inc amzn adding another reason consumer sign amazon prime membership program ecommerce giant intensifies battle subscriber retailer walmart inc wmt,-0.2263,-0.11315,0.3276922222,-0.440842222,Negative Impact
25/10/2024,187.85,190.45,187.53,187.83,187.83,29362100,5.66,38.78057437,1.192,0,27.30545211,0.4577403224,0.2071825716,4.83,315.664,18518.60938,19456.26953,8248.799805,7497.540039,3299.699951,79402.28906,24463.69922,183.4730008,179.6472501,184.8029403,175.4189428,186.2590012,191.0729883,181.445014,66.60367104,0.8902176263,1.112839953,-0.222622327,3.534286499,183.5543238,11408171300,65.18867626,53.05167523,20.32999992,Behind the scenes with the team of ex-prosecutors fighting Amazon's counterfeit problem,Counterfeits on Amazon skyrocketed after sales from Chinese-based sellers more than doubled in 2015. Here's how Amazon is trying to stop the problem.,https://www.cnbc.com/2024/10/25/amazon-turns-to-team-of-ex-prosecutors-to-try-to-fight-counterfeiters.html,cnbc.com,9,counterfeit amazon skyrocketed sale chinesebased seller doubled here amazon trying stop problem,-0.3612,-0.32508,0.211835,-0.536915,Negative Impact
28/10/2024,189.57,190.21,188.21,188.39,188.39,27930800,5.66,38.78057437,1.192,0,27.30545211,0.4577403224,0.2071825716,4.83,315.664,18567.18945,19549.66992,8285.599609,7556.939941,3322.197998,80005.03906,24565.69922,183.6996008,179.8133002,184.9436093,175.548008,186.362001,191.2696251,181.454377,64.31094018,0.9186706181,1.074006086,-0.155335468,3.540715899,183.8600006,11436102100,66.94821036,62.17636699,19.79999924,"Nasdaq Surges To Fresh Highs As Nvidia, Meta And Amazon Surge: Fear Index Remains In 'Greed' Zone","The CNN Money Fear and Greed index showed a decline in the overall market sentiment, while the index remained in the ÃÂÃÂGreedÃÂÃÂ zone on Friday.",https://www.benzinga.com/news/earnings/24/10/41567317/nasdaq-surges-to-fresh-highs-as-nvidia-meta-and-amazon-surge-fear-index-remains-in-greed-zone,benzinga.com,5,cnn money fear greed index showed decline overall market sentiment index remained greed zone friday,-0.8225,-0.41125,0.29424,-0.70549,Negative Impact
29/10/2024,188.58,191.46,187.82,190.83,190.83,35690200,5.66,38.78057437,1.192,0,27.30545211,0.4577403224,0.2071825716,4.83,315.664,18712.75,19456.68945,8219.599609,7511.109863,3286.406982,80369.03125,24562.59961,183.9518008,179.9943502,185.1744482,175.7000676,186.6470009,191.9030429,181.3909589,64.29292532,1.125137737,1.084232416,0.04090532038,3.529287066,184.3196008,11471792300,91.18771034,74.44153232,19.34000015,"Amazon, Alphabet, and Apple Went on an AI Spending Spree Last Quarter. What's Next for Big Tech.",The AI investment cycle looks to be here to stay.,https://www.barrons.com/articles/amazon-alphabet-apple-tech-ai-spending-0b4b25e0,barrons.com,9,ai investment cycle look stay,0,0,0.286526,-0.286526,Negative Impact
30/10/2024,194.7,195.61,192.42,192.73,192.73,37707600,5.66,38.78057437,1.192,0,27.30545211,0.4577403224,0.2071825716,4.83,315.664,18607.92969,19416.26953,8159.600098,7428.359863,3266.238037,79942.17969,24507.80078,184.2288007,180.1922002,185.4707442,175.8695197,187.0455009,192.8762611,181.2147408,65.03461146,1.425644106,1.152514754,0.2731293521,3.659286499,184.751625,11509499900,75.8388815,77.99160073,20.35000038,Amazon ÃÂÃÂhas never been stronger.' So why isn't its stock getting more love?,"Amazon's stock has trailed the S&P 500 over three months, owing in part to concerns about operating income and margin compression. Will Thursday's earnings alleviate fears?",https://www.marketwatch.com/story/amazon-has-never-been-stronger-so-why-isnt-its-stock-getting-more-love-6162abf9,marketwatch.com,8,amazon stock trailed sp three month owing part concern operating income margin compression thursday earnings alleviate fear,-0.3612,-0.28896,0.231605,-0.520565,Negative Impact
31/10/2024,190.51,190.60,185.23,186.40,186.40,75146800,5.66,38.78057437,1.192,0,27.30545211,0.4577403224,0.2071825716,4.83,315.664,18095.15039,19238.94922,8110.100098,7350.370117,3279.823975,79389.0625,24156.90039,184.3546005,180.3656501,185.5071854,175.9743005,187.2675003,192.5997879,181.9352127,45.03688896,1.139879502,1.149987704,-0.010108202,3.935715812,195.6100006,11434353100,22.73483114,63.25380766,23.15999985,Amazon.com beats estimates for quarterly revenue,"Amazon.com beat market estimates for quarterly revenue on Thursday, boosted by strong growth in its cloud services unit thanks to growing enterprise spend on AI.",https://www.reuters.com/technology/amazoncom-beats-estimates-quarterly-revenue-2024-10-31/,reuters.com,10,amazoncom beat market estimate quarterly revenue thursday boosted strong growth cloud service unit thanks growing enterprise spend ai,0.9001,0.9001,0.3015781132,0.5985218868,Positive Impact
01/11/2024,199,200.50,197.02,197.93,197.93,99687800,5.66,38.78057437,1.192,0,27.30545211,0.4577403224,0.2071825716,4.83,315.493,18239.91992,19253.53906,8177.200195,7409.109863,3272.013916,79724.11719,24255.19922,184.7906003,180.5878001,185.9943543,176.1927651,187.8385002,194.9711124,180.705888,65.00144745,1.822771758,1.284544515,0.5382272432,4.766430446,185.2299957,11534040900,84.71143547,61.09504937,21.87999916,"Apple, Amazon shares steady in Frankfurt after results","Frankfurt-listed shares of ""Magnificent 7"" stocks Apple and Amazon were broadly steady on Friday, in light volumes after both companies reported quarterly earnings after-market on Thursday.",https://www.reuters.com/technology/apple-amazon-shares-steady-frankfurt-after-results-2024-11-01/,reuters.com,10,frankfurtlisted share magnificent stock apple amazon broadly steady friday light volume company reported quarterly earnings aftermarket thursday,0.7783,0.7783,0.3246853333,0.4536146667,Positive Impact
04/11/2024,196.45,197.33,194.31,195.78,195.78,38492100,5.66,38.78057437,1.192,0,27.30545211,0.4577403224,0.2071825716,4.64,315.493,18179.98047,19243.39063,8184.200195,7371.709961,3310.207031,78782.24219,24256.09961,185.1654004,180.7900001,186.378105,176.3876629,188.5875,195.7540772,181.4209228,61.04286377,2.165519491,1.46073951,0.7047799806,4.751429967,185.2299957,11495548800,71.92146397,59.78924353,21.97999954,Earnings Season Is In the Home Stretch. Here's What You Need to Know.,"Third-quarter earnings season enters the home stretch this week. The quarter appears to have been mixed for corporate America, with companies broadly beating estimates while scaling back fourth-quarter guidance.",https://www.investopedia.com/earnings-season-home-stretch-what-you-need-to-know-8739193,investopedia.com,5,thirdquarter earnings season enters home stretch week quarter appears mixed corporate america company broadly beating estimate scaling back fourthquarter guidance,-0.4588,-0.2294,0.2000622222,-0.429462222,Negative Impact
05/11/2024,196.04,199.82,195.99,199.50,199.50,30564800,5.66,38.78057437,1.192,0,27.30545211,0.4577403224,0.2071825716,4.64,315.493,18439.16992,19463.78906,8172.399902,7407.149902,3386.987061,79476.63281,24387.90039,185.6454004,181.0136001,186.8926892,176.6176364,189.4264999,197.5639492,181.2890506,65.94185761,2.706127988,1.709817206,0.9963107827,4.885002136,185.5353958,11526113600,94.05115916,83.56135287,20.48999977,My 2 Favorite Growth Stocks to Buy Hand Over Fist in November,The sky's the limit for these stocks.,https://www.fool.com/investing/2024/11/05/my-2-favorite-growth-stocks-to-buy-hand-over-fist/,fool.com,7,sky limit stock,0,0,0.3458969565,-0.345896957,Negative Impact
06/11/2024,200.01,207.55,199.14,207.09,207.09,72292200,5.66,38.78057437,1.192,0,27.30545211,0.4577403224,0.2071825716,4.64,315.493,18983.4707,19828,8166.700195,7369.609863,3383.805908,80378.13281,24637.5,186.3248004,181.26895,187.6847404,176.920844,190.5224998,201.6143923,179.4306074,71.03226924,3.704312382,2.108716241,1.595596141,5.275716509,185.8346879,11598405800,98.07205909,88.01489407,16.27000046,"Amazon Stock Pops, Driven by AWS. Is It Too Late to Buy?",The company will look to continue to invest heavily in AI.,https://www.fool.com/investing/2024/11/06/amazon-stock-pops-driven-by-aws-is-it-too-late-to/,fool.com,7,company look continue invest heavily ai,0,0,0.28185,-0.28185,Negative Impact
07/11/2024,207.44,212.25,207.19,210.05,210.05,52878400,5.66,38.78057437,1.192,0,27.30545211,0.4577403224,0.2071825716,4.64,315.493,19269.46094,19876.09961,8140.700195,7425.600098,3470.660889,79541.78906,24845.90039,187.1098004,181.5348501,188.5618095,177.2504874,191.6925003,205.6348019,177.7501987,71.9375114,4.680277188,2.62302843,2.057248758,5.325716291,186.7033005,11651284200,92.29692879,94.80671568,15.19999981,"India raids offices of sellers using Amazon, Flipkart platforms, sources say","India's financial crime agency has raided offices of some sellers operating on the platforms of Amazon and Flipkart, majority-owned by Walmart , as part of an investigation into alleged violations of foreign investment rules by the e-commerce companies, two government sources said on Thursday.",https://www.reuters.com/world/india/india-raids-offices-sellers-using-amazon-flipkart-platforms-sources-say-2024-11-07/,reuters.com,10,india financial crime agency raided office seller operating platform amazon flipkart majorityowned walmart part investigation alleged violation foreign investment rule ecommerce company two government source said thursday,-0.7184,-0.7184,0.3631594737,-1.081559474,Negative Impact
08/11/2024,209.72,209.96,207.44,208.18,208.18,36038600,5.66,38.78057437,1.192,0,27.30545211,0.4577403224,0.2071825716,4.64,315.493,19286.7793,19937.13086,8072.399902,7338.669922,3452.297119,79486.32031,24759.40039,187.8310004,181.787,189.3311501,177.5582437,192.6604996,208.3427904,176.9782088,69.19059428,5.24241087,3.146904918,2.095505952,5.293572562,188.2361025,11615208400,85.74927286,92.03942025,14.93999958,"Trump Economy: 2 Stocks Set to Prosper (AMZN, HD)","Most Trump voters believe he will boost their economic security and for many, the ability to support their families is a top concern. Appealing to people's most basic needs such as their personal finances has clearly been a winning strategy, and if the results can be delivered, Trump will likely remain popular with those who voted for him.",https://www.zacks.com/commentary/2367609/trump-economy-2-stocks-set-to-prosper-amzn-hd?cid=CS-STOCKNEWSAPI-FT-investment_ideas-2367609,zacks.com,8,trump voter believe boost economic security many ability support family top concern appealing people basic need personal finance clearly winning strategy result delivered trump likely remain popular voted,0.9571,0.76568,0.35445,0.41123,Positive Impact
11/11/2024,208.5,209.65,205.59,206.84,206.84,35456000,5.66,38.78057437,1.192,0,27.30545211,0.4577403224,0.2071825716,4.64,315.493,19298.75977,20015.86914,8125.200195,7426.879883,3470.065918,79496.14844,24789.30078,188.3978003,182.0256001,190.0177715,177.8496044,193.6254997,210.323446,176.9275534,66.97030155,5.516192128,3.62076236,1.895429768,5.259286063,189.6769363,11579752400,81.05740853,86.36787006,14.97000027,"India to summon Amazon, Flipkart executives as regulatory scrutiny grows, source says","India's financial crime agency will summon Flipkart and Amazon executives as it steps up an investigation into alleged foreign investment law violations, days after raiding some of the e-commerce firms' sellers, a senior government source said.",https://www.reuters.com/technology/india-summon-amazon-flipkart-executives-regulatory-scrutiny-grows-source-says-2024-11-11/,reuters.com,10,india financial crime agency summon flipkart amazon executive step investigation alleged foreign investment law violation day raiding ecommerce firm seller senior government source said,-0.7184,-0.7184,0.1265644444,-0.844964444,Negative Impact
12/11/2024,208.3699951,209.54,206.01,208.91,208.91,38942900,5.66,38.78057437,1.192,0,27.30545211,0.4577403224,0.2071825716,4.64,315.493,19281.40039,19853.28906,8025.799805,7226.97998,3421.969971,78675.17969,24923,189.0510004,182.2638501,190.7586433,178.1586631,194.6864998,212.4585844,176.9144152,75.43084911,5.832959315,4.063201751,1.769757564,5.082143511,191.0313201,11618695300,88.23530676,85.01399605,14.71000004,"Amazon offers free computing power to AI researchers, aiming to challenge Nvidia","Amazon.com's cloud computing unit on Tuesday said it will offer free computing power to researchers who want to use its custom artificial intelligence chips, aiming to challenge Nvidia's popularity among those researchers.",https://www.reuters.com/technology/artificial-intelligence/amazon-offers-free-computing-power-ai-researchers-aiming-challenge-nvidia-2024-11-12/,reuters.com,10,amazoncoms cloud computing unit tuesday said offer free computing power researcher want use custom artificial intelligence chip aiming challenge nvidias popularity among researcher,0.8779,0.8779,0.2895821053,0.5883178947,Positive Impact
13/11/2024,209.3999939,215.09,209.14,214.10,214.10,46212900,5.66,38.78057437,1.192,0,27.30545211,0.4577403224,0.2071825716,4.64,315.493,19230.7207,19845.41992,8030.299805,7216.830078,3439.278076,77690.95313,24989,189.8664005,182.5393501,191.6739909,178.5162884,196.0470001,215.4016013,176.6923989,77.12328563,6.428683553,4.536298112,1.892385441,5.291428702,192.3044409,11664908200,96.68456057,88.65909195,14.02000046,US labor board bans mandatory anti-union meetings in ruling against Amazon,"Amazon.com made unlawful promises and threats during mandatory meetings to discourage unionizing at a New York City warehouse, a U.S. labor board said on Wednesday while banning employers from holding such meetings moving forward.",https://www.reuters.com/technology/us-labor-board-bans-mandatory-anti-union-meetings-ruling-against-amazon-2024-11-13/,reuters.com,10,amazoncom made unlawful promise threat mandatory meeting discourage unionizing new york city warehouse u labor board said wednesday banning employer holding meeting moving forward,-0.5574,-0.5574,0.1997253846,-0.757125385,Negative Impact
14/11/2024,214.1600037,215.90,210.88,211.48,211.48,42620300,5.66,38.78057437,1.192,0,27.30545211,0.4577403224,0.2071825716,4.64,315.493,19107.65039,19733.58008,8071.200195,7311.799805,3379.839111,77580.3125,25049.69922,190.5382004,182.8207501,192.450697,178.8442855,197.2445,217.3301624,177.1588375,72.62290516,6.613154039,4.951669297,1.661484742,5.359285627,194.1272854,11622287900,85.5885281,90.16946514,14.31000042,These 3 Dow Stocks Are Set to Soar in 2025 and Beyond,These 3 Dow Stocks Are Set to Soar in 2025 and Beyond,https://www.fool.com/investing/2024/11/14/these-3-dow-stocks-are-set-to-soar-in-2025-beyond/,fool.com,7,dow stock set soar beyond,0,0,0.267437,-0.267437,Negative Impact
15/11/2024,206.7599945,207.34,199.61,202.61,202.61,86591100,5.66,38.78057437,1.192,0,27.30545211,0.4577403224,0.2071825716,4.64,315.493,18680.11914,19645.76953,8063.600098,7269.629883,3330.726074,#N/A,24890.69922,191.1626004,183.0374001,192.849101,179.0807602,197.9254997,217.7547043,178.0962952,61.73654441,5.974740661,5.15628357,0.8184570909,6.037142072,196.3045562,11535696800,56.66777281,79.64695382,16.13999939,"In Amazon, SpaceX cases, US labor board's power is on the line","A U.S. labor board whose enforcement powers are being challenged in a series of lawsuits is set to defend itself from attacks by Elon Musk's SpaceX and Amazon.com in a conservative U.S. appeals court, as the agency also braces for a potential overhaul under President-elect Donald Trump.",https://www.reuters.com/legal/amazon-spacex-will-test-us-labor-boards-powers-conservative-appeals-court-2024-11-15/,reuters.com,10,u labor board whose enforcement power challenged series lawsuit set defend attack elon musk spacex amazoncom conservative u appeal court agency also brace potential overhaul presidentelect donald trump,-0.6597,-0.6597,0.181246,-0.840946,Negative Impact
18/11/2024,204.1499939,204.67,200.95,201.70,201.70,36512500,5.66,38.78057437,1.192,0,27.30545211,0.4577403224,0.2071825716,4.64,315.493,18791.81055,19718.41992,8109.299805,7278.22998,3323.849121,77339.00781,24976.90039,191.6886005,183.1868501,193.196195,179.3058273,198.5569992,217.9994307,179.1145677,59.20405736,5.333878142,5.191802484,0.1420756575,6.042856489,198.2641,11499184300,53.70069189,65.3189976,15.57999992,Tencent challenges Amazon and Microsoft's cloud dominance by tapping into its WeChat ecosystem,"Tencent is increasingly leveraging its WeChat ecosystem to set itself apart from other cloud service competitors, Tencent Cloud CEO Dowson Tong said. Tong shared that many of Tencent's clients were keen on building their own mini programs on WeChat's network to attract existing users of the super app to their services.",https://www.cnbc.com/2024/11/18/tencent-is-contesting-microsoft-googles-cloud-dominance-with-wechat.html,cnbc.com,9,tencent increasingly leveraging wechat ecosystem set apart cloud service competitor tencent cloud ceo dowson tong said tong shared many tencents client keen building mini program wechats network attract existing user super app service,0.8834,0.79506,0.4020533333,0.3930066667,Positive Impact
19/11/2024,199.3300018,205.30,198.78,204.61,204.61,31197900,5.66,38.78057437,1.192,0,27.30545211,0.4577403224,0.2071825716,4.64,315.493,18987.4707,19718.25,8099,7229.640137,3346.01001,77578.38281,25010.80078,192.1898004,183.3583501,193.6437952,179.5576101,199.3024994,218.4562573,180.1487415,59.89010933,5.003129986,5.154067984,-0.150937999,6.167142596,215.8999939,11530382200,63.18880352,57.85242274,16.35000038,Looking for Stocks with Positive Earnings Momentum? Check Out These 2 Retail and Wholesale Names,The Zacks Earnings ESP is a great way to find potential earnings surprises. Why investors should take advantage now.,https://www.zacks.com/stock/news/2372015/looking-for-stocks-with-positive-earnings-momentum-check-out-these-2-retail-and-wholesale-names?cid=CS-STOCKNEWSAPI-FT-tale_of_the_tape|zacks_education_earnings_esp-2372015,zacks.com,8,zacks earnings esp great way find potential earnings surprise investor take advantage,0.802,0.6416,0.2959975,0.3456025,Positive Impact
20/11/2024,202.9799957,203.13,199.45,202.88,202.88,32769000,5.66,38.78057437,1.192,0,27.30545211,0.4577403224,0.2071825716,4.64,315.493,18966.14063,19749.13086,8085.100098,7198.450195,3367.989014,#N/A,25036.5,192.5570004,183.5270002,194.0059995,179.7896737,200.2109993,218.1346142,182.2873844,64.85755901,4.548975731,5.033049534,-0.484073802,6,215.557594,11497613200,39.69434358,52.194613,17.15999985,Thursday's big stock stories: What's likely to move the market in the next trading session,"The major averages ended Wednesday's session mixed, with the S&P 500 closing near the flatline. Here's what CNBC is watching going into Thursday.",https://www.cnbc.com/2024/11/20/thursdays-big-stock-stories-whats-likely-to-move-the-market.html,cnbc.com,9,major average ended wednesday session mixed sp closing near flatline here cnbc watching going thursday,0,0,0.3906433333,-0.390643333,Negative Impact
21/11/2024,203.4900055,203.49,195.75,198.38,198.38,58800000,5.66,38.78057437,1.192,0,27.30545211,0.4577403224,0.2071825716,4.64,315.493,18972.41992,19968.30078,8149.299805,7213.319824,3370.404053,77155.78906,25390.69922,192.7846005,183.6662502,194.1775291,179.9746521,200.8109993,217.5493699,184.0726286,50.46460045,3.782342333,4.782908094,-1.000565761,5.545714242,215.2220421,11438813200,18.85135718,40.57816809,16.87000084,Should You Forget Sirius XM Holdings? This Stock Has Made Far More Millionaires.,Should You Forget Sirius XM Holdings? This Stock Has Made Far More Millionaires.,https://www.fool.com/investing/2024/11/21/should-you-forget-sirius-xm-and-buy-amazon-instead/,fool.com,7,forget sirius xm holding stock made far millionaire,-0.2263,-0.15841,0.3011292857,-0.459539286,Negative Impact
22/11/2024,198.25,199.26,196.75,197.12,197.12,31530800,5.66,38.78057437,1.192,0,27.30545211,0.4577403224,0.2071825716,4.64,315.493,19003.65039,20123.44922,8262.099609,7255.009766,3267.191895,79117.10938,25444.30078,192.9972003,183.8026502,194.29292,180.1452526,201.275499,216.9808384,185.5701595,51.40933449,3.038086415,4.433943758,-1.395857343,5.466428484,214.4431604,11407282400,6.798985271,21.78156201,15.23999977,"Dow Surges Over 450 Points As Nvidia Climbs Post-Earnings, Google, Amazon Slip: Fear Index Shifts To 'Greed' Zone","The CNN Money Fear and Greed index showed further improvement in the overall market sentiment, while the index moved to the ÃÂÃÂGreedÃÂÃÂ zone on Thursday.",https://www.benzinga.com/24/11/42131399/dow-surges-over-450-points-investor-sentiment-improves-fear-greed-index-moves-to-greed-zone,benzinga.com,5,cnn money fear greed index showed improvement overall market sentiment index moved greed zone thursday,-0.6808,-0.3404,0.2708355556,-0.611235556,Negative Impact
25/11/2024,199.2799988,201.95,199.00,201.45,201.45,40685700,5.66,38.78057437,1.192,0,27.30545211,0.4577403224,0.2071825716,4.64,315.493,19054.83984,20220.35938,8291.700195,7257.470215,3263.76001,80109.85156,25410.40039,193.3284003,183.9376502,194.5735896,180.3572401,201.9284988,216.4168985,187.4400992,52.02491728,2.76577111,4.100309228,-1.334538118,5.522856576,213.695434,11447968100,28.28783461,17.97939235,14.60000038,"Japan authorities raid Amazon Japan for possible anti-competitive practices, Nikkei reports","The Japanese Fair Trade Commission conducted an on-site inspection of Amazon Japan on suspicion of violating anti-monopoly laws, the Nikkei business daily reported on Tuesday.",https://www.reuters.com/technology/japan-authorities-raid-amazon-japan-possible-anti-competitive-practices-nikkei-2024-11-26/,reuters.com,10,japanese fair trade commission conducted onsite inspection amazon japan suspicion violating antimonopoly law nikkei business daily reported tuesday,-0.4767,-0.4767,0.136455,-0.613155,Negative Impact
26/11/2024,201.8999939,208.00,201.79,207.86,207.86,41673700,5.66,38.78057437,1.192,0,27.30545211,0.4577403224,0.2071825716,4.64,315.493,19174.30078,20219.44922,8258.599609,7194.509766,3259.75708,80004.0625,25405.09961,193.7480002,184.1152502,195.0946254,180.6308994,202.7799988,216.5035492,189.0564483,50.81967586,3.032239228,3.886695228,-0.854456,5.38999939,212.9776166,11489641800,60.09927682,31.7286989,14.10000038,Amazon Japan raided by anti-monopoly authorities,Amazon Japan has said it will collaborate with Japan's Fair Trade Commission (JFTC) after the watchdog conducted an on-site inspection related to suspected violations of anti-monopoly laws.,https://techcrunch.com/2024/11/26/amazon-japan-raided-by-anti-monopoly-authorities/,techcrunch.com,5,amazon japan said collaborate japan fair trade commission jftc watchdog conducted onsite inspection related suspected violation antimonopoly law,-0.2732,-0.1366,0.3088873684,-0.445487368,Negative Impact
27/11/2024,206.9799957,207.64,205.05,205.74,205.74,28061600,5.66,38.78057437,1.192,0,27.30545211,0.4577403224,0.2071825716,4.64,315.493,19060.48047,20209.82031,8274.799805,7143.029785,3309.779053,80234.07813,25488.30078,194.1342004,184.3007503,195.5120913,180.8807412,203.4304993,216.3585698,190.5024288,45.32842591,3.037338693,3.716823921,-0.679485228,5.222141811,212.288512,11461580200,49.57820605,45.98843916,14.10000038,Amazon bets big on interactive ads during NFL game,CNBC's Julia Boorstin reports on Amazon's push to get more consumers shopping via interactive ads during the stream of its second Black Friday NFL game.,https://www.youtube.com/watch?v=jzk7AaSKzWI,youtube.com,5,cnbcs julia boorstin report amazon push get consumer shopping via interactive ad stream second black friday nfl game,0.1779,0.08895,0.4472541667,-0.358304167,Negative Impact
29/11/2024,205.8300018,208.20,204.59,207.89,207.89,24892400,5.66,38.78057437,1.192,0,27.30545211,0.4577403224,0.2071825716,4.64,315.493,19218.16992,20272.03906,8287.299805,7235.109863,3326.456055,79802.78906,25648,194.4946005,184.4853003,195.9974994,181.1494901,204.5049995,214.7714425,194.2385566,49.6875747,3.178229938,3.609105125,-0.430875186,5.293570382,211.6269715,11486472600,60.24815418,56.64187902,13.51000023,"E-Commerce Spending Hits Thanksgiving Record. Amazon, Shopify Stock Gain In Black Friday Trading.",Online shopping on Thanksgiving hit record levels. Amazon stock closed slightly higher Friday.,https://www.investors.com/news/technology/amazon-stock-ecommerce-thanksgiving-black-friday-spending/,investors.com,5,online shopping thanksgiving hit record level amazon stock closed slightly higher friday,0.1779,0.08895,0.3618,-0.27285,Negative Impact
02/12/2024,209.9600067,212.99,209.51,210.71,210.71,39523200,5.66,38.78057437,1.192,0,27.30545211,0.4577403224,0.2071825716,4.48,315.605,19403.94922,20213.2207,8312.900391,7236.890137,3363.981934,80248.07813,25590.30078,194.8768005,184.6898503,196.5744605,181.4436246,205.1440002,215.2773662,195.0106342,54.04051781,3.477353522,3.582754804,-0.105401282,5.367856707,195.75,11525995800,74.24323199,61.35653074,13.34000015,Amazon to pilot AI-designed material for carbon removal,"Amazon.com Inc plans to pilot a new carbon-removal material for data centers, which are at risk of worsening emissions from artificial intelligence systems they power, a startup behind the deal said on Monday.",https://www.reuters.com/technology/artificial-intelligence/amazon-pilot-ai-designed-material-carbon-removal-2024-12-02/,reuters.com,10,amazoncom inc plan pilot new carbonremoval material data center risk worsening emission artificial intelligence system power startup behind deal said monday,-0.25,-0.25,0.3861946667,-0.636194667,Negative Impact
03/12/2024,210.3099976,214.02,209.65,213.44,213.44,32214800,5.66,38.78057437,1.192,0,27.30545211,0.4577403224,0.2071825716,4.48,315.605,19480.91016,20185.81055,8359.400391,7255.419922,3378.805908,80845.75,25635.69922,195.2680005,184.9095004,197.2358543,181.7619965,206.0270004,215.7959049,196.258096,54.6652905,3.889859083,3.64417566,0.2456834228,5.427857535,196.0948001,11558210600,87.79160198,74.09432938,13.30000019,RAINN Named Winner of 2024-2025 Amazon Web Services IMAGINE Grant for Nonprofits,"RAINN will use AWS generative AI to create on-demand crisis hotlines and additional support mediums. This solution will integrate RAINN's National Sexual Assault Hotline directly into social media, gaming, and social networking sites. RAINN will use AWS generative AI to create on-demand crisis hotlines and additional support mediums. This solution will integrate RAINN's National Sexual Assault Hotline directly into social media, gaming, and social networking sites.",https://www.globenewswire.com/news-release/2024/12/03/2991132/0/en/RAINN-Named-Winner-of-2024-2025-Amazon-Web-Services-IMAGINE-Grant-for-Nonprofits.html,globenewswire.com,5,rainn use aws generative ai create ondemand crisis hotlines additional support medium solution integrate rainns national sexual assault hotline directly social medium gaming social networking site rainn use aws generative ai create ondemand crisis hotlines additional support medium solution integrate rainns national sexual assault hotline directly social medium gaming social networking site,-0.6808,-0.3404,0.3181633333,-0.658563333,Negative Impact
04/12/2024,215.9600067,220.00,215.75,218.16,218.16,48745700,5.66,38.78057437,1.192,0,27.30545211,0.4577403224,0.2071825716,4.48,315.605,19735.11914,20188.59961,8335.799805,7303.279785,3364.649902,80956.32813,25641.19922,195.7520004,185.1649004,198.0564092,182.1241657,206.9600006,217.6271942,196.292807,54.22212574,4.545242635,3.824389055,0.7208535805,5.455000741,196.8118083,11606956300,92.41238624,84.81574007,13.44999981,Amazon Accused Of ÃÂÃÂSecretly' Excluding Low-Income Neighborhoods From Prime Delivery By D.C. Attorney General,"Two historically low-income neighborhoods in Washington, D.C., have been secretly excluded from Amazon's expedited delivery service over the last two years, despite residents paying millions of dollars for the company's Prime membership, a lawsuit filed Wednesday alleges.",https://www.forbes.com/sites/tylerroush/2024/12/04/amazon-accused-of-secretly-excluding-low-income-neighborhoods-from-prime-delivery-by-dc-attorney-general/,forbes.com,8,two historically lowincome neighborhood washington dc secretly excluded amazon expedited delivery service last two year despite resident paying million dollar company prime membership lawsuit filed wednesday alleges,-0.3818,-0.30544,0.2985933333,-0.604033333,Negative Impact
05/12/2024,218.0299988,222.15,217.30,220.55,220.55,41140200,5.66,38.78057437,1.192,0,27.30545211,0.4577403224,0.2071825716,4.48,315.605,19700.25977,20157.43945,8349.400391,7330.540039,3368.85498,81765.85938,25680,196.3124005,185.4247004,198.9385109,182.5065124,207.6330009,219.9114418,195.3545601,59.4775404,5.197577363,4.099026716,1.098550646,5.442858015,198.2030998,11648096500,93.93942722,91.38113848,13.53999996,"If I Could Only Buy 1 ""Magnificent Seven"" Stock in December, This Would Be It","As 2024 draws to a close, many investors are probably wondering about the same things. Will there be a Santa Claus Rally this December, or will the markets sell off as investors prepare for tax loss harvesting?",https://www.fool.com/investing/2024/12/05/if-i-could-only-buy-1-magnificent-seven-stock-in-d/,fool.com,7,draw close many investor probably wondering thing santa claus rally december market sell investor prepare tax loss harvesting,-0.3182,-0.22274,0.398859375,-0.621599375,Negative Impact
06/12/2024,220.75,227.15,220.60,227.03,227.03,44178100,5.66,38.78057437,1.192,0,27.30545211,0.4577403224,0.2071825716,4.48,315.605,19859.76953,20107.78906,8308.599609,7426.879883,3404.075928,81709.11719,25691.80078,197.0298004,185.6869504,200.0401379,182.9495321,208.4820007,223.505464,193.4585374,76.85877097,6.16635691,4.512492755,1.653864155,5.066429138,200.1188513,11692274600,99.61784987,95.32322111,12.77000046,"Walmart, Amazon holiday spending rise as Target, Best Buy stumble - data","Walmart Inc , Amazon.com and fast-growing e-commerce sites Shein and PDD Holding's Temu saw record-breaking sales on Black Friday and Cyber Monday, according to spending data, suggesting that they may finish the holiday season on a much stronger note than Target and Best Buy , which struggled.",https://www.reuters.com/business/retail-consumer/walmart-amazon-holiday-spending-rise-target-best-buy-stumble-data-2024-12-06/,reuters.com,10,walmart inc amazoncom fastgrowing ecommerce site shein pdd holding temu saw recordbreaking sale black friday cyber monday according spending data suggesting may finish holiday season much stronger note target best buy struggled,0.7964,0.7964,0.30701875,0.48938125,Positive Impact
09/12/2024,227.2100067,230.08,225.67,226.09,226.09,46819400,5.66,38.78057437,1.192,0,27.30545211,0.4577403224,0.2071825716,4.48,315.605,19736.68945,20006.25977,8352.099609,7480.140137,3402.533936,81508.46094,25625.40039,197.7922003,185.9424503,201.0617009,183.3787905,209.3775009,226.3357036,192.4192983,76.80808578,6.780114401,4.966017084,1.814097317,5.115715027,202.8219656,11645455200,88.377497,93.97825803,14.18999958,3 Top Stocks to Buy This Holiday Season,"Another year is already drawing to a close. The major market indexes hit new all-time highs in 2024, and some market followers may be struggling to find investment ideas in this sea of premium valuations.",https://www.fool.com/investing/2024/12/09/3-top-stocks-to-buy-this-holiday-season/,fool.com,7,another year already drawing close major market index hit new alltime high market follower may struggling find investment idea sea premium valuation,-0.4215,-0.29505,0.3535517391,-0.648601739,Negative Impact
10/12/2024,226.0899963,229.06,224.20,225.04,225.04,31199900,5.66,38.78057437,1.192,0,27.30545211,0.4577403224,0.2071825716,4.48,315.605,19687.24023,19881.90039,8280.400391,7394.779785,3422.660889,81510.04688,25504.30078,198.5664001,186.1940003,202.0020261,183.7933298,210.2875008,228.5736518,192.0013497,73.41277835,7.099951344,5.392803936,1.707147408,4.997143337,206.0929299,11614255300,85.3189389,91.10476192,14.18000031,3 Dow Jones Stocks Billionaires Were Piling Into This Year,"Investors who follow the right billionaires can find great stocks to help them improve their returns. Chase Coleman of Tiger Global Management, Andreas Halvorsen of Viking Global Investors, and Bill Ackman of Pershing Square have built billionaire fortunes from their talents of picking winners.",https://www.fool.com/investing/2024/12/10/3-dow-jones-stocks-billionaires-piling-this-year/,fool.com,7,investor follow right billionaire find great stock help improve return chase coleman tiger global management andreas halvorsen viking global investor bill ackman pershing square built billionaire fortune talent picking winner,0.946,0.6622,0.3567977273,0.3054022727,Positive Impact
11/12/2024,226.4100037,231.20,226.26,230.26,230.26,35385800,5.66,38.78057437,1.192,0,27.30545211,0.4577403224,0.2071825716,4.48,315.605,20034.89063,19891.0293,8301.599609,7423.399902,3432.48999,81526.14063,25657.69922,199.4689999,186.4776003,203.1101818,184.2556847,211.3550003,231.6814553,191.0285453,79.05346307,7.686035071,5.851450163,1.834584908,5.068571908,208.9713785,11649641100,97.34837088,90.34826893,13.57999992,"Alphabet and Tesla reach fresh records, joining Amazon and Meta and pushing Nasdaq past 20,000","Tesla topped its 2021 peak on Wednesday and Alphabet hit a record for the first time since July. Four of tech's seven megacaps closed at all-time highs, pushing the Nasdaq past 20,000.",https://www.cnbc.com/2024/12/11/alphabet-and-tesla-reach-fresh-records-joining-amazon-and-meta-.html,cnbc.com,9,tesla topped peak wednesday alphabet hit record first time since july four tech seven megacaps closed alltime high pushing nasdaq past,0,0,0.3591991667,-0.359199167,Negative Impact
12/12/2024,229.8300018,231.09,227.63,228.97,228.97,28204100,5.66,38.78057437,1.192,0,27.30545211,0.4577403224,0.2071825716,4.48,315.605,19902.83984,19769.08984,8311.799805,7420.939941,3461.5,81289.96094,25410.69922,200.3532001,186.7566503,204.1242923,184.7006032,212.0985001,233.8832365,190.3137636,84.83260509,7.954721888,6.272104508,1.68261738,4.76285662,212.0833851,11621437000,93.52686234,92.06472404,13.92000008,"Best Stocks for 2025: Tech, Industrials, and Financials Lead","It's now the end of the investing year. As is customary, the biggest investment banks in the industry are starting to come out and issue their views for 2025.",https://www.marketbeat.com/stock-ideas/best-stocks-for-2025-tech-industrials-and-financials-lead/,marketbeat.com,5,end investing year customary biggest investment bank industry starting come issue view,0,0,0.2937126667,-0.293712667,Negative Impact
13/12/2024,228.3999939,230.20,225.86,227.46,227.46,28768100,5.66,38.78057437,1.192,0,27.30545211,0.4577403224,0.2071825716,4.48,315.605,19926.7207,19729.36914,8300.299805,7409.569824,3391.87793,82133.11719,25274.30078,201.2632001,187.0101504,205.0394184,185.1260699,212.8975006,235.733554,190.0614472,84.35237722,7.954123998,6.608508406,1.345615592,4.893571036,214.7597108,11592668900,88.38512239,93.0867852,13.81000042,"Meet the Supercharged Artificial Intelligence (AI) Growth Stock That Could Join Apple, Nvidia, and Microsoft in the $3 Trillion Club by 2027","The latest advances in artificial intelligence (AI) have had a profound impact on the tech landscape, minting a new generation of trillionaires in the process. The ability of these advanced algorithms to create new content, streamline processes, and increase productivity will usher in the fourth industrial revolution, according to many experts.",https://www.fool.com/investing/2024/12/13/meet-the-unstoppable-artificial-intelligence-ai-gr/,fool.com,7,latest advance artificial intelligence ai profound impact tech landscape minting new generation trillionaires process ability advanced algorithm create new content streamline process increase productivity usher fourth industrial revolution according many expert,0.8689,0.60823,0.3191663636,0.2890636364,Positive Impact
16/12/2024,230.2299957,233.00,228.01,232.93,232.93,37552100,5.66,38.78057437,1.192,0,27.30545211,0.4577403224,0.2071825716,4.48,315.605,20173.89063,19627.67969,8262.099609,7357.080078,3386.331055,81748.57031,25147.19922,202.1916,187.2837003,206.1331664,185.6017309,214.4135002,238.3720536,190.4549469,84.74615322,8.299362435,6.946679212,1.352683223,4.944284712,217.0613508,11630221000,99.77568949,93.89589141,14.68999958,"Amazon Ignored Warnings About Speed Quotas Causing Worker Injuries, Senate Panel Says",A Senate committee investigation found Amazon manipulated its warehouses' injury data to make them appear safer than they are and ignored internal reports linking worker injuries to speed and productivity quotasÃÂÃÂwhich the online retail giant has insisted it does not enforce.,https://www.forbes.com/sites/siladityaray/2024/12/16/amazon-ignored-warnings-about-speed-quotas-causing-worker-injuries-senate-panel-says/,forbes.com,8,senate committee investigation found amazon manipulated warehouse injury data make appear safer ignored internal report linking worker injury speed productivity quotaswhich online retail giant insisted enforce,-0.7184,-0.57472,0.110601875,-0.685321875,Negative Impact
17/12/2024,232.3899994,232.73,227.85,231.15,231.15,35948100,5.66,38.78057437,1.192,0,27.30545211,0.4577403224,0.2071825716,4.48,315.605,20109.06055,19517.60938,8195.200195,7365.700195,3361.485107,80684.45313,25119.69922,203.1985999,187.5515503,207.1142184,186.0549474,215.8860001,240.1723196,191.5996805,78.63291346,8.333274557,7.223998281,1.109276276,4.839283534,219.6115347,11594272900,93.48818773,93.88299987,15.86999989,"Amazon ignored internal warnings of warehouse injuries, Senate probe finds","For years, Amazon has faced accusations that the pressure the company puts on its warehouse workers to work more quickly has led to higher rates of injuries.",https://techxplore.com/news/2024-12-amazon-internal-warehouse-injuries-senate.html,techxplore.com,5,year amazon faced accusation pressure company put warehouse worker work quickly led higher rate injury,-0.6486,-0.3243,0.163255,-0.487555,Negative Impact
18/12/2024,230.7700043,231.40,220.11,220.52,220.52,43281400,5.66,38.78057437,1.192,0,27.30545211,0.4577403224,0.2071825716,4.48,315.605,19392.68945,18986.96094,8199.099609,7384.620117,3382.208008,80182.20313,24557,203.9545999,187.7835503,207.6399355,186.3978833,216.6815002,240.4494117,192.9135887,65.02644383,7.41690141,7.262578907,0.1543225035,5.444997515,233,11550991500,56.0718264,83.11190121,27.62000084,Amazon workers to strike at multiple US warehouses during busy holiday season,"Thousands of Amazon.com AMZN.O workers will walk off the job on Thursday at 6 a.m. ET (1100 GMT), in the crucial final days before Christmas, after union officials said the retailer failed to come to the bargaining table.",https://www.reuters.com/technology/amazon-workers-strike-multiple-us-warehouses-during-busy-holiday-season-2024-12-19/,reuters.com,10,thousand amazoncom amzno worker walk job thursday et gmt crucial final day christmas union official said retailer failed come bargaining table,-0.5106,-0.5106,0.1888505882,-0.699450588,Negative Impact
19/12/2024,224.9100037,226.09,222.92,223.29,223.29,39918700,5.66,38.78057437,1.192,0,27.30545211,0.4577403224,0.2071825716,4.48,315.605,19372.76953,18958.21094,8105.299805,7294.370117,3370.032959,79218.04688,24413.90039,204.7169998,188.0324503,208.2536633,186.764969,217.7019997,240.7155069,194.6884924,65.46185453,6.835389933,7.177141112,-0.341751179,5.584996905,232.7422,11590910200,58.66324205,69.40775206,24.09000015,Amazon agrees to worker safety measures to settle US probe,"Amazon.com will implement new safety measures at all of its U.S. facilities to settle a federal agency's claims that it failed to prevent workers from developing back problems and other ergonomic injuries, the agency said on Thursday.",https://www.reuters.com/technology/amazon-agrees-worker-safety-measures-settle-us-probe-2024-12-19/,reuters.com,10,amazoncom implement new safety measure u facility settle federal agency claim failed prevent worker developing back problem ergonomic injury agency said thursday,-0.7096,-0.7096,0.02695608696,-0.736556087,Negative Impact
20/12/2024,219.8399963,226.21,218.73,224.92,224.92,88279200,5.66,38.78057437,1.192,0,27.30545211,0.4577403224,0.2071825716,4.48,315.605,19572.59961,19119.43945,8084.600098,7274.47998,3368.069092,78041.59375,24599.5,205.4823999,188.2729503,208.9072451,187.144621,219.0289993,240.3498251,197.7081735,64.61633888,6.431922471,7.028097384,-0.596174913,5.754997253,232.489556,11679189400,65.39614681,60.04373842,18.36000061,"At Christmas, Slowdowns Loom In Both Air Travel And Amazon Shipping","With Christmas five days away, potential breakdowns in two critical transportation sectors are threatening to disrupt both holiday travel and overnight shipping.",https://www.forbes.com/sites/tedreed/2024/12/20/at-christmas-slowdowns-loom-in-both-air-travel-and-amazon-shipping/,forbes.com,8,christmas five day away potential breakdown two critical transportation sector threatening disrupt holiday travel overnight shipping,-0.4588,-0.36704,0.2234341176,-0.590474118,Negative Impact
23/12/2024,225.0099945,226.88,223.90,225.06,225.06,28070000,5.66,38.78057437,1.192,0,27.30545211,0.4577403224,0.2071825716,4.48,315.605,19764.88086,19207.10938,8102.700195,7272.319824,3351.25708,78540.17188,24749,206.2071997,188.5215002,209.5406863,187.5218884,220.4259995,239.2133409,201.638658,62.62495176,6.053685266,6.83321496,-0.779529695,5.655711583,231.9391736,11707259400,53.97100034,59.34346307,16.78000069,Amazon Has Officially Entered the Car Dealer Business,"In this podcast, Motley Fool analyst Asit Sharma and host Mary Long discuss:",https://www.fool.com/investing/2024/12/23/amazon-has-officially-entered-the-car-dealer-busin/,fool.com,7,podcast motley fool analyst asit sharma host mary long discus,-0.4404,-0.30828,0.2380428571,-0.546322857,Negative Impact
24/12/2024,226.9400024,229.14,226.13,229.05,229.05,15007500,5.66,38.78057437,1.192,0,27.30545211,0.4577403224,0.2071825716,4.48,315.605,20031.13086,19341.48047,8137,7282.689941,3393.528076,78472.86719,24846.80078,207.0373999,188.8069502,210.3057576,187.9351035,221.8059998,238.6818729,204.9301266,62.02253074,6.006648745,6.667901717,-0.661252972,5.478569031,231.4108065,11722266900,74.84077888,64.73597534,14.27000046,"AMD and Nvidia Back Musk's xAI. What It Means for Microsoft, Google and Amazon.",Nvidia and AMD's participation in xAI's funding round means they are directly financing a rival to their major customers.,https://www.barrons.com/articles/amd-nvidia-xai-fundraising-87032109,barrons.com,9,nvidia amd participation xais funding round mean directly financing rival major customer,0,0,0.36167,-0.36167,Negative Impact
26/12/2024,228.5,228.50,226.67,227.05,227.05,16146700,5.66,38.78057437,1.192,0,27.30545211,0.4577403224,0.2071825716,4.48,315.605,20020.35938,19364.5,#N/A,#N/A,3398.076904,78472.47656,#N/A,207.8245999,189.0652502,210.9623946,188.3243065,222.7654999,238.4423186,207.0886811,57.23831325,5.741800773,6.482681528,-0.740880755,5.302141462,230.9035741,11706120200,58.30416842,62.37198255,14.72999954,"Waymo dominated U.S. robotaxi market in 2024, but Tesla and Amazon's Zoox loom","Despite General Motor's decision to shutter its Cruise robotaxi business earlier this month, the U.S. has never been closer to a driverless future. For the autonomous vehicle industry, 2024 will be remembered as the year that at least one major U.S. player -- Alphabet-owned Waymo -- saw glimmers of mainstream adoption.",https://www.cnbc.com/2024/12/26/waymo-dominated-us-robotaxi-market-in-2024-but-tesla-zoox-loom.html,cnbc.com,9,despite general motor decision shutter cruise robotaxi business earlier month u never closer driverless future autonomous vehicle industry remembered year least one major u player alphabetowned waymo saw glimmer mainstream adoption,0,0,0.34505,-0.34505,Negative Impact
27/12/2024,225.6000061,226.03,220.90,223.75,223.75,27367100,5.66,38.78057437,1.192,0,27.30545211,0.4577403224,0.2071825716,4.33,315.605,19722.0293,19238.48047,8149.799805,7355.370117,3400.14209,78699.07031,24796.40039,208.5617999,189.3012003,211.4638694,188.676801,223.6659996,237.1392195,210.1927797,46.06903034,5.205617067,6.227268636,-1.021651569,5.269999913,230.4166309,11678753100,35.17871597,56.10788776,15.94999981,"Forget the Santa Claus Rally -- Artificial Intelligence Stocks Like Broadcom, Amazon, and Rivian Dragged the Stock Market Down Today",Artificial intelligence (AI) and tech stocks dragged the Nasdaq Composite (^IXIC -1.44%) down as much as 2.4% at one point today. The Dow Jones Industrial Average (^DJI -0.57%) lost as much as 500 points in a holiday-shortened week usually powered by a Santa Claus rally that has failed to materialize thus far.,https://www.fool.com/investing/2024/12/27/forget-the-santa-claus-rally-artificial-intelligen/,fool.com,7,artificial intelligence ai tech stock dragged nasdaq composite ixic much one point today dow jones industrial average dji lost much point holidayshortened week usually powered santa claus rally failed materialize thus far,-0.4019,-0.28133,0.3155971429,-0.596927143,Negative Impact
30/12/2024,220.0599976,223.00,218.43,221.30,221.30,28321200,5.66,38.78057437,1.192,0,27.30545211,0.4577403224,0.2071825716,4.33,315.605,19486.78906,19077.92969,8121,7313.560059,3407.325928,78248.13281,24620.59961,209.2372,189.5139503,211.8496001,189.0014099,224.3364998,235.6686218,213.0043777,44.45986914,4.530765495,5.887968008,-1.357202513,5.335000174,229.9491655,11650431900,19.69807092,37.7269851,17.39999962,Amazon (AMZN) is a Top-Ranked Momentum Stock: Should You Buy?,"Whether you're a value, growth, or momentum investor, finding strong stocks becomes easier with the Zacks Style Scores, a top feature of the Zacks Premium research service.",https://www.zacks.com/stock/news/2389520/amazon-amzn-is-a-top-ranked-momentum-stock-should-you-buy?cid=CS-STOCKNEWSAPI-FT-tale_of_the_tape|zacks_education_momentum_score-2389520,zacks.com,8,whether youre value growth momentum investor finding strong stock becomes easier zacks style score top feature zacks premium research service,0.8979,0.71832,0.3269375,0.3913825,Positive Impact
31/12/2024,222.9700012,223.23,218.94,219.39,219.39,24819700,5.66,38.78057437,1.192,0,27.30545211,0.4577403224,0.2071825716,4.33,315.605,19310.78906,19097.09961,8173,7380.740234,3351.762939,78139.00781,24727.90039,209.8451999,189.7388003,212.145302,189.303784,224.7704994,234.4495614,215.0914375,43.59265335,3.79803801,5.469982008,-1.671943998,5.294285366,229.2580152,11625612200,6.588924031,20.48857031,17.35000038,REITs To Avoid In 2025,REITs To Avoid In 2025,https://seekingalpha.com/article/4746396-reits-to-avoid-in-2025,seekingalpha.com,6,reit avoid,-0.296,-0.1776,0.3760777778,-0.553677778,Negative Impact
02/01/2025,222.0299988,225.15,218.19,220.22,220.22,33956600,5.66,38.78057437,1.192,0,27.30545211,0.4577403224,0.2071825716,4.33,317.671,19280.78906,19095.41992,8260.099609,7393.759766,3262.561035,79943.71094,24898,210.4681998,189.9675003,212.4619569,189.611408,225.1094994,233.5078525,216.7111462,37.35516149,3.246892258,5.025364058,-1.7784718,5.351427351,228.6083338,11659568800,13.70694878,13.33131458,17.93000031,"Seattle preps for traffic nightmare as 50,000 Amazon workers return to office full time","State transit officials are urging drivers to prepare for gridlock as an estimated 50,000 Amazon corporate workers heed CEO Andy Jassy's directive.",https://nypost.com/2025/01/02/business/seattle-girds-for-gridlock-as-50000-amazon-workers-return-to-office/,nypost.com,5,state transit official urging driver prepare gridlock estimated amazon corporate worker heed ceo andy jassys directive,0.1779,0.08895,0.4308716667,-0.341921667,Negative Impact
03/01/2025,222.5099945,225.36,221.62,224.19,224.19,27515600,5.66,38.78057437,1.192,0,27.30545211,0.4577403224,0.2071825716,4.33,317.671,19621.67969,19254.28906,8224,7282.220215,3211.429932,79223.10938,25073.5,211.1579999,190.2089503,212.9218803,189.9554736,225.4109993,233.1672943,217.6547043,44.36054546,3.094776541,4.639246555,-1.544470014,5.471427917,227.7748673,11687084400,40.51317346,20.26968209,16.12999916,These 5 Artificial Intelligence (AI) Stocks Make Up 28.8% of the Entire S&P 500 Index,"The S&P 500 (^GSPC -0.22%) is home to 500 companies from 11 different sectors of the economy, making it the most diversified of the major U.S. stock market indexes.",https://www.fool.com/investing/2025/01/03/these-5-ai-stocks-make-288-entire-sp-500-index/,fool.com,7,sp gspc home company different sector economy making diversified major u stock market index,0,0,0.4094175,-0.4094175,Negative Impact
06/01/2025,226.7799988,228.84,224.84,227.61,227.61,31849800,5.66,38.78057437,1.192,0,27.30545211,0.4577403224,0.2071825716,4.33,317.671,19864.98047,19261.41992,8249.700195,7445.689941,3206.923096,77964.99219,24999.80078,212.0159998,190.4562504,213.497885,190.3301455,225.7639992,233.2258274,218.302171,50.16933164,3.213149819,4.354027208,-1.140877389,5.4935706,218.1900024,11718934200,63.60566997,39.27526407,16.04000092,These 4 Stocks Boast Impressive Interest Coverage Ratios,"LDOS, AMZN, HALO & BMRN's impressive interest coverage ratios highlight that these companies can withstand financial hardships.",https://www.zacks.com/stock/news/2392304/these-4-stocks-boast-impressive-interest-coverage-ratios?cid=CS-STOCKNEWSAPI-FT-analyst_blog|rw-2392304,zacks.com,8,ldos amzn halo bmrns impressive interest coverage ratio highlight company withstand financial hardship,0.7506,0.60048,0.2138528571,0.3866271429,Positive Impact
07/01/2025,227.8999939,228.38,221.46,222.11,222.11,28084200,5.66,38.78057437,1.192,0,27.30545211,0.4577403224,0.2071825716,4.33,317.671,19489.67969,19213.88086,8245.299805,7489.350098,3229.644043,78199.10938,24929.90039,212.7305997,190.6760504,213.835615,190.646363,225.5179993,233.1270425,217.908956,37.79332807,2.830528885,4.049327543,-1.218798659,5.592142378,218.4030023,11690850000,26.9601099,43.69298444,17.81999969,These Were the 5 Top-Performing Stocks in the Dow Jones Industrial Average in 2024,"Rising over 13% in 2024, the Dow Jones Industrial Average lagged the S&P 500, which soared 23%. But the diversity among the performances of the individual Dow Jones stocks was considerable.",https://www.fool.com/investing/2025/01/07/these-were-the-5-top-performing-stocks-in-the-dow/,fool.com,7,rising dow jones industrial average lagged sp soared diversity among performance individual dow jones stock considerable,-0.296,-0.2072,0.39291,-0.60011,Negative Impact
08/01/2025,223.1900024,223.52,220.20,222.13,222.13,25033300,5.66,38.78057437,1.192,0,27.30545211,0.4577403224,0.2071825716,4.33,317.671,19478.88086,19240.74023,8251,7452.419922,3230.167969,78148.49219,25051.69922,213.4165997,190.8923505,214.1608852,190.9596331,225.3199997,233.0711362,217.5688631,39.40320779,2.500093691,3.739480773,-1.239387082,5.466429574,218.6117422,11715883300,29.82592725,40.13056904,17.70000076,Here's Why Amazon (AMZN) Gained But Lagged the Market Today,"The latest trading day saw Amazon (AMZN) settling at $222.15, representing a +0.02% change from its previous close.",https://www.zacks.com/stock/news/2394016/here-s-why-amazon-amzn-gained-but-lagged-the-market-today?cid=CS-STOCKNEWSAPI-FT-tale_of_the_tape|yseop_template_6-2394016,zacks.com,8,latest trading day saw amazon amzn settling representing change previous close,0.1779,0.14232,0.49896,-0.35664,Negative Impact
10/01/2025,221.4600067,221.71,216.50,218.94,218.94,36811500,5.66,38.78057437,1.192,0,27.30545211,0.4577403224,0.2071825716,4.33,317.671,19161.63086,18963.00977,8248.5,7431.040039,3168.523926,77378.90625,24767.69922,214.0275998,191.0885004,214.3483016,191.2380447,225.0150002,233.2758275,216.7541728,47.75056753,1.958241494,3.383232917,-1.424991423,5.062144688,228.8399963,11679071800,19.30381772,25.36328495,19.54000092,AI picks 2 tech stocks to buy for 2025 and beyond,"In the aftermath of the 2008 financial crisis, as traditional industries struggled to regain footing, investors turned to big tech, which had grown and evolved significantly since the dot-com crash.",https://finbold.com/ai-picks-2-tech-stocks-to-buy-for-2025-and-beyond/,finbold.com,5,aftermath financial crisis traditional industry struggled regain footing investor turned big tech grown evolved significantly since dotcom crash,-0.8481,-0.42405,0.104435,-0.528485,Negative Impact
13/01/2025,218.0599976,219.40,216.47,218.46,218.46,27262700,5.66,38.78057437,1.192,0,27.30545211,0.4577403224,0.2071825716,4.33,317.671,19088.09961,19047.33008,8224.200195,7408.640137,3160.754883,76330.00781,24536.30078,214.5801999,191.2893005,214.5095449,191.50891,224.4250008,232.7933876,216.056614,42.64394752,1.473107019,3.001207737,-1.528100718,4.873573303,228.5931964,11651809100,15.70643868,21.61206122,19.19000053,"Jeff Bezos enables Trump's threat to democracy, Washington Post columnist Rubin says as she quits","Amazon founder Jeff Bezos ""and his cronies"" are enabling ""the most acute threat to American democracy"" ÃÂÃÂ President-elect Donald Trump ÃÂÃÂ a Washington Post columnist warned as she resigned. Jennifer Rubin also called out ABC and Meta CEO Mark Zuckerberg as targets, and announced she was co-launching a new media outlet, The Contrarian, on Substack.",https://www.cnbc.com/2025/01/13/jeff-bezos-trump-democracy-washington-post-jennifer-rubin.html,cnbc.com,9,amazon founder jeff bezos crony enabling acute threat american democracy presidentelect donald trump washington post columnist warned resigned jennifer rubin also called abc meta ceo mark zuckerberg target announced colaunching new medium outlet contrarian substack,-0.7003,-0.63027,0.2397193333,-0.869989333,Negative Impact
14/01/2025,220.4400024,221.82,216.20,217.76,217.76,24711700,5.66,38.78057437,1.192,0,27.30545211,0.4577403224,0.2071825716,4.33,317.671,19044.39063,19176.65039,8201.5,7423.669922,3240.939941,76499.63281,24588.59961,215.0807999,191.4789504,214.6370135,191.7701148,223.8645004,232.4499726,215.2790282,38.77743232,1.020386932,2.605043576,-1.584656644,4.740716117,228.1082686,11627097400,12.05562028,15.68862556,18.70999908,"Alphabet Stock Has Room to Run, Analysts Say. Amazon Stock's Move Is Less Certain.",Tech stocks haven't had the strongest start to the new year.,https://www.barrons.com/articles/alphabet-amazon-stock-ai-tech-6ed6c5e3,barrons.com,9,tech stock havent strongest start new year,-0.3412,-0.30708,0.1706578947,-0.477737895,Negative Impact
15/01/2025,222.8300018,223.57,220.75,223.35,223.35,31291300,5.66,38.78057437,1.192,0,27.30545211,0.4577403224,0.2071825716,4.33,317.671,19511.23047,19422.71094,8301.099609,7474.589844,3227.116943,76724.07813,24789.30078,215.8198001,191.6938004,214.9786995,192.0843426,223.6590004,232.0772327,215.2407681,47.71085706,1.099990218,2.304032905,-1.204042687,4.942859105,227.3937723,11658388700,55.25508351,27.67238082,16.12000084,"India Online Grocery Market Report 2024-2029, Featuring Avenue E-commerce, Spencer's Retail, Dunzo Digital, Kiranakart Technologies, Max Hypermarket, Natures Basket, BigBasket, Grofers & Amazon Pantry",India's Online Grocery Market to Surge with CAGR of 31.33% from 2024 to 2029 India's Online Grocery Market to Surge with CAGR of 31.33% from 2024 to 2029,https://www.globenewswire.com/news-release/2025/01/15/3010117/28124/en/India-Online-Grocery-Market-Report-2024-2029-Featuring-Avenue-E-commerce-Spencer-s-Retail-Dunzo-Digital-Kiranakart-Technologies-Max-Hypermarket-Natures-Basket-BigBasket-Grofers-Ama.html,globenewswire.com,5,india online grocery market surge cagr india online grocery market surge cagr,0,0,0.3550536364,-0.355053636,Negative Impact
16/01/2025,224.4199982,224.65,220.31,220.66,220.66,24757300,5.66,38.78057437,1.192,0,27.30545211,0.4577403224,0.2071825716,4.33,317.671,19338.28906,19548.63086,8391.900391,7634.740234,3236.031982,77042.82031,24846.19922,216.2744003,191.8922504,215.2014957,192.3686775,223.0455009,230.3311258,215.7598761,38.36339587,0.9352348736,2.030273298,-1.095038425,4.961430141,226.7221458,11633631400,35.28486495,34.19852291,16.60000038,Amazon opens Cape Town walk-in centre as strives for market-share,"U.S. e-commerce giant Amazon.com opened on Thursday a walk-in centre in South Africa that it says will help its independent sellers attract more customers and expand their businesses, while it also seeks to gain market share.",https://www.reuters.com/technology/amazon-opens-cape-town-walk-in-centre-strives-market-share-2025-01-16/,reuters.com,10,u ecommerce giant amazoncom opened thursday walkin centre south africa say help independent seller attract customer expand business also seek gain market share,0.9022,0.9022,0.4495453846,0.4526546154,Positive Impact
17/01/2025,225.8399963,226.51,223.08,225.94,225.94,42370100,5.66,38.78057437,1.192,0,27.30545211,0.4577403224,0.2071825716,4.33,317.671,19630.19922,19607.36914,8505.200195,7709.75,3241.821045,76619.32813,25067.90039,216.8776004,192.1185004,215.6226136,192.7027206,222.7850014,229.1670436,216.4029592,48.58886385,1.216691588,1.867556956,-0.650865368,5.209286281,216.1999969,11676001500,77.0570092,55.86565255,15.97000027,Top Stocks to Buy for Cloud Computing Exposure,"Cloud-related players have seen a lot of attention amid the AI frenzy, with many soaring as a result. For those seeking exposure, this tool has that covered.",https://www.zacks.com/commentary/2398632/top-stocks-to-buy-for-cloud-computing-exposure?cid=CS-STOCKNEWSAPI-FT-investment_ideas-2398632,zacks.com,8,cloudrelated player seen lot attention amid ai frenzy many soaring result seeking exposure tool covered,-0.3182,-0.25456,0.290265,-0.544825,Negative Impact
21/01/2025,228.8999939,231.78,226.94,230.71,230.71,39951500,5.66,38.78057437,1.192,0,27.30545211,0.4577403224,0.2071825716,4.33,317.671,19756.7793,19893.58984,8548.299805,7770.950195,3242.623047,75838.35938,25281.59961,217.5018005,192.3600005,216.2142761,193.0809025,223.2945015,230.4903101,216.0986929,58.52941297,1.803853838,1.854816333,-0.050962495,5.187142508,216.4061969,11715953000,93.13227253,68.49138223,15.06000042,"AWS, Robotics, Prime Video Ads Fuel Amazon Growth Potential: Analysts",Wall Street analysts rerated Amazon.com Inc AMZN as the U.S. kicked in its earnings season last week.,https://www.benzinga.com/analyst-ratings/price-target/25/01/43110753/aws-robotics-prime-video-ads-fuel-amazon-growth-potential-analysts,benzinga.com,5,wall street analyst rerated amazoncom inc amzn u kicked earnings season last week,0,0,0.388402,-0.388402,Negative Impact
22/01/2025,232.0200043,235.44,231.19,235.01,235.01,41448200,5.66,38.78057437,1.192,0,27.30545211,0.4577403224,0.2071825716,4.33,317.671,20009.33984,19827.61914,8545.099609,7837.399902,3213.624023,76404.99219,25311.5,218.0602005,192.6350504,216.9513631,193.4981074,223.8805016,232.7815745,214.9794286,66.07266542,2.586343472,2.00112176,0.5852217113,5.144998823,217.021149,11757401200,97.76503216,89.31810463,15.10000038,"Amazon exits Quebec operations, to cut about 1,700 jobs","E-commerce giant Amazon.com is exiting its operations in Quebec, leading to the loss of about 1,700 full-time jobs, a company spokesperson said on Wednesday.",https://www.reuters.com/technology/amazon-exits-quebec-operations-cut-about-1700-jobs-2025-01-22/,reuters.com,10,ecommerce giant amazoncom exiting operation quebec leading loss fulltime job company spokesperson said wednesday,-0.3182,-0.3182,0.28469625,-0.60289625,Negative Impact
23/01/2025,234.1000061,235.52,231.51,235.42,235.42,26404400,5.66,38.78057437,1.192,0,27.30545211,0.4577403224,0.2071825716,4.33,317.671,20053.67969,19978.7793,8565.200195,7892.609863,3230.164063,76520.38281,25434.09961,218.5676004,192.8868004,217.6756233,193.9152406,224.4055016,234.6950481,214.115955,69.47750822,3.202637996,2.241425008,0.9612129885,5.125,218.1262802,11783805600,99.48237026,96.79322499,15.02000046,Canada to Review Amazon Contracts After Quebec Layoffs,"Canada has warned Amazon.com that it is reviewing business ties with the company's cloud-computing unit following Amazon's decision to shut down its warehouses in Quebec, leading to the layoff of 1,700 workers.",https://www.wsj.com/articles/canada-to-review-amazon-contracts-after-quebec-layoffs-d458ea66,wsj.com,9,canada warned amazoncom reviewing business tie company cloudcomputing unit following amazon decision shut warehouse quebec leading layoff worker,-0.1027,-0.09243,0.3224892308,-0.414919231,Negative Impact
24/01/2025,234.5,236.40,232.93,234.85,234.85,25890700,5.66,38.78057437,1.192,0,27.30545211,0.4577403224,0.2071825716,4.33,317.671,19954.30078,19997.4707,8502.400391,7927.620117,3252.625977,76190.46094,25468.5,219.1010007,193.1351004,218.3491285,194.3225517,224.895002,236.1972817,213.5927223,67.88945909,3.60352308,2.513844622,1.089678458,4.875714983,219.5177781,11757914900,92.32679194,96.52473146,14.85000038,Amazon Willing to Discuss Quebec Shutdown With Canadian Officials,"Amazon.com said it is open to talks with officials from the Canadian and Quebec governments about the decision to shut down operations in the country's French-speaking province, which would lead to 1,700 people losing their jobs.",https://www.wsj.com/articles/amazon-willing-to-discuss-quebec-shutdown-with-canadian-officials-610e5f59,wsj.com,9,amazoncom said open talk official canadian quebec government decision shut operation country frenchspeaking province would lead people losing job,-0.3818,-0.34362,0.26994,-0.61356,Negative Impact
27/01/2025,226.2100067,235.61,225.86,235.42,235.42,49428300,5.66,38.78057437,1.192,0,27.30545211,0.4577403224,0.2071825716,4.33,317.671,19341.83008,19980,8503.700195,7906.580078,3250.601074,75366.17188,25289.19922,219.6726007,193.3838504,219.0185744,194.7314816,225.2135017,237.3379001,213.0891034,64.97731939,3.922010497,2.795477797,1.1265327,5.205000741,221.2059997,11807343200,95.14853527,95.65256583,17.89999962,Whole Foods workers in Philadelphia vote to form Amazon-owned grocery store's first union,Workers at a Whole Foods store in Philadelphia voted to join the United Food and Commercial Workers union. The vote marks the first successful organizing effort at Whole Foods since Amazon acquired the grocer for $13.7 billion in 2017.,https://www.cnbc.com/2025/01/27/whole-foods-workers-vote-to-form-amazon-chains-first-union.html,cnbc.com,9,worker whole food store philadelphia voted join united food commercial worker union vote mark first successful organizing effort whole food since amazon acquired grocer billion,0.8591,0.77319,0.3561371429,0.4170528571,Positive Impact
28/01/2025,234.2899933,241.77,233.98,238.15,238.15,41587200,5.66,38.78057437,1.192,0,27.30545211,0.4577403224,0.2071825716,4.33,317.671,19733.58984,19970.63086,8533.900391,7897.370117,#N/A,75901.40625,25419.5,220.2574005,193.6448504,219.7688261,195.1635066,225.7685013,239.193337,212.3436655,64.32064186,4.344619837,3.105306205,1.239313632,5.429287502,222.7253991,11848930400,85.84274799,91.10602507,16.40999985,Amazon Is Battling Unions On Two Fronts In Its Flagship Business And Now Whole Foods,"After successful unionization efforts by Amazon workers in a Staten Island warehouse and more widely across Amazon's third-party delivery operations, employees at an Amazon-owned Whole Foods store in Philadelphia have voted to join the United Food and Commercial Workers union. It's the first move by Whole Foods workers to unionize and more may follow as public opinion has turned overwhelmingly positive toward unions, rising from 48% approval in 2019 to 70% last year, according to Gallup.",https://www.forbes.com/sites/pamdanziger/2025/01/28/amazon-is-battling-unions-on-two-fronts-in-its-flagship-business-and-now-whole-foods/,forbes.com,8,successful unionization effort amazon worker staten island warehouse widely across amazon thirdparty delivery operation employee amazonowned whole food store philadelphia voted join united food commercial worker union first move whole food worker unionize may follow public opinion turned overwhelmingly positive toward union rising approval last year according gallup,0.9468,0.75744,0.293716875,0.463723125,Positive Impact
29/01/2025,239.0200043,240.39,236.15,237.07,237.07,26091700,5.66,38.78057437,1.192,0,27.30545211,0.4577403224,0.2071825716,4.33,317.671,19632.32031,19927.4707,8557.799805,7872.47998,#N/A,76532.96094,25473.30078,220.7168005,193.8849504,220.4473038,195.5804867,226.4345016,240.731009,212.1379943,73.1006972,4.540059908,3.392256946,1.147802962,5.237859453,225.0107517,11822838700,81.61910206,87.53679511,16.55999947,Goldman Sachs hires Amazon exec in senior AI engineering role,"Goldman Sachs has hired Daniel Marcu from Amazon.com as its global head of artificial intelligence engineering and science to help develop and refine artificial intelligence platforms and products, according to a memo seen by Reuters.",https://www.reuters.com/technology/artificial-intelligence/goldman-sachs-hires-amazon-exec-senior-ai-engineering-role-2025-01-29/,reuters.com,10,goldman sachs hired daniel marcu amazoncom global head artificial intelligence engineering science help develop refine artificial intelligence platform product according memo seen reuters,0.836,0.836,0.189666875,0.646333125,Positive Impact
30/01/2025,237.1399994,237.95,232.22,234.64,234.64,32020700,5.66,38.78057437,1.192,0,27.30545211,0.4577403224,0.2071825716,4.33,317.671,19681.75,20166.2207,8646.900391,7941.640137,#N/A,76759.8125,25808.30078,221.1800006,194.1275004,221.0038801,195.9691385,227.1015015,241.6322125,212.5707904,67.97929997,4.44759711,3.603324978,0.8442721312,5.410001482,227.021862,11790818000,72.11574955,79.85919987,15.84000015,"UPS shares tank 17% after weak guidance, plan to slash Amazon deliveries by more than half","UPS shares tumbled on Thursday after the shipping giant said it would slash Amazon deliveries by more than half. CEO Carol Tome said the move would ""put us further down the path to become a more profitable, agile and differentiated UPS that is growing in the best parts of the market.",https://www.cnbc.com/2025/01/30/ups-shares-tank-after-weak-guidance-plan-to-slash-amazon-deliveries.html,cnbc.com,9,ups share tumbled thursday shipping giant said would slash amazon delivery half ceo carol tome said move would put u path become profitable agile differentiated ups growing best part market,0.8625,0.77625,0.09241352941,0.6838364706,Positive Impact
31/01/2025,236.5,240.29,236.41,237.68,237.68,36162400,5.66,38.78057437,1.192,0,27.30545211,0.4577403224,0.2071825716,4.33,317.671,19627.43945,19998.82031,8674,7950.169922,#N/A,77500.57031,25533.09961,221.8814005,194.3978004,221.6578453,196.3841719,228.0160011,242.8031466,213.2288556,77.04965188,4.566976466,3.796055276,0.77092119,5.411429269,228.7916391,11826980400,84.00465223,79.24650128,16.43000031,"Jim Cramer's week ahead: Earnings from Amazon, Alphabet, Eli Lilly, Palantir","CNBC's Jim Cramer on Friday walked investors through an earnings-heavy week, highlighting reports from Amazon, Alphabet, Eli Lilly and Palantir, as well as a key inflation metric from the Labor Department. ""When you get a week that's packed with important earnings reports and the monthly employment report plus the tariff news, you're usually better off sitting on your hands,"" he said.",https://www.cnbc.com/2025/01/31/jim-cramers-week-ahead-earnings-from-amazon-alphabet-eli-lilly-palantir.html,cnbc.com,9,cnbcs jim cramer friday walked investor earningsheavy week highlighting report amazon alphabet eli lilly palantir well key inflation metric labor department get week thats packed important earnings report monthly employment report plus tariff news youre usually better sitting hand said,0.8658,0.77922,0.2480572727,0.5311627273,Positive Impact
03/02/2025,234.0599976,239.25,232.90,237.42,237.42,37285900,5.66,38.78057437,1.192,0,27.30545211,0.4577403224,0.2071825716,4.33,317.671,19391.96094,19870.33008,8583.599609,7854.919922,#N/A,77186.74219,25241.80078,222.5958005,194.6683003,222.275969,196.7924886,228.876001,243.7544488,213.9975532,77.54212793,4.587721682,3.954388557,0.633333125,5.655715942,230.3490429,11789694500,82.98785742,79.70275307,18.62000084,"If You Buy Amazon Stock Today, Will You Become a Millionaire by 2030?","To say that Amazon (AMZN -0.11%) has been a wildly successful investment would be putting it very lightly. The e-commerce, cloud computing, and digital advertising juggernaut's shares have catapulted 1,420% higher in the past decade (as of Jan. 30).",https://www.fool.com/investing/2025/02/03/buy-amazon-stock-today-become-millionaire-2030/,fool.com,7,say amazon amzn wildly successful investment would putting lightly ecommerce cloud computing digital advertising juggernaut share catapulted higher past decade jan,0.7717,0.54019,0.185185,0.355005,Positive Impact
04/02/2025,239.0099945,242.52,238.03,242.06,242.06,29713800,5.66,38.78057437,1.192,0,27.30545211,0.4577403224,0.2071825716,4.33,317.671,19654.01953,19964.60938,8570.799805,7906.399902,#N/A,78583.8125,25279.40039,223.3448004,194.9722003,223.0518132,197.2429116,229.7695007,245.5801656,213.9588358,81.67364702,4.921835729,4.147877992,0.7739577379,5.61857278,231.7195583,11819408300,97.92883127,88.30711364,17.20999908,3 Stocks Thriving Despite Tariffs Concerns,"Trade war and tariff headlines seem to be rolling in by the hour, adding a significant degree of uncertainty to this market and rattling investors. While some stocks and sectors struggle under the pressure, others, especially leading stocks continue to power higher unfazed.",https://www.zacks.com/commentary/2409484/3-stocks-thriving-despite-tariffs-concerns?cid=CS-STOCKNEWSAPI-FT-investment_ideas-2409484,zacks.com,8,trade war tariff headline seem rolling hour adding significant degree uncertainty market rattling investor stock sector struggle pressure others especially leading stock continue power higher unfazed,-0.8402,-0.67216,0.2651978947,-0.937357895,Negative Impact
05/02/2025,237.0200043,238.32,235.20,236.17,236.17,38727300,5.66,38.78057437,1.192,0,27.30545211,0.4577403224,0.2071825716,4.33,317.671,19692.33008,20128.89063,8623.299805,7891.680176,3229.488037,78271.28125,25569.80078,224.0106003,195.2569503,223.5662518,197.6302458,230.1975006,246.2239957,214.1710055,66.5804527,4.657659197,4.249834233,0.4078249646,5.693571908,232.8999939,11780681000,71.40925626,84.10864832,15.77000046,"Trump sued over purge at NLRB, regulator targeted by SpaceX, Amazon and others","Former National Labor Relations Board chair Gwynne Wilcox accused President Donald Trump of effectively shutting down NLRB operations by ""illegally"" firing her. Wilcox, an appointee of Democratic former President Joe Biden, in a federal lawsuit asked a judge to reinstate her as an NLRB member and declare that her firing was unlawful.",https://www.cnbc.com/2025/02/05/trump-sued-nlrb-spacex-amazon-musk.html,cnbc.com,9,former national labor relation board chair gwynne wilcox accused president donald trump effectively shutting nlrb operation illegally firing wilcox appointee democratic former president joe biden federal lawsuit asked judge reinstate nlrb member declare firing unlawful,-0.6124,-0.55116,0.274496087,-0.825656087,Negative Impact
06/02/2025,238.0099945,239.66,236.01,238.83,238.83,60897100,5.66,38.78057437,1.192,0,27.30545211,0.4577403224,0.2071825716,4.33,317.671,19791.99023,20157.58008,8727.299805,8007.620117,3270.658936,78058.15625,25534.5,224.8196002,195.5779503,224.1648303,198.0401936,231.0335007,247.0280069,215.0389944,73.51801372,4.609798569,4.3218271,0.2879714689,5.644287109,234.2467953,11841578100,81.01850834,83.45219863,15.5,"Flat Day Ahead of Friday Jobs Report; Q4 Results for AMZN, SKX, EXPE",#ERROR!,https://www.zacks.com/stock/news/2411626/flat-day-ahead-of-friday-jobs-report-q4-results-for-amzn-skx-expe?cid=CS-STOCKNEWSAPI-FT-ahead_of_wall_street-2411626,zacks.com,8,"Flat Day Ahead of Friday Jobs Report; Q4 Results for AMZN, SKX, EXPE",-0.4019,-0.32152,0.2362242623,-0.557744262,Negative Impact
07/02/2025,232.5,234.81,228.06,229.15,229.15,77539300,5.66,38.78057437,1.192,0,27.30545211,0.4577403224,0.2071825716,4.33,317.671,19523.40039,20039.48047,8700.5,7973.029785,3303.666992,77860.1875,25442.90039,225.4602002,195.8375503,224.3603269,198.3497438,231.3845001,246.8558756,215.9131246,53.72994867,3.747573243,4.206976329,-0.459403085,5.99571664,242.5200043,11764038800,19.74785452,57.39187304,16.54000092,"Amazon Stock Down On $100 Billion CapEx, Doubts About AI Payoff","The business of generative AI teeters on an upside down pyramid. With the exception of Nvidia which has benefited tremendously from the $1 trillion in capital spending by cloud services providers, those using AI chatbots are still in search of a killer app, I noted in Brain Rush.",https://www.forbes.com/sites/petercohan/2025/02/07/amazon-stock-down-on-100-billion-capex-doubts-about-ai-payoff/,forbes.com,8,business generative ai teeter upside pyramid exception nvidia benefited tremendously trillion capital spending cloud service provider using ai chatbots still search killer app noted brain rush,-0.6486,-0.51888,0.2233709091,-0.742250909,Negative Impact
10/02/2025,230.5500031,233.92,229.20,233.14,233.14,35419900,5.66,38.78057437,1.192,0,27.30545211,0.4577403224,0.2071825716,4.33,317.671,19714.26953,20117.88086,8767.799805,8006.220215,3322.169922,77311.79688,25658.90039,226.0940002,196.1055503,224.7046278,198.6959155,232.0945,246.4223213,217.7666787,52.87573305,3.34762423,4.035105909,-0.687481679,5.919288635,242.2308041,11799458700,43.69746206,48.15460831,15.81000042,"This Analyst With 86% Accuracy Rate Sees More Than 18% Upside In Amazon.com, - Here Are 5 Stock Picks For Last Week From Wall Street's Most Accurate Analysts","U.S. stocks settled lower on Friday, with the Dow Jones index dipping more than 400 points as investors digested the jobs report for January. Wall Street also recorded losses last week as renewed fears over inflation and trade tariffs eroded risk appetite.",https://www.benzinga.com/25/02/43604668/this-analyst-with-86-accuracy-rate-sees-more-than-18-upside-in-amazon-com-here-are-5-stock-picks-for-last-week-fr,benzinga.com,5,u stock settled lower friday dow jones index dipping point investor digested job report january wall street also recorded loss last week renewed fear inflation trade tariff eroded risk appetite,-0.8316,-0.4158,0.2849788235,-0.700778824,Negative Impact
11/02/2025,231.9199982,233.44,230.13,232.76,232.76,23713700,5.66,38.78057437,1.192,0,27.30545211,0.4577403224,0.2071825716,4.33,317.671,19643.85938,20168.21094,8777.400391,8028.899902,3318.056885,76293.60156,25631.80078,226.5920001,196.3864003,225.0205245,199.0348616,232.8094994,245.6192793,219.9997194,47.06496114,2.96581052,3.821246831,-0.855436311,5.817860195,241.947388,11775745000,41.41652089,34.95394582,16.02000046,2 Super Growth Stocks to Buy in the Next Market Correction,"Market indexes continue to trade close to new highs, but investors should be prepared for more volatility in 2025. Historically, the stock market experiences a correction, which is defined as a pullback of at least 10% from the recent high, once every two years.",https://www.fool.com/investing/2025/02/11/2-super-growth-stocks-buy-market-correction/,fool.com,7,market index continue trade close new high investor prepared volatility historically stock market experience correction defined pullback least recent high every two year,0.2263,0.15841,0.5153091667,-0.356899167,Negative Impact
12/02/2025,230.4600067,231.18,228.16,228.93,228.93,32285200,5.66,38.78057437,1.192,0,27.30545211,0.4577403224,0.2071825716,4.33,317.671,19649.94922,20062.31055,8807.400391,8042.189941,3346.38501,76171.07813,25563.09961,227.0557999,196.6627003,225.173837,199.3323256,233.3679993,244.2429267,222.4930718,42.22753549,2.327343102,3.522466085,-1.195122983,5.8600017,241.6696402,11743459800,18.42731927,34.51376741,15.89000034,3 Evergreen Retail Stocks to Buy Like There's No Tomorrow,"Most retailers aren't considered evergreen businesses because they're highly exposed to macro and competitive headwinds. They've also struggled to keep pace with major technological shifts in the e-commerce, mobile, and social media markets.",https://www.fool.com/investing/2025/02/12/3-evergreen-retail-stocks-to-buy-like-theres-no-to/,fool.com,7,retailer arent considered evergreen business theyre highly exposed macro competitive headwind theyve also struggled keep pace major technological shift ecommerce mobile social medium market,-0.2568,-0.17976,0.3144273333,-0.494187333,Negative Impact
13/02/2025,228.8500061,230.42,227.52,230.37,230.37,31346500,5.66,38.78057437,1.192,0,27.30545211,0.4577403224,0.2071825716,4.33,317.671,19945.64063,20181.28906,8764.700195,8164.109863,3332.48291,76138.96875,25698.5,227.5053998,196.9164503,225.3776079,199.6411581,233.7189987,243.644172,223.7938255,44.74423803,1.915468902,3.201066649,-1.285597746,5.819286891,241.3974473,11774806300,27.07078941,28.97154319,15.10000038,1 Unstoppable Artificial Intelligence (AI) Stock to Buy Right Now,"In 2023, Bank of America analyst Michael Hartnett coined the term ""Magnificent Seven"" to describe a group of powerhouse tech stocks, inspired by the classic 1960s Western film. These companies, among the market's most valuable, are leading the way in artificial intelligence (AI), cloud computing, online gaming, and advanced hardware and software.",https://www.fool.com/investing/2025/02/13/1-unstoppable-artificial-intelligence-ai-stock-to/,fool.com,7,bank america analyst michael hartnett coined term magnificent seven describe group powerhouse tech stock inspired classic western film company among market valuable leading way artificial intelligence ai cloud computing online gaming advanced hardware software,0.936,0.6552,0.343588125,0.311611875,Positive Impact